sido,sgg_nm,age,date,popu_num,popu_male_num,popu_female_num,popu_sx_rate,local_num,local_male_num,local_female_num,local_sx_rate
서울특별시,종로구,합계,2017,157277,76670,80607,95.1,146298,71757,74541,96.3
서울특별시,종로구,0~4세,2017,4137,2099,2038,103,4011,2039,1972,103.4
서울특별시,종로구,0세,2017,694,336,358,93.9,675,327,348,94
서울특별시,종로구,1세,2017,836,429,407,105.4,805,412,393,104.8
서울특별시,종로구,2세,2017,878,459,419,109.5,850,447,403,110.9
서울특별시,종로구,3세,2017,879,435,444,98,856,424,432,98.1
서울특별시,종로구,4세,2017,850,440,410,107.3,825,429,396,108.3
서울특별시,종로구,5~9세,2017,4594,2365,2229,106.1,4511,2319,2192,105.8
서울특별시,종로구,5세,2017,982,513,469,109.4,961,499,462,108
서울특별시,종로구,6세,2017,890,457,433,105.5,872,448,424,105.7
서울특별시,종로구,7세,2017,888,437,451,96.9,877,432,445,97.1
서울특별시,종로구,8세,2017,890,454,436,104.1,879,450,429,104.9
서울특별시,종로구,9세,2017,944,504,440,114.5,922,490,432,113.4
서울특별시,종로구,10~14세,2017,5002,2567,2435,105.4,4935,2532,2403,105.4
서울특별시,종로구,10세,2017,985,507,478,106.1,975,501,474,105.7
서울특별시,종로구,11세,2017,943,499,444,112.4,931,492,439,112.1
서울특별시,종로구,12세,2017,934,484,450,107.6,918,473,445,106.3
서울특별시,종로구,13세,2017,1023,510,513,99.4,1010,505,505,100
서울특별시,종로구,14세,2017,1117,567,550,103.1,1101,561,540,103.9
서울특별시,종로구,15~19세,2017,10198,5267,4931,106.8,9358,4960,4398,112.8
서울특별시,종로구,15세,2017,1208,622,586,106.1,1196,614,582,105.5
서울특별시,종로구,16세,2017,1708,1020,688,148.3,1691,1010,681,148.3
서울특별시,종로구,17세,2017,2303,1379,924,149.2,2265,1360,905,150.3
서울특별시,종로구,18세,2017,2084,990,1094,90.5,1859,917,942,97.3
서울특별시,종로구,19세,2017,2895,1256,1639,76.6,2347,1059,1288,82.2
서울특별시,종로구,20~24세,2017,15098,6848,8250,83,12341,5908,6433,91.8
서울특별시,종로구,20세,2017,2969,1258,1711,73.5,2309,1047,1262,83
서울특별시,종로구,21세,2017,2942,1288,1654,77.9,2328,1084,1244,87.1
서울특별시,종로구,22세,2017,3029,1403,1626,86.3,2445,1195,1250,95.6
서울특별시,종로구,23세,2017,3020,1383,1637,84.5,2545,1218,1327,91.8
서울특별시,종로구,24세,2017,3138,1516,1622,93.5,2714,1364,1350,101
서울특별시,종로구,25~29세,2017,13584,7156,6428,111.3,12180,6519,5661,115.2
서울특별시,종로구,25세,2017,3016,1611,1405,114.7,2656,1465,1191,123
서울특별시,종로구,26세,2017,2952,1565,1387,112.8,2685,1442,1243,116
서울특별시,종로구,27세,2017,2728,1405,1323,106.2,2440,1282,1158,110.7
서울특별시,종로구,28세,2017,2447,1278,1169,109.3,2219,1165,1054,110.5
서울특별시,종로구,29세,2017,2441,1297,1144,113.4,2180,1165,1015,114.8
서울특별시,종로구,30~34세,2017,11100,5615,5485,102.4,10004,5054,4950,102.1
서울특별시,종로구,30세,2017,2371,1159,1212,95.6,2117,1038,1079,96.2
서울특별시,종로구,31세,2017,2219,1141,1078,105.8,1976,1012,964,105
서울특별시,종로구,32세,2017,2180,1117,1063,105.1,1986,1026,960,106.9
서울특별시,종로구,33세,2017,2145,1093,1052,103.9,1929,975,954,102.2
서울특별시,종로구,34세,2017,2185,1105,1080,102.3,1996,1003,993,101
서울특별시,종로구,35~39세,2017,10661,5347,5314,100.6,9855,4884,4971,98.2
서울특별시,종로구,35세,2017,2200,1111,1089,102,2018,1010,1008,100.2
서울특별시,종로구,36세,2017,2288,1155,1133,101.9,2129,1058,1071,98.8
서울특별시,종로구,37세,2017,2199,1086,1113,97.6,2034,999,1035,96.5
서울특별시,종로구,38세,2017,2069,1034,1035,99.9,1926,948,978,96.9
서울특별시,종로구,39세,2017,1905,961,944,101.8,1748,869,879,98.9
서울특별시,종로구,40~44세,2017,10810,5251,5559,94.5,10138,4866,5272,92.3
서울특별시,종로구,40세,2017,1967,923,1044,88.4,1836,851,985,86.4
서울특별시,종로구,41세,2017,2020,1018,1002,101.6,1879,929,950,97.8
서울특별시,종로구,42세,2017,2072,1023,1049,97.5,1946,953,993,96
서울특별시,종로구,43세,2017,2335,1134,1201,94.4,2205,1060,1145,92.6
서울특별시,종로구,44세,2017,2416,1153,1263,91.3,2272,1073,1199,89.5
서울특별시,종로구,45~49세,2017,13404,6598,6806,96.9,12604,6176,6428,96.1
서울특별시,종로구,45세,2017,2625,1345,1280,105.1,2451,1247,1204,103.6
서울특별시,종로구,46세,2017,2808,1428,1380,103.5,2643,1338,1305,102.5
서울특별시,종로구,47세,2017,2703,1315,1388,94.7,2534,1226,1308,93.7
서울특별시,종로구,48세,2017,2651,1266,1385,91.4,2506,1188,1318,90.1
서울특별시,종로구,49세,2017,2617,1244,1373,90.6,2470,1177,1293,91
서울특별시,종로구,50~54세,2017,12413,6134,6279,97.7,11645,5768,5877,98.1
서울특별시,종로구,50세,2017,2446,1182,1264,93.5,2312,1113,1199,92.8
서울특별시,종로구,51세,2017,2408,1160,1248,92.9,2255,1085,1170,92.7
서울특별시,종로구,52세,2017,2494,1222,1272,96.1,2332,1154,1178,98
서울특별시,종로구,53세,2017,2514,1267,1247,101.6,2361,1193,1168,102.1
서울특별시,종로구,54세,2017,2551,1303,1248,104.4,2385,1223,1162,105.2
서울특별시,종로구,55~59세,2017,12560,6237,6323,98.6,11922,5948,5974,99.6
서울특별시,종로구,55세,2017,2533,1314,1219,107.8,2370,1236,1134,109
서울특별시,종로구,56세,2017,2634,1281,1353,94.7,2557,1241,1316,94.3
서울특별시,종로구,57세,2017,2626,1221,1405,86.9,2495,1167,1328,87.9
서울특별시,종로구,58세,2017,2434,1251,1183,105.7,2302,1197,1105,108.3
서울특별시,종로구,59세,2017,2333,1170,1163,100.6,2198,1107,1091,101.5
서울특별시,종로구,60~64세,2017,10042,4918,5124,96,9530,4693,4837,97
서울특별시,종로구,60세,2017,2246,1099,1147,95.8,2106,1034,1072,96.5
서울특별시,종로구,61세,2017,2127,1056,1071,98.6,2029,1011,1018,99.3
서울특별시,종로구,62세,2017,2131,1027,1104,93,2042,986,1056,93.4
서울특별시,종로구,63세,2017,1903,957,946,101.2,1797,914,883,103.5
서울특별시,종로구,64세,2017,1635,779,856,91,1556,748,808,92.6
서울특별시,종로구,65~69세,2017,7154,3331,3823,87.1,6928,3228,3700,87.2
서울특별시,종로구,65세,2017,1710,842,868,97,1652,812,840,96.7
서울특별시,종로구,66세,2017,1215,551,664,83,1154,527,627,84.1
서울특별시,종로구,67세,2017,1406,645,761,84.8,1353,624,729,85.6
서울특별시,종로구,68세,2017,1393,643,750,85.7,1363,625,738,84.7
서울특별시,종로구,69세,2017,1430,650,780,83.3,1406,640,766,83.6
서울특별시,종로구,70~74세,2017,6076,2665,3411,78.1,5995,2635,3360,78.4
서울특별시,종로구,70세,2017,1451,650,801,81.1,1423,637,786,81
서울특별시,종로구,71세,2017,1134,496,638,77.7,1122,494,628,78.7
서울특별시,종로구,72세,2017,1132,492,640,76.9,1114,486,628,77.4
서울특별시,종로구,73세,2017,1146,467,679,68.8,1133,462,671,68.9
서울특별시,종로구,74세,2017,1213,560,653,85.8,1203,556,647,85.9
서울특별시,종로구,75~79세,2017,5380,2371,3009,78.8,5326,2351,2975,79
서울특별시,종로구,75세,2017,1383,621,762,81.5,1369,616,753,81.8
서울특별시,종로구,76세,2017,1152,520,632,82.3,1141,514,627,82
서울특별시,종로구,77세,2017,1011,455,556,81.8,1002,453,549,82.5
서울특별시,종로구,78세,2017,996,429,567,75.7,988,426,562,75.8
서울특별시,종로구,79세,2017,838,346,492,70.3,826,342,484,70.7
서울특별시,종로구,80~84세,2017,3025,1223,1802,67.9,2998,1211,1787,67.8
서울특별시,종로구,80세,2017,751,324,427,75.9,744,321,423,75.9
서울특별시,종로구,81세,2017,682,286,396,72.2,678,286,392,73
서울특별시,종로구,82세,2017,631,255,376,67.8,623,249,374,66.6
서울특별시,종로구,83세,2017,534,205,329,62.3,532,204,328,62.2
서울특별시,종로구,84세,2017,427,153,274,55.8,421,151,270,55.9
서울특별시,종로구,85세이상,2017,2039,678,1361,49.8,2017,666,1351,49.3
서울특별시,종로구,85~89세,2017,1412,488,924,52.8,1396,481,915,52.6
서울특별시,종로구,85세,2017,374,139,235,59.1,370,137,233,58.8
서울특별시,종로구,86세,2017,336,113,223,50.7,332,112,220,50.9
서울특별시,종로구,87세,2017,281,92,189,48.7,278,90,188,47.9
서울특별시,종로구,88세,2017,230,89,141,63.1,228,87,141,61.7
서울특별시,종로구,89세,2017,191,55,136,40.4,188,55,133,41.4
서울특별시,종로구,90~94세,2017,476,152,324,46.9,472,149,323,46.1
서울특별시,종로구,90세,2017,152,51,101,50.5,150,50,100,50
서울특별시,종로구,91세,2017,114,34,80,42.5,113,33,80,41.3
서울특별시,종로구,92세,2017,91,29,62,46.8,91,29,62,46.8
서울특별시,종로구,93세,2017,60,17,43,39.5,60,17,43,39.5
서울특별시,종로구,94세,2017,59,21,38,55.3,58,20,38,52.6
서울특별시,종로구,95~99세,2017,127,32,95,33.7,126,31,95,32.6
서울특별시,종로구,95세,2017,53,17,36,47.2,53,17,36,47.2
서울특별시,종로구,96세,2017,29,6,23,26.1,28,5,23,21.7
서울특별시,종로구,97세,2017,24,X,20,20,24,X,20,20
서울특별시,종로구,98세,2017,10,X,6,66.7,10,X,6,66.7
서울특별시,종로구,99세,2017,11,X,10,10,11,X,10,10
서울특별시,종로구,100세이상,2017,24,6,18,33.3,23,5,18,27.8
서울특별시,종로구,15세미만,2017,13733,7031,6702,104.9,13457,6890,6567,104.9
서울특별시,종로구,15~64세,2017,119870,59371,60499,98.1,109577,54776,54801,100
서울특별시,종로구,65세이상,2017,23674,10268,13406,76.6,23264,10091,13173,76.6
서울특별시,종로구,평균연령,2017,42.1,41.3,42.9,,42.6,41.6,43.6,
서울특별시,종로구,중위연령,2017,42.1,41.1,43.1,,43.1,41.9,44.2,
서울특별시,용산구,합계,2017,223898,108471,115427,94,207893,99759,108134,92.3
서울특별시,용산구,0~4세,2017,7975,4101,3874,105.9,7304,3763,3541,106.3
서울특별시,용산구,0세,2017,1496,738,758,97.4,1368,682,686,99.4
서울특별시,용산구,1세,2017,1654,864,790,109.4,1520,792,728,108.8
서울특별시,용산구,2세,2017,1644,867,777,111.6,1508,801,707,113.3
서울특별시,용산구,3세,2017,1602,823,779,105.6,1453,746,707,105.5
서울특별시,용산구,4세,2017,1579,809,770,105.1,1455,742,713,104.1
서울특별시,용산구,5~9세,2017,7791,3929,3862,101.7,7145,3605,3540,101.8
서울특별시,용산구,5세,2017,1699,846,853,99.2,1560,783,777,100.8
서울특별시,용산구,6세,2017,1591,842,749,112.4,1449,765,684,111.8
서울특별시,용산구,7세,2017,1493,762,731,104.2,1367,699,668,104.6
서울특별시,용산구,8세,2017,1484,725,759,95.5,1358,655,703,93.2
서울특별시,용산구,9세,2017,1524,754,770,97.9,1411,703,708,99.3
서울특별시,용산구,10~14세,2017,7448,3829,3619,105.8,6970,3570,3400,105
서울특별시,용산구,10세,2017,1609,818,791,103.4,1497,760,737,103.1
서울특별시,용산구,11세,2017,1421,724,697,103.9,1321,668,653,102.3
서울특별시,용산구,12세,2017,1407,746,661,112.9,1314,689,625,110.2
서울특별시,용산구,13세,2017,1512,796,716,111.2,1420,747,673,111
서울특별시,용산구,14세,2017,1499,745,754,98.8,1418,706,712,99.2
서울특별시,용산구,15~19세,2017,9587,4771,4816,99.1,9174,4559,4615,98.8
서울특별시,용산구,15세,2017,1597,836,761,109.9,1534,808,726,111.3
서울특별시,용산구,16세,2017,1750,916,834,109.8,1697,892,805,110.8
서울특별시,용산구,17세,2017,1932,1000,932,107.3,1851,955,896,106.6
서울특별시,용산구,18세,2017,1978,990,988,100.2,1891,938,953,98.4
서울특별시,용산구,19세,2017,2330,1029,1301,79.1,2201,966,1235,78.2
서울특별시,용산구,20~24세,2017,14643,6465,8178,79.1,13441,5872,7569,77.6
서울특별시,용산구,20세,2017,2516,1110,1406,78.9,2307,1035,1272,81.4
서울특별시,용산구,21세,2017,2604,1181,1423,83,2423,1091,1332,81.9
서울특별시,용산구,22세,2017,3014,1291,1723,74.9,2768,1174,1594,73.7
서울특별시,용산구,23세,2017,3194,1414,1780,79.4,2930,1264,1666,75.9
서울특별시,용산구,24세,2017,3315,1469,1846,79.6,3013,1308,1705,76.7
서울특별시,용산구,25~29세,2017,18471,9078,9393,96.6,16515,7990,8525,93.7
서울특별시,용산구,25세,2017,3654,1681,1973,85.2,3274,1490,1784,83.5
서울특별시,용산구,26세,2017,3708,1791,1917,93.4,3368,1603,1765,90.8
서울특별시,용산구,27세,2017,3621,1813,1808,100.3,3255,1606,1649,97.4
서울특별시,용산구,28세,2017,3698,1881,1817,103.5,3284,1642,1642,100
서울특별시,용산구,29세,2017,3790,1912,1878,101.8,3334,1649,1685,97.9
서울특별시,용산구,30~34세,2017,19518,10032,9486,105.8,17308,8694,8614,100.9
서울특별시,용산구,30세,2017,3745,1868,1877,99.5,3328,1626,1702,95.5
서울특별시,용산구,31세,2017,3921,2039,1882,108.3,3460,1753,1707,102.7
서울특별시,용산구,32세,2017,3748,1937,1811,107,3307,1662,1645,101
서울특별시,용산구,33세,2017,3982,2076,1906,108.9,3510,1792,1718,104.3
서울특별시,용산구,34세,2017,4122,2112,2010,105.1,3703,1861,1842,101
서울특별시,용산구,35~39세,2017,19833,10020,9813,102.1,17798,8836,8962,98.6
서울특별시,용산구,35세,2017,4188,2096,2092,100.2,3776,1850,1926,96.1
서울특별시,용산구,36세,2017,4212,2150,2062,104.3,3821,1938,1883,102.9
서울특별시,용산구,37세,2017,4197,2109,2088,101,3738,1839,1899,96.8
서울특별시,용산구,38세,2017,3796,1914,1882,101.7,3388,1677,1711,98
서울특별시,용산구,39세,2017,3440,1751,1689,103.7,3075,1532,1543,99.3
서울특별시,용산구,40~44세,2017,17767,8904,8863,100.5,16118,7943,8175,97.2
서울특별시,용산구,40세,2017,3417,1667,1750,95.3,3058,1462,1596,91.6
서울특별시,용산구,41세,2017,3344,1690,1654,102.2,2988,1486,1502,98.9
서울특별시,용산구,42세,2017,3470,1743,1727,100.9,3148,1558,1590,98
서울특별시,용산구,43세,2017,3763,1893,1870,101.2,3456,1708,1748,97.7
서울특별시,용산구,44세,2017,3773,1911,1862,102.6,3468,1729,1739,99.4
서울특별시,용산구,45~49세,2017,19810,9994,9816,101.8,18347,9152,9195,99.5
서울특별시,용산구,45세,2017,4039,2066,1973,104.7,3733,1902,1831,103.9
서울특별시,용산구,46세,2017,4090,2084,2006,103.9,3804,1924,1880,102.3
서울특별시,용산구,47세,2017,3923,1961,1962,99.9,3626,1788,1838,97.3
서울특별시,용산구,48세,2017,3957,1982,1975,100.4,3673,1807,1866,96.8
서울특별시,용산구,49세,2017,3801,1901,1900,100.1,3511,1731,1780,97.2
서울특별시,용산구,50~54세,2017,16923,8306,8617,96.4,15758,7735,8023,96.4
서울특별시,용산구,50세,2017,3361,1626,1735,93.7,3128,1500,1628,92.1
서울특별시,용산구,51세,2017,3222,1623,1599,101.5,3017,1521,1496,101.7
서울특별시,용산구,52세,2017,3457,1690,1767,95.6,3218,1580,1638,96.5
서울특별시,용산구,53세,2017,3354,1650,1704,96.8,3126,1547,1579,98
서울특별시,용산구,54세,2017,3529,1717,1812,94.8,3269,1587,1682,94.4
서울특별시,용산구,55~59세,2017,17326,8411,8915,94.3,16535,8022,8513,94.2
서울특별시,용산구,55세,2017,3548,1785,1763,101.2,3373,1692,1681,100.7
서울특별시,용산구,56세,2017,3553,1701,1852,91.8,3408,1629,1779,91.6
서울특별시,용산구,57세,2017,3623,1691,1932,87.5,3458,1618,1840,87.9
서울특별시,용산구,58세,2017,3376,1603,1773,90.4,3223,1533,1690,90.7
서울특별시,용산구,59세,2017,3226,1631,1595,102.3,3073,1550,1523,101.8
서울특별시,용산구,60~64세,2017,14249,6838,7411,92.3,13555,6527,7028,92.9
서울특별시,용산구,60세,2017,3216,1534,1682,91.2,3045,1466,1579,92.8
서울특별시,용산구,61세,2017,3107,1537,1570,97.9,2954,1473,1481,99.5
서울특별시,용산구,62세,2017,3060,1415,1645,86,2924,1353,1571,86.1
서울특별시,용산구,63세,2017,2588,1265,1323,95.6,2468,1201,1267,94.8
서울특별시,용산구,64세,2017,2278,1087,1191,91.3,2164,1034,1130,91.5
서울특별시,용산구,65~69세,2017,10103,4667,5436,85.9,9774,4508,5266,85.6
서울특별시,용산구,65세,2017,2348,1042,1306,79.8,2252,1004,1248,80.4
서울특별시,용산구,66세,2017,1708,800,908,88.1,1641,769,872,88.2
서울특별시,용산구,67세,2017,2028,953,1075,88.7,1965,918,1047,87.7
서울특별시,용산구,68세,2017,2001,940,1061,88.6,1943,906,1037,87.4
서울특별시,용산구,69세,2017,2018,932,1086,85.8,1973,911,1062,85.8
서울특별시,용산구,70~74세,2017,8127,3552,4575,77.6,8003,3489,4514,77.3
서울특별시,용산구,70세,2017,1930,813,1117,72.8,1893,801,1092,73.4
서울특별시,용산구,71세,2017,1547,661,886,74.6,1517,644,873,73.8
서울특별시,용산구,72세,2017,1519,700,819,85.5,1503,687,816,84.2
서울특별시,용산구,73세,2017,1545,656,889,73.8,1526,645,881,73.2
서울특별시,용산구,74세,2017,1586,722,864,83.6,1564,712,852,83.6
서울특별시,용산구,75~79세,2017,7311,3086,4225,73,7226,3047,4179,72.9
서울특별시,용산구,75세,2017,1881,840,1041,80.7,1865,832,1033,80.5
서울특별시,용산구,76세,2017,1519,654,865,75.6,1498,647,851,76
서울특별시,용산구,77세,2017,1334,559,775,72.1,1314,548,766,71.5
서울특별시,용산구,78세,2017,1332,557,775,71.9,1313,547,766,71.4
서울특별시,용산구,79세,2017,1245,476,769,61.9,1236,473,763,62
서울특별시,용산구,80~84세,2017,4268,1609,2659,60.5,4212,1582,2630,60.2
서울특별시,용산구,80세,2017,1092,430,662,65,1079,427,652,65.5
서울특별시,용산구,81세,2017,995,362,633,57.2,982,354,628,56.4
서울특별시,용산구,82세,2017,863,340,523,65,851,333,518,64.3
서울특별시,용산구,83세,2017,720,255,465,54.8,712,252,460,54.8
서울특별시,용산구,84세,2017,598,222,376,59,588,216,372,58.1
서울특별시,용산구,85세이상,2017,2748,879,1869,47,2710,865,1845,46.9
서울특별시,용산구,85~89세,2017,1949,654,1295,50.5,1921,644,1277,50.4
서울특별시,용산구,85세,2017,532,197,335,58.8,527,197,330,59.7
서울특별시,용산구,86세,2017,412,152,260,58.5,408,151,257,58.8
서울특별시,용산구,87세,2017,399,142,257,55.3,390,138,252,54.8
서울특별시,용산구,88세,2017,342,94,248,37.9,338,94,244,38.5
서울특별시,용산구,89세,2017,264,69,195,35.4,258,64,194,33
서울특별시,용산구,90~94세,2017,633,178,455,39.1,625,174,451,38.6
서울특별시,용산구,90세,2017,192,44,148,29.7,191,43,148,29.1
서울특별시,용산구,91세,2017,143,38,105,36.2,141,36,105,34.3
서울특별시,용산구,92세,2017,114,36,78,46.2,112,35,77,45.5
서울특별시,용산구,93세,2017,104,33,71,46.5,103,33,70,47.1
서울특별시,용산구,94세,2017,80,27,53,50.9,78,27,51,52.9
서울특별시,용산구,95~99세,2017,148,41,107,38.3,147,41,106,38.7
서울특별시,용산구,95세,2017,67,15,52,28.8,67,15,52,28.8
서울특별시,용산구,96세,2017,32,11,21,52.4,32,11,21,52.4
서울특별시,용산구,97세,2017,24,8,16,50,24,8,16,50
서울특별시,용산구,98세,2017,16,6,10,60,15,6,9,66.7
서울특별시,용산구,99세,2017,9,X,8,12.5,9,X,8,12.5
서울특별시,용산구,100세이상,2017,18,6,12,50,17,6,11,54.5
서울특별시,용산구,15세미만,2017,23214,11859,11355,104.4,21419,10938,10481,104.4
서울특별시,용산구,15~64세,2017,168127,82819,85308,97.1,154549,75330,79219,95.1
서울특별시,용산구,65세이상,2017,32557,13793,18764,73.5,31925,13491,18434,73.2
서울특별시,용산구,평균연령,2017,42.2,41.4,43,,42.7,41.8,43.5,
서울특별시,용산구,중위연령,2017,42,41.2,42.7,,42.7,42,43.4,
서울특별시,성동구,합계,2017,302367,149060,153307,97.2,291931,144018,147913,97.4
서울특별시,성동구,0~4세,2017,12554,6330,6224,101.7,12359,6236,6123,101.8
서울특별시,성동구,0세,2017,2490,1275,1215,104.9,2455,1257,1198,104.9
서울특별시,성동구,1세,2017,2557,1261,1296,97.3,2513,1240,1273,97.4
서울특별시,성동구,2세,2017,2594,1296,1298,99.8,2550,1276,1274,100.2
서울특별시,성동구,3세,2017,2502,1264,1238,102.1,2465,1244,1221,101.9
서울특별시,성동구,4세,2017,2411,1234,1177,104.8,2376,1219,1157,105.4
서울특별시,성동구,5~9세,2017,10457,5353,5104,104.9,10349,5293,5056,104.7
서울특별시,성동구,5세,2017,2337,1201,1136,105.7,2307,1184,1123,105.4
서울특별시,성동구,6세,2017,2152,1104,1048,105.3,2135,1093,1042,104.9
서울특별시,성동구,7세,2017,2010,1022,988,103.4,1981,1010,971,104
서울특별시,성동구,8세,2017,1882,961,921,104.3,1866,951,915,103.9
서울특별시,성동구,9세,2017,2076,1065,1011,105.3,2060,1055,1005,105
서울특별시,성동구,10~14세,2017,9617,4798,4819,99.6,9548,4763,4785,99.5
서울특별시,성동구,10세,2017,2086,1059,1027,103.1,2075,1052,1023,102.8
서울특별시,성동구,11세,2017,1831,947,884,107.1,1819,941,878,107.2
서울특별시,성동구,12세,2017,1826,921,905,101.8,1812,913,899,101.6
서울특별시,성동구,13세,2017,1957,986,971,101.5,1941,980,961,102
서울특별시,성동구,14세,2017,1917,885,1032,85.8,1901,877,1024,85.6
서울특별시,성동구,15~19세,2017,13662,6800,6862,99.1,13332,6646,6686,99.4
서울특별시,성동구,15세,2017,2090,1002,1088,92.1,2078,995,1083,91.9
서울특별시,성동구,16세,2017,2302,1188,1114,106.6,2290,1181,1109,106.5
서울특별시,성동구,17세,2017,2565,1293,1272,101.7,2536,1278,1258,101.6
서울특별시,성동구,18세,2017,2917,1450,1467,98.8,2839,1411,1428,98.8
서울특별시,성동구,19세,2017,3788,1867,1921,97.2,3589,1781,1808,98.5
서울특별시,성동구,20~24세,2017,23650,11828,11822,100.1,21831,11109,10722,103.6
서울특별시,성동구,20세,2017,4250,2037,2213,92,3936,1925,2011,95.7
서울특별시,성동구,21세,2017,4401,2127,2274,93.5,4044,1993,2051,97.2
서울특별시,성동구,22세,2017,4634,2345,2289,102.4,4243,2177,2066,105.4
서울특별시,성동구,23세,2017,5053,2512,2541,98.9,4669,2367,2302,102.8
서울특별시,성동구,24세,2017,5312,2807,2505,112.1,4939,2647,2292,115.5
서울특별시,성동구,25~29세,2017,25791,13208,12583,105,24379,12507,11872,105.3
서울특별시,성동구,25세,2017,5561,2916,2645,110.2,5243,2776,2467,112.5
서울특별시,성동구,26세,2017,5229,2788,2441,114.2,4968,2655,2313,114.8
서울특별시,성동구,27세,2017,5202,2645,2557,103.4,4908,2506,2402,104.3
서울특별시,성동구,28세,2017,4869,2440,2429,100.5,4602,2299,2303,99.8
서울특별시,성동구,29세,2017,4930,2419,2511,96.3,4658,2271,2387,95.1
서울특별시,성동구,30~34세,2017,25514,12623,12891,97.9,24285,11972,12313,97.2
서울특별시,성동구,30세,2017,4830,2383,2447,97.4,4536,2227,2309,96.4
서울특별시,성동구,31세,2017,4931,2456,2475,99.2,4674,2324,2350,98.9
서울특별시,성동구,32세,2017,5191,2525,2666,94.7,4950,2397,2553,93.9
서울특별시,성동구,33세,2017,5110,2520,2590,97.3,4881,2396,2485,96.4
서울특별시,성동구,34세,2017,5452,2739,2713,101,5244,2628,2616,100.5
서울특별시,성동구,35~39세,2017,26612,13594,13018,104.4,25740,13094,12646,103.5
서울특별시,성동구,35세,2017,5813,2986,2827,105.6,5586,2857,2729,104.7
서울특별시,성동구,36세,2017,5596,2841,2755,103.1,5409,2727,2682,101.7
서울특별시,성동구,37세,2017,5671,2877,2794,103,5509,2789,2720,102.5
서울특별시,성동구,38세,2017,5024,2556,2468,103.6,4878,2474,2404,102.9
서울특별시,성동구,39세,2017,4508,2334,2174,107.4,4358,2247,2111,106.4
서울특별시,성동구,40~44세,2017,23193,11931,11262,105.9,22488,11555,10933,105.7
서울특별시,성동구,40세,2017,4547,2326,2221,104.7,4412,2256,2156,104.6
서울특별시,성동구,41세,2017,4430,2316,2114,109.6,4299,2239,2060,108.7
서울특별시,성동구,42세,2017,4448,2246,2202,102,4301,2162,2139,101.1
서울특별시,성동구,43세,2017,4841,2499,2342,106.7,4723,2440,2283,106.9
서울특별시,성동구,44세,2017,4927,2544,2383,106.8,4753,2458,2295,107.1
서울특별시,성동구,45~49세,2017,25178,12563,12615,99.6,24294,12116,12178,99.5
서울특별시,성동구,45세,2017,4859,2451,2408,101.8,4683,2361,2322,101.7
서울특별시,성동구,46세,2017,5168,2589,2579,100.4,5002,2503,2499,100.2
서울특별시,성동구,47세,2017,5159,2623,2536,103.4,4965,2522,2443,103.2
서울특별시,성동구,48세,2017,5017,2439,2578,94.6,4852,2367,2485,95.3
서울특별시,성동구,49세,2017,4975,2461,2514,97.9,4792,2363,2429,97.3
서울특별시,성동구,50~54세,2017,23297,11500,11797,97.5,22376,11054,11322,97.6
서울특별시,성동구,50세,2017,4512,2188,2324,94.1,4382,2119,2263,93.6
서울특별시,성동구,51세,2017,4520,2252,2268,99.3,4320,2158,2162,99.8
서울특별시,성동구,52세,2017,4785,2359,2426,97.2,4556,2240,2316,96.7
서울특별시,성동구,53세,2017,4606,2298,2308,99.6,4442,2226,2216,100.5
서울특별시,성동구,54세,2017,4874,2403,2471,97.2,4676,2311,2365,97.7
서울특별시,성동구,55~59세,2017,24448,12179,12269,99.3,23670,11830,11840,99.9
서울특별시,성동구,55세,2017,4970,2519,2451,102.8,4791,2437,2354,103.5
서울특별시,성동구,56세,2017,5083,2529,2554,99,4952,2476,2476,100
서울특별시,성동구,57세,2017,5211,2551,2660,95.9,5056,2494,2562,97.3
서울특별시,성동구,58세,2017,4732,2344,2388,98.2,4585,2264,2321,97.5
서울특별시,성동구,59세,2017,4452,2236,2216,100.9,4286,2159,2127,101.5
서울특별시,성동구,60~64세,2017,18958,9216,9742,94.6,18284,8891,9393,94.7
서울특별시,성동구,60세,2017,4420,2172,2248,96.6,4262,2092,2170,96.4
서울특별시,성동구,61세,2017,4014,1946,2068,94.1,3863,1871,1992,93.9
서울특별시,성동구,62세,2017,4074,1930,2144,90,3937,1868,2069,90.3
서울특별시,성동구,63세,2017,3522,1708,1814,94.2,3390,1648,1742,94.6
서울특별시,성동구,64세,2017,2928,1460,1468,99.5,2832,1412,1420,99.4
서울특별시,성동구,65~69세,2017,13163,6201,6962,89.1,12880,6069,6811,89.1
서울특별시,성동구,65세,2017,3109,1493,1616,92.4,3029,1452,1577,92.1
서울특별시,성동구,66세,2017,2360,1115,1245,89.6,2291,1087,1204,90.3
서울특별시,성동구,67세,2017,2587,1223,1364,89.7,2529,1189,1340,88.7
서울특별시,성동구,68세,2017,2600,1187,1413,84,2552,1166,1386,84.1
서울특별시,성동구,69세,2017,2507,1183,1324,89.4,2479,1175,1304,90.1
서울특별시,성동구,70~74세,2017,10480,4710,5770,81.6,10407,4680,5727,81.7
서울특별시,성동구,70세,2017,2588,1164,1424,81.7,2568,1157,1411,82
서울특별시,성동구,71세,2017,2024,924,1100,84,2002,914,1088,84
서울특별시,성동구,72세,2017,1939,853,1086,78.5,1931,851,1080,78.8
서울특별시,성동구,73세,2017,1973,895,1078,83,1962,889,1073,82.9
서울특별시,성동구,74세,2017,1956,874,1082,80.8,1944,869,1075,80.8
서울특별시,성동구,75~79세,2017,8476,3703,4773,77.6,8435,3692,4743,77.8
서울특별시,성동구,75세,2017,2296,1044,1252,83.4,2285,1042,1243,83.8
서울특별시,성동구,76세,2017,1800,815,985,82.7,1793,813,980,83
서울특별시,성동구,77세,2017,1560,647,913,70.9,1550,644,906,71.1
서울특별시,성동구,78세,2017,1498,666,832,80,1489,664,825,80.5
서울특별시,성동구,79세,2017,1322,531,791,67.1,1318,529,789,67
서울특별시,성동구,80~84세,2017,4595,1755,2840,61.8,4568,1749,2819,62
서울특별시,성동구,80세,2017,1203,486,717,67.8,1199,485,714,67.9
서울특별시,성동구,81세,2017,1042,386,656,58.8,1034,385,649,59.3
서울특별시,성동구,82세,2017,899,353,546,64.7,893,352,541,65.1
서울특별시,성동구,83세,2017,833,323,510,63.3,828,322,506,63.6
서울특별시,성동구,84세,2017,618,207,411,50.4,614,205,409,50.1
서울특별시,성동구,85세이상,2017,2722,768,1954,39.3,2706,762,1944,39.2
서울특별시,성동구,85~89세,2017,1915,566,1349,42,1906,563,1343,41.9
서울특별시,성동구,85세,2017,546,181,365,49.6,543,179,364,49.2
서울특별시,성동구,86세,2017,412,122,290,42.1,409,121,288,42
서울특별시,성동구,87세,2017,384,99,285,34.7,381,99,282,35.1
서울특별시,성동구,88세,2017,330,100,230,43.5,330,100,230,43.5
서울특별시,성동구,89세,2017,243,64,179,35.8,243,64,179,35.8
서울특별시,성동구,90~94세,2017,631,161,470,34.3,628,160,468,34.2
서울특별시,성동구,90세,2017,206,57,149,38.3,205,57,148,38.5
서울특별시,성동구,91세,2017,143,33,110,30,143,33,110,30
서울특별시,성동구,92세,2017,109,24,85,28.2,109,24,85,28.2
서울특별시,성동구,93세,2017,87,20,67,29.9,87,20,67,29.9
서울특별시,성동구,94세,2017,86,27,59,45.8,84,26,58,44.8
서울특별시,성동구,95~99세,2017,154,36,118,30.5,153,36,117,30.8
서울특별시,성동구,95세,2017,57,13,44,29.5,56,13,43,30.2
서울특별시,성동구,96세,2017,49,12,37,32.4,49,12,37,32.4
서울특별시,성동구,97세,2017,26,6,20,30,26,6,20,30
서울특별시,성동구,98세,2017,15,X,12,25,15,X,12,25
서울특별시,성동구,99세,2017,7,X,5,40,7,X,5,40
서울특별시,성동구,100세이상,2017,22,5,17,29.4,19,X,16,18.8
서울특별시,성동구,15세미만,2017,32628,16481,16147,102.1,32256,16292,15964,102.1
서울특별시,성동구,15~64세,2017,230303,115442,114861,100.5,220679,110774,109905,100.8
서울특별시,성동구,65세이상,2017,39436,17137,22299,76.9,38996,16952,22044,76.9
서울특별시,성동구,평균연령,2017,41.2,40.4,41.9,,41.3,40.5,42.1,
서울특별시,성동구,중위연령,2017,40.7,40,41.5,,40.9,40.2,41.8,
서울특별시,광진구,합계,2017,363934,177156,186778,94.8,345535,168833,176702,95.5
서울특별시,광진구,0~4세,2017,12176,6251,5925,105.5,11779,6045,5734,105.4
서울특별시,광진구,0세,2017,2366,1223,1143,107,2283,1174,1109,105.9
서울특별시,광진구,1세,2017,2528,1301,1227,106,2438,1256,1182,106.3
서울특별시,광진구,2세,2017,2568,1291,1277,101.1,2495,1254,1241,101
서울특별시,광진구,3세,2017,2347,1216,1131,107.5,2253,1170,1083,108
서울특별시,광진구,4세,2017,2367,1220,1147,106.4,2310,1191,1119,106.4
서울특별시,광진구,5~9세,2017,11857,6136,5721,107.3,11664,6035,5629,107.2
서울특별시,광진구,5세,2017,2483,1273,1210,105.2,2424,1240,1184,104.7
서울특별시,광진구,6세,2017,2386,1201,1185,101.4,2350,1180,1170,100.9
서울특별시,광진구,7세,2017,2383,1267,1116,113.5,2344,1247,1097,113.7
서울특별시,광진구,8세,2017,2194,1137,1057,107.6,2158,1121,1037,108.1
서울특별시,광진구,9세,2017,2411,1258,1153,109.1,2388,1247,1141,109.3
서울특별시,광진구,10~14세,2017,12507,6404,6103,104.9,12399,6337,6062,104.5
서울특별시,광진구,10세,2017,2569,1288,1281,100.5,2539,1271,1268,100.2
서울특별시,광진구,11세,2017,2348,1180,1168,101,2327,1168,1159,100.8
서울특별시,광진구,12세,2017,2366,1212,1154,105,2349,1198,1151,104.1
서울특별시,광진구,13세,2017,2593,1356,1237,109.6,2568,1342,1226,109.5
서울특별시,광진구,14세,2017,2631,1368,1263,108.3,2616,1358,1258,107.9
서울특별시,광진구,15~19세,2017,18401,9292,9109,102,17758,9059,8699,104.1
서울특별시,광진구,15세,2017,2703,1389,1314,105.7,2679,1379,1300,106.1
서울특별시,광진구,16세,2017,3001,1594,1407,113.3,2972,1582,1390,113.8
서울특별시,광진구,17세,2017,3516,1799,1717,104.8,3466,1779,1687,105.5
서울특별시,광진구,18세,2017,3968,2003,1965,101.9,3811,1957,1854,105.6
서울특별시,광진구,19세,2017,5213,2507,2706,92.6,4830,2362,2468,95.7
서울특별시,광진구,20~24세,2017,31434,14641,16793,87.2,28480,13589,14891,91.3
서울특별시,광진구,20세,2017,5477,2493,2984,83.5,4908,2294,2614,87.8
서울특별시,광진구,21세,2017,5830,2599,3231,80.4,5216,2389,2827,84.5
서울특별시,광진구,22세,2017,6180,2914,3266,89.2,5559,2679,2880,93
서울특별시,광진구,23세,2017,6773,3169,3604,87.9,6165,2962,3203,92.5
서울특별시,광진구,24세,2017,7174,3466,3708,93.5,6632,3265,3367,97
서울특별시,광진구,25~29세,2017,35083,17143,17940,95.6,32623,16073,16550,97.1
서울특별시,광진구,25세,2017,7412,3590,3822,93.9,6921,3408,3513,97
서울특별시,광진구,26세,2017,7251,3622,3629,99.8,6760,3403,3357,101.4
서울특별시,광진구,27세,2017,6941,3412,3529,96.7,6384,3186,3198,99.6
서울특별시,광진구,28세,2017,6780,3248,3532,92,6313,3033,3280,92.5
서울특별시,광진구,29세,2017,6699,3271,3428,95.4,6245,3043,3202,95
서울특별시,광진구,30~34세,2017,32152,16052,16100,99.7,30285,15118,15167,99.7
서울특별시,광진구,30세,2017,6637,3266,3371,96.9,6177,3027,3150,96.1
서울특별시,광진구,31세,2017,6385,3142,3243,96.9,5992,2949,3043,96.9
서울특별시,광진구,32세,2017,6248,3123,3125,99.9,5882,2959,2923,101.2
서울특별시,광진구,33세,2017,6197,3109,3088,100.7,5882,2937,2945,99.7
서울특별시,광진구,34세,2017,6685,3412,3273,104.2,6352,3246,3106,104.5
서울특별시,광진구,35~39세,2017,29867,15103,14764,102.3,28627,14450,14177,101.9
서울특별시,광진구,35세,2017,6693,3313,3380,98,6392,3159,3233,97.7
서울특별시,광진구,36세,2017,6310,3215,3095,103.9,6062,3085,2977,103.6
서울특별시,광진구,37세,2017,6096,3089,3007,102.7,5871,2976,2895,102.8
서울특별시,광진구,38세,2017,5758,2904,2854,101.8,5523,2783,2740,101.6
서울특별시,광진구,39세,2017,5010,2582,2428,106.3,4779,2447,2332,104.9
서울특별시,광진구,40~44세,2017,26972,13467,13505,99.7,25886,12871,13015,98.9
서울특별시,광진구,40세,2017,5359,2692,2667,100.9,5150,2566,2584,99.3
서울특별시,광진구,41세,2017,5073,2583,2490,103.7,4881,2477,2404,103
서울특별시,광진구,42세,2017,5230,2612,2618,99.8,5037,2505,2532,98.9
서울특별시,광진구,43세,2017,5565,2794,2771,100.8,5337,2669,2668,100
서울특별시,광진구,44세,2017,5745,2786,2959,94.2,5481,2654,2827,93.9
서울특별시,광진구,45~49세,2017,30806,15009,15797,95,29250,14275,14975,95.3
서울특별시,광진구,45세,2017,5999,3052,2947,103.6,5714,2913,2801,104
서울특별시,광진구,46세,2017,6333,3091,3242,95.3,6017,2937,3080,95.4
서울특별시,광진구,47세,2017,6184,2970,3214,92.4,5875,2828,3047,92.8
서울특별시,광진구,48세,2017,6072,2884,3188,90.5,5757,2737,3020,90.6
서울특별시,광진구,49세,2017,6218,3012,3206,93.9,5887,2860,3027,94.5
서울특별시,광진구,50~54세,2017,28389,13860,14529,95.4,26424,12954,13470,96.2
서울특별시,광진구,50세,2017,5585,2715,2870,94.6,5298,2582,2716,95.1
서울특별시,광진구,51세,2017,5545,2658,2887,92.1,5208,2511,2697,93.1
서울특별시,광진구,52세,2017,5847,2849,2998,95,5445,2662,2783,95.7
서울특별시,광진구,53세,2017,5502,2734,2768,98.8,5082,2533,2549,99.4
서울특별시,광진구,54세,2017,5910,2904,3006,96.6,5391,2666,2725,97.8
서울특별시,광진구,55~59세,2017,29092,13815,15277,90.4,27432,13092,14340,91.3
서울특별시,광진구,55세,2017,5861,2855,3006,95,5469,2690,2779,96.8
서울특별시,광진구,56세,2017,6011,2803,3208,87.4,5751,2697,3054,88.3
서울특별시,광진구,57세,2017,6239,2966,3273,90.6,5860,2794,3066,91.1
서울특별시,광진구,58세,2017,5547,2580,2967,87,5243,2438,2805,86.9
서울특별시,광진구,59세,2017,5434,2611,2823,92.5,5109,2473,2636,93.8
서울특별시,광진구,60~64세,2017,22623,10923,11700,93.4,21229,10244,10985,93.3
서울특별시,광진구,60세,2017,5204,2539,2665,95.3,4841,2362,2479,95.3
서울특별시,광진구,61세,2017,4813,2300,2513,91.5,4533,2171,2362,91.9
서울특별시,광진구,62세,2017,4941,2352,2589,90.8,4649,2207,2442,90.4
서울특별시,광진구,63세,2017,4073,2005,2068,97,3811,1874,1937,96.7
서울특별시,광진구,64세,2017,3592,1727,1865,92.6,3395,1630,1765,92.4
서울특별시,광진구,65~69세,2017,15146,7191,7955,90.4,14588,6939,7649,90.7
서울특별시,광진구,65세,2017,3822,1852,1970,94,3663,1774,1889,93.9
서울특별시,광진구,66세,2017,2688,1240,1448,85.6,2551,1185,1366,86.7
서울특별시,광진구,67세,2017,2843,1337,1506,88.8,2732,1285,1447,88.8
서울특별시,광진구,68세,2017,2907,1399,1508,92.8,2814,1359,1455,93.4
서울특별시,광진구,69세,2017,2886,1363,1523,89.5,2828,1336,1492,89.5
서울특별시,광진구,70~74세,2017,11323,5303,6020,88.1,11171,5237,5934,88.3
서울특별시,광진구,70세,2017,2810,1263,1547,81.6,2766,1244,1522,81.7
서울특별시,광진구,71세,2017,2252,1088,1164,93.5,2210,1069,1141,93.7
서울특별시,광진구,72세,2017,2089,1014,1075,94.3,2067,1007,1060,95
서울특별시,광진구,73세,2017,2139,973,1166,83.4,2115,960,1155,83.1
서울특별시,광진구,74세,2017,2033,965,1068,90.4,2013,957,1056,90.6
서울특별시,광진구,75~79세,2017,8694,3995,4699,85,8612,3967,4645,85.4
서울특별시,광진구,75세,2017,2300,1077,1223,88.1,2271,1063,1208,88
서울특별시,광진구,76세,2017,1812,840,972,86.4,1804,836,968,86.4
서울특별시,광진구,77세,2017,1643,767,876,87.6,1630,763,867,88
서울특별시,광진구,78세,2017,1529,692,837,82.7,1518,690,828,83.3
서울특별시,광진구,79세,2017,1410,619,791,78.3,1389,615,774,79.5
서울특별시,광진구,80~84세,2017,4509,1726,2783,62,4449,1709,2740,62.4
서울특별시,광진구,80세,2017,1183,508,675,75.3,1166,504,662,76.1
서울특별시,광진구,81세,2017,977,365,612,59.6,962,359,603,59.5
서울특별시,광진구,82세,2017,948,347,601,57.7,940,346,594,58.2
서울특별시,광진구,83세,2017,759,287,472,60.8,748,282,466,60.5
서울특별시,광진구,84세,2017,642,219,423,51.8,633,218,415,52.5
서울특별시,광진구,85세이상,2017,2903,845,2058,41.1,2879,839,2040,41.1
서울특별시,광진구,85~89세,2017,2053,641,1412,45.4,2037,637,1400,45.5
서울특별시,광진구,85세,2017,605,201,404,49.8,602,201,401,50.1
서울특별시,광진구,86세,2017,430,137,293,46.8,427,137,290,47.2
서울특별시,광진구,87세,2017,380,114,266,42.9,375,111,264,42
서울특별시,광진구,88세,2017,349,110,239,46,346,109,237,46
서울특별시,광진구,89세,2017,289,79,210,37.6,287,79,208,38
서울특별시,광진구,90~94세,2017,646,158,488,32.4,642,158,484,32.6
서울특별시,광진구,90세,2017,211,53,158,33.5,208,53,155,34.2
서울특별시,광진구,91세,2017,143,30,113,26.5,143,30,113,26.5
서울특별시,광진구,92세,2017,116,31,85,36.5,115,31,84,36.9
서울특별시,광진구,93세,2017,93,30,63,47.6,93,30,63,47.6
서울특별시,광진구,94세,2017,83,14,69,20.3,83,14,69,20.3
서울특별시,광진구,95~99세,2017,179,42,137,30.7,176,40,136,29.4
서울특별시,광진구,95세,2017,66,13,53,24.5,65,13,52,25
서울특별시,광진구,96세,2017,50,14,36,38.9,49,13,36,36.1
서울특별시,광진구,97세,2017,28,X,24,16.7,28,X,24,16.7
서울특별시,광진구,98세,2017,19,9,10,90,18,8,10,80
서울특별시,광진구,99세,2017,16,X,14,14.3,16,X,14,14.3
서울특별시,광진구,100세이상,2017,25,X,21,19,24,X,20,20
서울특별시,광진구,15세미만,2017,36540,18791,17749,105.9,35842,18417,17425,105.7
서울특별시,광진구,15~64세,2017,284819,139305,145514,95.7,267994,131725,136269,96.7
서울특별시,광진구,65세이상,2017,42575,19060,23515,81.1,41699,18691,23008,81.2
서울특별시,광진구,평균연령,2017,40.6,39.9,41.1,,40.6,40,41.3,
서울특별시,광진구,중위연령,2017,39.7,39.1,40.4,,39.8,39.1,40.6,
서울특별시,동대문구,합계,2017,357380,176460,180920,97.5,339438,168977,170461,99.1
서울특별시,동대문구,0~4세,2017,11675,6049,5626,107.5,11435,5939,5496,108.1
서울특별시,동대문구,0세,2017,2095,1098,997,110.1,2061,1081,980,110.3
서울특별시,동대문구,1세,2017,2346,1194,1152,103.6,2278,1166,1112,104.9
서울특별시,동대문구,2세,2017,2487,1274,1213,105,2425,1250,1175,106.4
서울특별시,동대문구,3세,2017,2370,1234,1136,108.6,2335,1215,1120,108.5
서울특별시,동대문구,4세,2017,2377,1249,1128,110.7,2336,1227,1109,110.6
서울특별시,동대문구,5~9세,2017,11753,5988,5765,103.9,11638,5921,5717,103.6
서울특별시,동대문구,5세,2017,2457,1236,1221,101.2,2427,1220,1207,101.1
서울특별시,동대문구,6세,2017,2420,1234,1186,104,2392,1212,1180,102.7
서울특별시,동대문구,7세,2017,2280,1177,1103,106.7,2263,1167,1096,106.5
서울특별시,동대문구,8세,2017,2197,1131,1066,106.1,2176,1120,1056,106.1
서울특별시,동대문구,9세,2017,2399,1210,1189,101.8,2380,1202,1178,102
서울특별시,동대문구,10~14세,2017,11421,5871,5550,105.8,11337,5832,5505,105.9
서울특별시,동대문구,10세,2017,2376,1232,1144,107.7,2352,1220,1132,107.8
서울특별시,동대문구,11세,2017,2244,1151,1093,105.3,2223,1143,1080,105.8
서울특별시,동대문구,12세,2017,2142,1106,1036,106.8,2124,1100,1024,107.4
서울특별시,동대문구,13세,2017,2276,1159,1117,103.8,2265,1152,1113,103.5
서울특별시,동대문구,14세,2017,2383,1223,1160,105.4,2373,1217,1156,105.3
서울특별시,동대문구,15~19세,2017,18280,8842,9438,93.7,16726,8289,8437,98.2
서울특별시,동대문구,15세,2017,2444,1238,1206,102.7,2427,1233,1194,103.3
서울특별시,동대문구,16세,2017,2721,1397,1324,105.5,2706,1391,1315,105.8
서울특별시,동대문구,17세,2017,3167,1587,1580,100.4,3093,1556,1537,101.2
서울특별시,동대문구,18세,2017,3880,1896,1984,95.6,3510,1769,1741,101.6
서울특별시,동대문구,19세,2017,6068,2724,3344,81.5,4990,2340,2650,88.3
서울특별시,동대문구,20~24세,2017,34493,16090,18403,87.4,29059,14308,14751,97
서울특별시,동대문구,20세,2017,6500,2767,3733,74.1,5283,2390,2893,82.6
서울특별시,동대문구,21세,2017,6536,2781,3755,74.1,5337,2379,2958,80.4
서울특별시,동대문구,22세,2017,6802,3142,3660,85.8,5684,2784,2900,96
서울특별시,동대문구,23세,2017,7347,3620,3727,97.1,6348,3291,3057,107.7
서울특별시,동대문구,24세,2017,7308,3780,3528,107.1,6407,3464,2943,117.7
서울특별시,동대문구,25~29세,2017,31196,16567,14629,113.2,28361,15437,12924,119.4
서울특별시,동대문구,25세,2017,7336,3871,3465,111.7,6589,3600,2989,120.4
서울특별시,동대문구,26세,2017,6638,3609,3029,119.1,6028,3364,2664,126.3
서울특별시,동대문구,27세,2017,6105,3272,2833,115.5,5555,3027,2528,119.7
서울특별시,동대문구,28세,2017,5660,3019,2641,114.3,5184,2829,2355,120.1
서울특별시,동대문구,29세,2017,5457,2796,2661,105.1,5005,2617,2388,109.6
서울특별시,동대문구,30~34세,2017,26038,13567,12471,108.8,24450,12775,11675,109.4
서울특별시,동대문구,30세,2017,5190,2756,2434,113.2,4764,2553,2211,115.5
서울특별시,동대문구,31세,2017,5135,2702,2433,111.1,4771,2503,2268,110.4
서울특별시,동대문구,32세,2017,5005,2585,2420,106.8,4713,2442,2271,107.5
서울특별시,동대문구,33세,2017,5110,2661,2449,108.7,4858,2526,2332,108.3
서울특별시,동대문구,34세,2017,5598,2863,2735,104.7,5344,2751,2593,106.1
서울특별시,동대문구,35~39세,2017,27379,14170,13209,107.3,26337,13612,12725,107
서울특별시,동대문구,35세,2017,5786,2970,2816,105.5,5527,2837,2690,105.5
서울특별시,동대문구,36세,2017,5763,2978,2785,106.9,5574,2880,2694,106.9
서울특별시,동대문구,37세,2017,5691,2965,2726,108.8,5479,2848,2631,108.2
서울특별시,동대문구,38세,2017,5344,2761,2583,106.9,5150,2655,2495,106.4
서울특별시,동대문구,39세,2017,4795,2496,2299,108.6,4607,2392,2215,108
서울특별시,동대문구,40~44세,2017,25441,13164,12277,107.2,24603,12726,11877,107.1
서울특별시,동대문구,40세,2017,4980,2565,2415,106.2,4808,2477,2331,106.3
서울특별시,동대문구,41세,2017,4815,2507,2308,108.6,4646,2420,2226,108.7
서울특별시,동대문구,42세,2017,5013,2615,2398,109,4868,2527,2341,107.9
서울특별시,동대문구,43세,2017,5277,2763,2514,109.9,5100,2670,2430,109.9
서울특별시,동대문구,44세,2017,5356,2714,2642,102.7,5181,2632,2549,103.3
서울특별시,동대문구,45~49세,2017,28231,14413,13818,104.3,27222,13875,13347,104
서울특별시,동대문구,45세,2017,5625,2974,2651,112.2,5428,2853,2575,110.8
서울특별시,동대문구,46세,2017,5909,3081,2828,108.9,5717,2987,2730,109.4
서울특별시,동대문구,47세,2017,5614,2825,2789,101.3,5399,2701,2698,100.1
서울특별시,동대문구,48세,2017,5595,2795,2800,99.8,5379,2685,2694,99.7
서울특별시,동대문구,49세,2017,5488,2738,2750,99.6,5299,2649,2650,100
서울특별시,동대문구,50~54세,2017,26057,13006,13051,99.7,24991,12515,12476,100.3
서울특별시,동대문구,50세,2017,5096,2458,2638,93.2,4932,2392,2540,94.2
서울특별시,동대문구,51세,2017,5106,2654,2452,108.2,4901,2563,2338,109.6
서울특별시,동대문구,52세,2017,5353,2643,2710,97.5,5129,2537,2592,97.9
서울특별시,동대문구,53세,2017,5115,2549,2566,99.3,4892,2446,2446,100
서울특별시,동대문구,54세,2017,5387,2702,2685,100.6,5137,2577,2560,100.7
서울특별시,동대문구,55~59세,2017,28445,13773,14672,93.9,27620,13391,14229,94.1
서울특별시,동대문구,55세,2017,5526,2723,2803,97.1,5304,2626,2678,98.1
서울특별시,동대문구,56세,2017,5861,2843,3018,94.2,5752,2782,2970,93.7
서울특별시,동대문구,57세,2017,6062,2871,3191,90,5860,2778,3082,90.1
서울특별시,동대문구,58세,2017,5562,2672,2890,92.5,5418,2603,2815,92.5
서울특별시,동대문구,59세,2017,5434,2664,2770,96.2,5286,2602,2684,96.9
서울특별시,동대문구,60~64세,2017,23936,11558,12378,93.4,23207,11218,11989,93.6
서울특별시,동대문구,60세,2017,5321,2572,2749,93.6,5127,2475,2652,93.3
서울특별시,동대문구,61세,2017,5003,2443,2560,95.4,4870,2376,2494,95.3
서울특별시,동대문구,62세,2017,5171,2487,2684,92.7,5007,2414,2593,93.1
서울특별시,동대문구,63세,2017,4480,2165,2315,93.5,4361,2107,2254,93.5
서울특별시,동대문구,64세,2017,3961,1891,2070,91.4,3842,1846,1996,92.5
서울특별시,동대문구,65~69세,2017,17514,8231,9283,88.7,17160,8054,9106,88.4
서울특별시,동대문구,65세,2017,4147,1910,2237,85.4,4052,1863,2189,85.1
서울특별시,동대문구,66세,2017,3137,1489,1648,90.4,3055,1448,1607,90.1
서울특별시,동대문구,67세,2017,3442,1690,1752,96.5,3375,1655,1720,96.2
서울특별시,동대문구,68세,2017,3398,1608,1790,89.8,3334,1575,1759,89.5
서울특별시,동대문구,69세,2017,3390,1534,1856,82.7,3344,1513,1831,82.6
서울특별시,동대문구,70~74세,2017,14314,6523,7791,83.7,14209,6473,7736,83.7
서울특별시,동대문구,70세,2017,3466,1574,1892,83.2,3429,1555,1874,83
서울특별시,동대문구,71세,2017,2754,1270,1484,85.6,2727,1256,1471,85.4
서울특별시,동대문구,72세,2017,2716,1231,1485,82.9,2700,1227,1473,83.3
서울특별시,동대문구,73세,2017,2620,1151,1469,78.4,2608,1146,1462,78.4
서울특별시,동대문구,74세,2017,2758,1297,1461,88.8,2745,1289,1456,88.5
서울특별시,동대문구,75~79세,2017,11573,5154,6419,80.3,11514,5138,6376,80.6
서울특별시,동대문구,75세,2017,3094,1395,1699,82.1,3081,1393,1688,82.5
서울특별시,동대문구,76세,2017,2399,1118,1281,87.3,2390,1113,1277,87.2
서울특별시,동대문구,77세,2017,2169,935,1234,75.8,2146,929,1217,76.3
서울특별시,동대문구,78세,2017,2069,906,1163,77.9,2063,905,1158,78.2
서울특별시,동대문구,79세,2017,1842,800,1042,76.8,1834,798,1036,77
서울특별시,동대문구,80~84세,2017,6117,2417,3700,65.3,6070,2402,3668,65.5
서울특별시,동대문구,80세,2017,1577,657,920,71.4,1563,654,909,71.9
서울특별시,동대문구,81세,2017,1379,575,804,71.5,1373,573,800,71.6
서울특별시,동대문구,82세,2017,1268,504,764,66,1255,501,754,66.4
서울특별시,동대문구,83세,2017,1051,386,665,58,1047,383,664,57.7
서울특별시,동대문구,84세,2017,842,295,547,53.9,832,291,541,53.8
서울특별시,동대문구,85세이상,2017,3517,1077,2440,44.1,3499,1072,2427,44.2
서울특별시,동대문구,85~89세,2017,2500,826,1674,49.3,2485,822,1663,49.4
서울특별시,동대문구,85세,2017,743,281,462,60.8,738,279,459,60.8
서울특별시,동대문구,86세,2017,523,169,354,47.7,518,168,350,48
서울특별시,동대문구,87세,2017,494,153,341,44.9,491,152,339,44.8
서울특별시,동대문구,88세,2017,415,125,290,43.1,414,125,289,43.3
서울특별시,동대문구,89세,2017,325,98,227,43.2,324,98,226,43.4
서울특별시,동대문구,90~94세,2017,818,204,614,33.2,816,203,613,33.1
서울특별시,동대문구,90세,2017,278,75,203,36.9,278,75,203,36.9
서울특별시,동대문구,91세,2017,178,38,140,27.1,177,37,140,26.4
서울특별시,동대문구,92세,2017,145,36,109,33,144,36,108,33.3
서울특별시,동대문구,93세,2017,101,21,80,26.3,101,21,80,26.3
서울특별시,동대문구,94세,2017,116,34,82,41.5,116,34,82,41.5
서울특별시,동대문구,95~99세,2017,174,40,134,29.9,173,40,133,30.1
서울특별시,동대문구,95세,2017,65,14,51,27.5,65,14,51,27.5
서울특별시,동대문구,96세,2017,43,8,35,22.9,43,8,35,22.9
서울특별시,동대문구,97세,2017,36,10,26,38.5,35,10,25,40
서울특별시,동대문구,98세,2017,15,6,9,66.7,15,6,9,66.7
서울특별시,동대문구,99세,2017,15,X,13,15.4,15,X,13,15.4
서울특별시,동대문구,100세이상,2017,25,7,18,38.9,25,7,18,38.9
서울특별시,동대문구,15세미만,2017,34849,17908,16941,105.7,34410,17692,16718,105.8
서울특별시,동대문구,15~64세,2017,269496,135150,134346,100.6,252576,128146,124430,103
서울특별시,동대문구,65세이상,2017,53035,23402,29633,79,52452,23139,29313,78.9
서울특별시,동대문구,평균연령,2017,41.8,41,42.6,,42.3,41.3,43.2,
서울특별시,동대문구,중위연령,2017,41.3,40.4,42.3,,42.2,41,43.5,
서울특별시,중랑구,합계,2017,396892,196346,200546,97.9,390879,193871,197008,98.4
서울특별시,중랑구,0~4세,2017,14249,7300,6949,105.1,14088,7216,6872,105
서울특별시,중랑구,0세,2017,2701,1371,1330,103.1,2661,1353,1308,103.4
서울특별시,중랑구,1세,2017,2877,1458,1419,102.7,2843,1440,1403,102.6
서울특별시,중랑구,2세,2017,2994,1579,1415,111.6,2967,1565,1402,111.6
서울특별시,중랑구,3세,2017,2823,1422,1401,101.5,2789,1403,1386,101.2
서울특별시,중랑구,4세,2017,2854,1470,1384,106.2,2828,1455,1373,106
서울특별시,중랑구,5~9세,2017,13641,6949,6692,103.8,13541,6901,6640,103.9
서울특별시,중랑구,5세,2017,3006,1554,1452,107,2980,1541,1439,107.1
서울특별시,중랑구,6세,2017,2833,1462,1371,106.6,2813,1449,1364,106.2
서울특별시,중랑구,7세,2017,2651,1347,1304,103.3,2631,1338,1293,103.5
서울특별시,중랑구,8세,2017,2486,1260,1226,102.8,2469,1256,1213,103.5
서울특별시,중랑구,9세,2017,2665,1326,1339,99,2648,1317,1331,98.9
서울특별시,중랑구,10~14세,2017,13302,6837,6465,105.8,13256,6818,6438,105.9
서울특별시,중랑구,10세,2017,2718,1380,1338,103.1,2709,1375,1334,103.1
서울특별시,중랑구,11세,2017,2537,1368,1169,117,2529,1365,1164,117.3
서울특별시,중랑구,12세,2017,2471,1297,1174,110.5,2461,1293,1168,110.7
서울특별시,중랑구,13세,2017,2696,1342,1354,99.1,2683,1338,1345,99.5
서울특별시,중랑구,14세,2017,2880,1450,1430,101.4,2874,1447,1427,101.4
서울특별시,중랑구,15~19세,2017,18148,9417,8731,107.9,18047,9377,8670,108.2
서울특별시,중랑구,15세,2017,2909,1529,1380,110.8,2897,1521,1376,110.5
서울특별시,중랑구,16세,2017,3395,1779,1616,110.1,3384,1774,1610,110.2
서울특별시,중랑구,17세,2017,3942,1974,1968,100.3,3922,1971,1951,101
서울특별시,중랑구,18세,2017,3900,2010,1890,106.3,3883,2000,1883,106.2
서울특별시,중랑구,19세,2017,4002,2125,1877,113.2,3961,2111,1850,114.1
서울특별시,중랑구,20~24세,2017,26324,13412,12912,103.9,25915,13249,12666,104.6
서울특별시,중랑구,20세,2017,4610,2401,2209,108.7,4541,2375,2166,109.6
서울특별시,중랑구,21세,2017,4996,2638,2358,111.9,4941,2609,2332,111.9
서울특별시,중랑구,22세,2017,5284,2745,2539,108.1,5198,2711,2487,109
서울특별시,중랑구,23세,2017,5556,2718,2838,95.8,5487,2696,2791,96.6
서울특별시,중랑구,24세,2017,5878,2910,2968,98,5748,2858,2890,98.9
서울특별시,중랑구,25~29세,2017,30101,14778,15323,96.4,29262,14451,14811,97.6
서울특별시,중랑구,25세,2017,6395,3135,3260,96.2,6251,3071,3180,96.6
서울특별시,중랑구,26세,2017,6037,2934,3103,94.6,5896,2880,3016,95.5
서울특별시,중랑구,27세,2017,5984,2930,3054,95.9,5803,2862,2941,97.3
서울특별시,중랑구,28세,2017,5841,2869,2972,96.5,5638,2793,2845,98.2
서울특별시,중랑구,29세,2017,5844,2910,2934,99.2,5674,2845,2829,100.6
서울특별시,중랑구,30~34세,2017,30372,15532,14840,104.7,29599,15217,14382,105.8
서울특별시,중랑구,30세,2017,5777,2900,2877,100.8,5602,2824,2778,101.7
서울특별시,중랑구,31세,2017,6021,3093,2928,105.6,5848,3026,2822,107.2
서울특별시,중랑구,32세,2017,5947,3029,2918,103.8,5805,2965,2840,104.4
서울특별시,중랑구,33세,2017,6118,3125,2993,104.4,5971,3061,2910,105.2
서울특별시,중랑구,34세,2017,6509,3385,3124,108.4,6373,3341,3032,110.2
서울특별시,중랑구,35~39세,2017,32189,16954,15235,111.3,31601,16699,14902,112.1
서울특별시,중랑구,35세,2017,6869,3553,3316,107.1,6744,3503,3241,108.1
서울특별시,중랑구,36세,2017,6837,3616,3221,112.3,6701,3568,3133,113.9
서울특별시,중랑구,37세,2017,6842,3596,3246,110.8,6732,3544,3188,111.2
서울특별시,중랑구,38세,2017,6252,3304,2948,112.1,6133,3250,2883,112.7
서울특별시,중랑구,39세,2017,5389,2885,2504,115.2,5291,2834,2457,115.3
서울특별시,중랑구,40~44세,2017,28473,14695,13778,106.7,28024,14509,13515,107.4
서울특별시,중랑구,40세,2017,5553,2914,2639,110.4,5479,2882,2597,111
서울특별시,중랑구,41세,2017,5336,2811,2525,111.3,5232,2767,2465,112.3
서울특별시,중랑구,42세,2017,5459,2802,2657,105.5,5379,2771,2608,106.3
서울특별시,중랑구,43세,2017,5979,3070,2909,105.5,5893,3037,2856,106.3
서울특별시,중랑구,44세,2017,6146,3098,3048,101.6,6041,3052,2989,102.1
서울특별시,중랑구,45~49세,2017,33718,16716,17002,98.3,33087,16450,16637,98.9
서울특별시,중랑구,45세,2017,6258,3131,3127,100.1,6135,3084,3051,101.1
서울특별시,중랑구,46세,2017,6886,3520,3366,104.6,6763,3467,3296,105.2
서울특별시,중랑구,47세,2017,6621,3295,3326,99.1,6480,3234,3246,99.6
서울특별시,중랑구,48세,2017,6953,3441,3512,98,6820,3383,3437,98.4
서울특별시,중랑구,49세,2017,7000,3329,3671,90.7,6889,3282,3607,91
서울특별시,중랑구,50~54세,2017,33371,16206,17165,94.4,32723,15948,16775,95.1
서울특별시,중랑구,50세,2017,6549,3113,3436,90.6,6448,3070,3378,90.9
서울특별시,중랑구,51세,2017,6455,3189,3266,97.6,6320,3135,3185,98.4
서울특별시,중랑구,52세,2017,6868,3311,3557,93.1,6732,3269,3463,94.4
서울특별시,중랑구,53세,2017,6645,3248,3397,95.6,6499,3181,3318,95.9
서울특별시,중랑구,54세,2017,6854,3345,3509,95.3,6724,3293,3431,96
서울특별시,중랑구,55~59세,2017,36858,18044,18814,95.9,36361,17845,18516,96.4
서울특별시,중랑구,55세,2017,7333,3705,3628,102.1,7203,3649,3554,102.7
서울특별시,중랑구,56세,2017,7935,3794,4141,91.6,7864,3766,4098,91.9
서울특별시,중랑구,57세,2017,7861,3824,4037,94.7,7750,3781,3969,95.3
서울특별시,중랑구,58세,2017,6963,3390,3573,94.9,6868,3358,3510,95.7
서울특별시,중랑구,59세,2017,6766,3331,3435,97,6676,3291,3385,97.2
서울특별시,중랑구,60~64세,2017,28897,14007,14890,94.1,28478,13826,14652,94.4
서울특별시,중랑구,60세,2017,6561,3183,3378,94.2,6455,3144,3311,95
서울특별시,중랑구,61세,2017,6076,2970,3106,95.6,5998,2936,3062,95.9
서울특별시,중랑구,62세,2017,6319,2999,3320,90.3,6230,2958,3272,90.4
서울특별시,중랑구,63세,2017,5337,2634,2703,97.4,5260,2601,2659,97.8
서울특별시,중랑구,64세,2017,4604,2221,2383,93.2,4535,2187,2348,93.1
서울특별시,중랑구,65~69세,2017,20449,9818,10631,92.4,20234,9720,10514,92.4
서울특별시,중랑구,65세,2017,5004,2440,2564,95.2,4938,2407,2531,95.1
서울특별시,중랑구,66세,2017,3645,1732,1913,90.5,3599,1711,1888,90.6
서울특별시,중랑구,67세,2017,3922,1919,2003,95.8,3890,1908,1982,96.3
서울특별시,중랑구,68세,2017,4001,1909,2092,91.3,3961,1889,2072,91.2
서울특별시,중랑구,69세,2017,3877,1818,2059,88.3,3846,1805,2041,88.4
서울특별시,중랑구,70~74세,2017,15447,7127,8320,85.7,15370,7107,8263,86
서울특별시,중랑구,70세,2017,3912,1817,2095,86.7,3892,1811,2081,87
서울특별시,중랑구,71세,2017,3001,1402,1599,87.7,2980,1396,1584,88.1
서울특별시,중랑구,72세,2017,2840,1302,1538,84.7,2826,1298,1528,84.9
서울특별시,중랑구,73세,2017,2859,1295,1564,82.8,2847,1293,1554,83.2
서울특별시,중랑구,74세,2017,2835,1311,1524,86,2825,1309,1516,86.3
서울특별시,중랑구,75~79세,2017,11731,5304,6427,82.5,11704,5296,6408,82.6
서울특별시,중랑구,75세,2017,3262,1501,1761,85.2,3257,1500,1757,85.4
서울특별시,중랑구,76세,2017,2526,1179,1347,87.5,2520,1178,1342,87.8
서울특별시,중랑구,77세,2017,2162,958,1204,79.6,2152,954,1198,79.6
서울특별시,중랑구,78세,2017,2039,925,1114,83,2036,924,1112,83.1
서울특별시,중랑구,79세,2017,1742,741,1001,74,1739,740,999,74.1
서울특별시,중랑구,80~84세,2017,5988,2318,3670,63.2,5969,2314,3655,63.3
서울특별시,중랑구,80세,2017,1536,660,876,75.3,1530,659,871,75.7
서울특별시,중랑구,81세,2017,1382,563,819,68.7,1379,562,817,68.8
서울특별시,중랑구,82세,2017,1253,454,799,56.8,1249,453,796,56.9
서울특별시,중랑구,83세,2017,1016,372,644,57.8,1013,371,642,57.8
서울특별시,중랑구,84세,2017,801,269,532,50.6,798,269,529,50.9
서울특별시,중랑구,85세이상,2017,3634,932,2702,34.5,3620,928,2692,34.5
서울특별시,중랑구,85~89세,2017,2576,700,1876,37.3,2566,697,1869,37.3
서울특별시,중랑구,85세,2017,687,240,447,53.7,683,238,445,53.5
서울특별시,중랑구,86세,2017,589,157,432,36.3,586,156,430,36.3
서울특별시,중랑구,87세,2017,506,123,383,32.1,504,123,381,32.3
서울특별시,중랑구,88세,2017,417,100,317,31.5,417,100,317,31.5
서울특별시,중랑구,89세,2017,377,80,297,26.9,376,80,296,27
서울특별시,중랑구,90~94세,2017,835,191,644,29.7,831,190,641,29.6
서울특별시,중랑구,90세,2017,265,67,198,33.8,264,67,197,34
서울특별시,중랑구,91세,2017,189,42,147,28.6,188,42,146,28.8
서울특별시,중랑구,92세,2017,159,28,131,21.4,159,28,131,21.4
서울특별시,중랑구,93세,2017,110,26,84,31,108,25,83,30.1
서울특별시,중랑구,94세,2017,112,28,84,33.3,112,28,84,33.3
서울특별시,중랑구,95~99세,2017,195,39,156,25,195,39,156,25
서울특별시,중랑구,95세,2017,74,13,61,21.3,74,13,61,21.3
서울특별시,중랑구,96세,2017,48,13,35,37.1,48,13,35,37.1
서울특별시,중랑구,97세,2017,38,8,30,26.7,38,8,30,26.7
서울특별시,중랑구,98세,2017,23,X,19,21.1,23,X,19,21.1
서울특별시,중랑구,99세,2017,12,X,11,9.1,12,X,11,9.1
서울특별시,중랑구,100세이상,2017,28,X,26,7.7,28,X,26,7.7
서울특별시,중랑구,15세미만,2017,41192,21086,20106,104.9,40885,20935,19950,104.9
서울특별시,중랑구,15~64세,2017,298451,149761,148690,100.7,293097,147571,145526,101.4
서울특별시,중랑구,65세이상,2017,57249,25499,31750,80.3,56897,25365,31532,80.4
서울특별시,중랑구,평균연령,2017,42.7,41.8,43.5,,42.7,41.8,43.6,
서울특별시,중랑구,중위연령,2017,43.6,42.5,44.8,,43.7,42.5,44.9,
서울특별시,성북구,합계,2017,445417,215068,230349,93.4,432226,209374,222852,94
서울특별시,성북구,0~4세,2017,15518,7872,7646,103,15304,7767,7537,103.1
서울특별시,성북구,0세,2017,2725,1375,1350,101.9,2676,1349,1327,101.7
서울특별시,성북구,1세,2017,3081,1553,1528,101.6,3036,1532,1504,101.9
서울특별시,성북구,2세,2017,3258,1680,1578,106.5,3218,1661,1557,106.7
서울특별시,성북구,3세,2017,3183,1623,1560,104,3143,1603,1540,104.1
서울특별시,성북구,4세,2017,3271,1641,1630,100.7,3231,1622,1609,100.8
서울특별시,성북구,5~9세,2017,17566,9074,8492,106.9,17464,9018,8446,106.8
서울특별시,성북구,5세,2017,3601,1894,1707,111,3581,1882,1699,110.8
서울특별시,성북구,6세,2017,3598,1846,1752,105.4,3577,1837,1740,105.6
서울특별시,성북구,7세,2017,3497,1754,1743,100.6,3473,1743,1730,100.8
서울특별시,성북구,8세,2017,3311,1715,1596,107.5,3294,1704,1590,107.2
서울특별시,성북구,9세,2017,3559,1865,1694,110.1,3539,1852,1687,109.8
서울특별시,성북구,10~14세,2017,17842,9222,8620,107,17773,9182,8591,106.9
서울특별시,성북구,10세,2017,3768,1971,1797,109.7,3752,1963,1789,109.7
서울특별시,성북구,11세,2017,3376,1697,1679,101.1,3359,1687,1672,100.9
서울특별시,성북구,12세,2017,3316,1741,1575,110.5,3308,1737,1571,110.6
서울특별시,성북구,13세,2017,3707,1912,1795,106.5,3687,1899,1788,106.2
서울특별시,성북구,14세,2017,3675,1901,1774,107.2,3667,1896,1771,107.1
서울특별시,성북구,15~19세,2017,25484,12354,13130,94.1,24365,11931,12434,96
서울특별시,성북구,15세,2017,3744,1887,1857,101.6,3735,1881,1854,101.5
서울특별시,성북구,16세,2017,4080,2045,2035,100.5,4065,2038,2027,100.5
서울특별시,성북구,17세,2017,4500,2294,2206,104,4446,2267,2179,104
서울특별시,성북구,18세,2017,5314,2588,2726,94.9,5043,2496,2547,98
서울특별시,성북구,19세,2017,7846,3540,4306,82.2,7076,3249,3827,84.9
서울특별시,성북구,20~24세,2017,40893,18432,22461,82.1,36691,16927,19764,85.6
서울특별시,성북구,20세,2017,8260,3329,4931,67.5,7221,3010,4211,71.5
서울특별시,성북구,21세,2017,7917,3368,4549,74,6974,3035,3939,77.1
서울특별시,성북구,22세,2017,8129,3631,4498,80.7,7241,3315,3926,84.4
서울특별시,성북구,23세,2017,8375,4012,4363,92,7648,3727,3921,95.1
서울특별시,성북구,24세,2017,8212,4092,4120,99.3,7607,3840,3767,101.9
서울특별시,성북구,25~29세,2017,34231,17424,16807,103.7,32220,16541,15679,105.5
서울특별시,성북구,25세,2017,7981,4013,3968,101.1,7486,3780,3706,102
서울특별시,성북구,26세,2017,7387,3851,3536,108.9,6977,3680,3297,111.6
서울특별시,성북구,27세,2017,6627,3359,3268,102.8,6224,3196,3028,105.5
서울특별시,성북구,28세,2017,6228,3200,3028,105.7,5858,3025,2833,106.8
서울특별시,성북구,29세,2017,6008,3001,3007,99.8,5675,2860,2815,101.6
서울특별시,성북구,30~34세,2017,29965,14952,15013,99.6,28623,14295,14328,99.8
서울특별시,성북구,30세,2017,5890,2970,2920,101.7,5585,2820,2765,102
서울특별시,성북구,31세,2017,5958,2975,2983,99.7,5653,2824,2829,99.8
서울특별시,성북구,32세,2017,5691,2786,2905,95.9,5437,2667,2770,96.3
서울특별시,성북구,33세,2017,5940,3002,2938,102.2,5694,2874,2820,101.9
서울특별시,성북구,34세,2017,6486,3219,3267,98.5,6254,3110,3144,98.9
서울특별시,성북구,35~39세,2017,33708,16815,16893,99.5,32785,16355,16430,99.5
서울특별시,성북구,35세,2017,6866,3387,3479,97.4,6677,3293,3384,97.3
서울특별시,성북구,36세,2017,7084,3636,3448,105.5,6890,3532,3358,105.2
서울특별시,성북구,37세,2017,6952,3410,3542,96.3,6787,3330,3457,96.3
서울특별시,성북구,38세,2017,6820,3407,3413,99.8,6641,3310,3331,99.4
서울특별시,성북구,39세,2017,5986,2975,3011,98.8,5790,2890,2900,99.7
서울특별시,성북구,40~44세,2017,34766,17273,17493,98.7,34060,16893,17167,98.4
서울특별시,성북구,40세,2017,6281,3111,3170,98.1,6147,3036,3111,97.6
서울특별시,성북구,41세,2017,6471,3223,3248,99.2,6336,3148,3188,98.7
서울특별시,성북구,42세,2017,6883,3406,3477,98,6753,3343,3410,98
서울특별시,성북구,43세,2017,7497,3747,3750,99.9,7367,3676,3691,99.6
서울특별시,성북구,44세,2017,7634,3786,3848,98.4,7457,3690,3767,98
서울특별시,성북구,45~49세,2017,38673,19441,19232,101.1,37904,19056,18848,101.1
서울특별시,성북구,45세,2017,7777,3959,3818,103.7,7624,3882,3742,103.7
서울특별시,성북구,46세,2017,8101,4083,4018,101.6,7936,3994,3942,101.3
서울특별시,성북구,47세,2017,7711,3837,3874,99,7558,3758,3800,98.9
서울특별시,성북구,48세,2017,7669,3862,3807,101.4,7518,3793,3725,101.8
서울특별시,성북구,49세,2017,7415,3700,3715,99.6,7268,3629,3639,99.7
서울특별시,성북구,50~54세,2017,32333,15774,16559,95.3,31693,15464,16229,95.3
서울특별시,성북구,50세,2017,6645,3276,3369,97.2,6509,3214,3295,97.5
서울특별시,성북구,51세,2017,6291,3124,3167,98.6,6178,3069,3109,98.7
서울특별시,성북구,52세,2017,6519,3182,3337,95.4,6398,3126,3272,95.5
서울특별시,성북구,53세,2017,6357,3064,3293,93,6233,2997,3236,92.6
서울특별시,성북구,54세,2017,6521,3128,3393,92.2,6375,3058,3317,92.2
서울특별시,성북구,55~59세,2017,33547,16083,17464,92.1,33123,15900,17223,92.3
서울특별시,성북구,55세,2017,6585,3191,3394,94,6490,3151,3339,94.4
서울특별시,성북구,56세,2017,6968,3341,3627,92.1,6887,3308,3579,92.4
서울특별시,성북구,57세,2017,7147,3328,3819,87.1,7049,3283,3766,87.2
서울특별시,성북구,58세,2017,6553,3188,3365,94.7,6471,3153,3318,95
서울특별시,성북구,59세,2017,6294,3035,3259,93.1,6226,3005,3221,93.3
서울특별시,성북구,60~64세,2017,27688,13051,14637,89.2,27337,12885,14452,89.2
서울특별시,성북구,60세,2017,6253,2919,3334,87.6,6161,2873,3288,87.4
서울특별시,성북구,61세,2017,5888,2798,3090,90.6,5813,2761,3052,90.5
서울특별시,성북구,62세,2017,5986,2783,3203,86.9,5911,2751,3160,87.1
서울특별시,성북구,63세,2017,5053,2430,2623,92.6,4999,2405,2594,92.7
서울특별시,성북구,64세,2017,4508,2121,2387,88.9,4453,2095,2358,88.8
서울특별시,성북구,65~69세,2017,20367,9356,11011,85,20193,9275,10918,85
서울특별시,성북구,65세,2017,4882,2298,2584,88.9,4836,2276,2560,88.9
서울특별시,성북구,66세,2017,3431,1607,1824,88.1,3401,1589,1812,87.7
서울특별시,성북구,67세,2017,4030,1864,2166,86.1,3986,1843,2143,86
서울특별시,성북구,68세,2017,4113,1859,2254,82.5,4082,1849,2233,82.8
서울특별시,성북구,69세,2017,3911,1728,2183,79.2,3888,1718,2170,79.2
서울특별시,성북구,70~74세,2017,16886,7540,9346,80.7,16821,7507,9314,80.6
서울특별시,성북구,70세,2017,4126,1847,2279,81,4112,1840,2272,81
서울특별시,성북구,71세,2017,3240,1424,1816,78.4,3223,1413,1810,78.1
서울특별시,성북구,72세,2017,3096,1388,1708,81.3,3090,1386,1704,81.3
서울특별시,성북구,73세,2017,3197,1410,1787,78.9,3177,1401,1776,78.9
서울특별시,성북구,74세,2017,3227,1471,1756,83.8,3219,1467,1752,83.7
서울특별시,성북구,75~79세,2017,14003,6172,7831,78.8,13966,6158,7808,78.9
서울특별시,성북구,75세,2017,3703,1685,2018,83.5,3697,1683,2014,83.6
서울특별시,성북구,76세,2017,2964,1360,1604,84.8,2958,1359,1599,85
서울특별시,성북구,77세,2017,2620,1114,1506,74,2613,1110,1503,73.9
서울특별시,성북구,78세,2017,2522,1085,1437,75.5,2509,1079,1430,75.5
서울특별시,성북구,79세,2017,2194,928,1266,73.3,2189,927,1262,73.5
서울특별시,성북구,80~84세,2017,7477,2940,4537,64.8,7448,2932,4516,64.9
서울특별시,성북구,80세,2017,1936,772,1164,66.3,1930,770,1160,66.4
서울특별시,성북구,81세,2017,1702,681,1021,66.7,1692,678,1014,66.9
서울특별시,성북구,82세,2017,1584,619,965,64.1,1582,619,963,64.3
서울특별시,성북구,83세,2017,1230,475,755,62.9,1225,473,752,62.9
서울특별시,성북구,84세,2017,1025,393,632,62.2,1019,392,627,62.5
서울특별시,성북구,85세이상,2017,4470,1293,3177,40.7,4456,1288,3168,40.7
서울특별시,성북구,85~89세,2017,3172,969,2203,44,3166,967,2199,44
서울특별시,성북구,85세,2017,857,282,575,49,854,281,573,49
서울특별시,성북구,86세,2017,722,233,489,47.6,721,232,489,47.4
서울특별시,성북구,87세,2017,628,184,444,41.4,627,184,443,41.5
서울특별시,성북구,88세,2017,528,147,381,38.6,527,147,380,38.7
서울특별시,성북구,89세,2017,437,123,314,39.2,437,123,314,39.2
서울특별시,성북구,90~94세,2017,1038,252,786,32.1,1033,250,783,31.9
서울특별시,성북구,90세,2017,357,88,269,32.7,357,88,269,32.7
서울특별시,성북구,91세,2017,256,62,194,32,252,60,192,31.3
서울특별시,성북구,92세,2017,175,36,139,25.9,175,36,139,25.9
서울특별시,성북구,93세,2017,121,33,88,37.5,121,33,88,37.5
서울특별시,성북구,94세,2017,129,33,96,34.4,128,33,95,34.7
서울특별시,성북구,95~99세,2017,237,65,172,37.8,236,64,172,37.2
서울특별시,성북구,95세,2017,95,29,66,43.9,95,29,66,43.9
서울특별시,성북구,96세,2017,56,15,41,36.6,56,15,41,36.6
서울특별시,성북구,97세,2017,39,7,32,21.9,39,7,32,21.9
서울특별시,성북구,98세,2017,33,11,22,50,33,11,22,50
서울특별시,성북구,99세,2017,14,X,11,27.3,13,X,11,18.2
서울특별시,성북구,100세이상,2017,23,7,16,43.8,21,7,14,50
서울특별시,성북구,15세미만,2017,50926,26168,24758,105.7,50541,25967,24574,105.7
서울특별시,성북구,15~64세,2017,331288,161599,169689,95.2,318801,156247,162554,96.1
서울특별시,성북구,65세이상,2017,63203,27301,35902,76,62884,27160,35724,76
서울특별시,성북구,평균연령,2017,41.1,40.3,41.8,,41.4,40.5,42.2,
서울특별시,성북구,중위연령,2017,41.2,40.4,41.9,,41.7,40.9,42.6,
서울특별시,강북구,합계,2017,313698,152464,161234,94.6,309255,150745,158510,95.1
서울특별시,강북구,0~4세,2017,9670,4919,4751,103.5,9609,4886,4723,103.5
서울특별시,강북구,0세,2017,1763,875,888,98.5,1749,869,880,98.8
서울특별시,강북구,1세,2017,1934,965,969,99.6,1923,959,964,99.5
서울특별시,강북구,2세,2017,1956,993,963,103.1,1943,987,956,103.2
서울특별시,강북구,3세,2017,1971,1005,966,104,1961,999,962,103.8
서울특별시,강북구,4세,2017,2046,1081,965,112,2033,1072,961,111.6
서울특별시,강북구,5~9세,2017,10514,5387,5127,105.1,10484,5378,5106,105.3
서울특별시,강북구,5세,2017,2168,1145,1023,111.9,2153,1138,1015,112.1
서울특별시,강북구,6세,2017,2130,1064,1066,99.8,2127,1064,1063,100.1
서울특별시,강북구,7세,2017,2076,1078,998,108,2070,1077,993,108.5
서울특별시,강북구,8세,2017,2053,1054,999,105.5,2051,1054,997,105.7
서울특별시,강북구,9세,2017,2087,1046,1041,100.5,2083,1045,1038,100.7
서울특별시,강북구,10~14세,2017,10846,5566,5280,105.4,10823,5555,5268,105.4
서울특별시,강북구,10세,2017,2128,1097,1031,106.4,2122,1094,1028,106.4
서울특별시,강북구,11세,2017,2079,1073,1006,106.7,2077,1072,1005,106.7
서울특별시,강북구,12세,2017,2065,1049,1016,103.2,2061,1049,1012,103.7
서울특별시,강북구,13세,2017,2184,1096,1088,100.7,2181,1095,1086,100.8
서울특별시,강북구,14세,2017,2390,1251,1139,109.8,2382,1245,1137,109.5
서울특별시,강북구,15~19세,2017,14891,7595,7296,104.1,14811,7564,7247,104.4
서울특별시,강북구,15세,2017,2379,1260,1119,112.6,2377,1259,1118,112.6
서울특별시,강북구,16세,2017,2767,1448,1319,109.8,2761,1446,1315,110
서울특별시,강북구,17세,2017,3141,1697,1444,117.5,3128,1690,1438,117.5
서울특별시,강북구,18세,2017,3110,1544,1566,98.6,3094,1540,1554,99.1
서울특별시,강북구,19세,2017,3494,1646,1848,89.1,3451,1629,1822,89.4
서울특별시,강북구,20~24세,2017,21210,10357,10853,95.4,20756,10215,10541,96.9
서울특별시,강북구,20세,2017,3890,1838,2052,89.6,3826,1814,2012,90.2
서울특별시,강북구,21세,2017,4110,2013,2097,96,4038,1993,2045,97.5
서울특별시,강북구,22세,2017,4242,2067,2175,95,4147,2039,2108,96.7
서울특별시,강북구,23세,2017,4469,2188,2281,95.9,4349,2150,2199,97.8
서울특별시,강북구,24세,2017,4499,2251,2248,100.1,4396,2219,2177,101.9
서울특별시,강북구,25~29세,2017,21689,10731,10958,97.9,20989,10487,10502,99.9
서울특별시,강북구,25세,2017,4745,2308,2437,94.7,4610,2259,2351,96.1
서울특별시,강북구,26세,2017,4547,2175,2372,91.7,4412,2125,2287,92.9
서울특별시,강북구,27세,2017,4208,2112,2096,100.8,4053,2056,1997,103
서울특별시,강북구,28세,2017,4203,2136,2067,103.3,4073,2094,1979,105.8
서울특별시,강북구,29세,2017,3986,2000,1986,100.7,3841,1953,1888,103.4
서울특별시,강북구,30~34세,2017,20727,10807,9920,108.9,20169,10603,9566,110.8
서울특별시,강북구,30세,2017,3853,1989,1864,106.7,3730,1946,1784,109.1
서울특별시,강북구,31세,2017,4079,2141,1938,110.5,3947,2093,1854,112.9
서울특별시,강북구,32세,2017,4040,2075,1965,105.6,3940,2043,1897,107.7
서울특별시,강북구,33세,2017,4238,2274,1964,115.8,4131,2234,1897,117.8
서울특별시,강북구,34세,2017,4517,2328,2189,106.3,4421,2287,2134,107.2
서울특별시,강북구,35~39세,2017,23655,12352,11303,109.3,23263,12179,11084,109.9
서울특별시,강북구,35세,2017,4921,2545,2376,107.1,4811,2497,2314,107.9
서울특별시,강북구,36세,2017,4877,2652,2225,119.2,4801,2619,2182,120
서울특별시,강북구,37세,2017,4995,2614,2381,109.8,4918,2577,2341,110.1
서울특별시,강북구,38세,2017,4705,2439,2266,107.6,4650,2416,2234,108.1
서울특별시,강북구,39세,2017,4157,2102,2055,102.3,4083,2070,2013,102.8
서울특별시,강북구,40~44세,2017,23507,12023,11484,104.7,23179,11886,11293,105.3
서울특별시,강북구,40세,2017,4410,2280,2130,107,4350,2255,2095,107.6
서울특별시,강북구,41세,2017,4297,2245,2052,109.4,4239,2222,2017,110.2
서울특별시,강북구,42세,2017,4570,2342,2228,105.1,4508,2321,2187,106.1
서울특별시,강북구,43세,2017,5033,2555,2478,103.1,4971,2526,2445,103.3
서울특별시,강북구,44세,2017,5197,2601,2596,100.2,5111,2562,2549,100.5
서울특별시,강북구,45~49세,2017,27238,13510,13728,98.4,26840,13337,13503,98.8
서울특별시,강북구,45세,2017,5297,2765,2532,109.2,5229,2737,2492,109.8
서울특별시,강북구,46세,2017,5598,2793,2805,99.6,5515,2757,2758,100
서울특별시,강북구,47세,2017,5431,2697,2734,98.6,5355,2669,2686,99.4
서울특별시,강북구,48세,2017,5497,2652,2845,93.2,5413,2613,2800,93.3
서울특별시,강북구,49세,2017,5415,2603,2812,92.6,5328,2561,2767,92.6
서울특별시,강북구,50~54세,2017,25061,12178,12883,94.5,24648,12021,12627,95.2
서울특별시,강북구,50세,2017,4976,2380,2596,91.7,4909,2356,2553,92.3
서울특별시,강북구,51세,2017,4773,2345,2428,96.6,4694,2314,2380,97.2
서울특별시,강북구,52세,2017,5124,2412,2712,88.9,5035,2374,2661,89.2
서울특별시,강북구,53세,2017,4918,2408,2510,95.9,4830,2382,2448,97.3
서울특별시,강북구,54세,2017,5270,2633,2637,99.8,5180,2595,2585,100.4
서울특별시,강북구,55~59세,2017,27541,12965,14576,88.9,27170,12820,14350,89.3
서울특별시,강북구,55세,2017,5241,2559,2682,95.4,5164,2533,2631,96.3
서울특별시,강북구,56세,2017,5790,2679,3111,86.1,5723,2653,3070,86.4
서울특별시,강북구,57세,2017,5931,2718,3213,84.6,5841,2686,3155,85.1
서울특별시,강북구,58세,2017,5374,2547,2827,90.1,5295,2512,2783,90.3
서울특별시,강북구,59세,2017,5205,2462,2743,89.8,5147,2436,2711,89.9
서울특별시,강북구,60~64세,2017,22863,10709,12154,88.1,22526,10561,11965,88.3
서울특별시,강북구,60세,2017,5081,2481,2600,95.4,4999,2441,2558,95.4
서울특별시,강북구,61세,2017,4779,2260,2519,89.7,4731,2238,2493,89.8
서울특별시,강북구,62세,2017,5021,2320,2701,85.9,4934,2289,2645,86.5
서울특별시,강북구,63세,2017,4283,1970,2313,85.2,4217,1938,2279,85
서울특별시,강북구,64세,2017,3699,1678,2021,83,3645,1655,1990,83.2
서울특별시,강북구,65~69세,2017,17988,8031,9957,80.7,17821,7962,9859,80.8
서울특별시,강북구,65세,2017,4192,1915,2277,84.1,4146,1896,2250,84.3
서울특별시,강북구,66세,2017,3146,1429,1717,83.2,3107,1413,1694,83.4
서울특별시,강북구,67세,2017,3388,1459,1929,75.6,3351,1446,1905,75.9
서울특별시,강북구,68세,2017,3681,1634,2047,79.8,3659,1623,2036,79.7
서울특별시,강북구,69세,2017,3581,1594,1987,80.2,3558,1584,1974,80.2
서울특별시,강북구,70~74세,2017,14915,6552,8363,78.3,14851,6529,8322,78.5
서울특별시,강북구,70세,2017,3644,1617,2027,79.8,3629,1613,2016,80
서울특별시,강북구,71세,2017,2807,1216,1591,76.4,2787,1209,1578,76.6
서울특별시,강북구,72세,2017,2812,1188,1624,73.2,2799,1185,1614,73.4
서울특별시,강북구,73세,2017,2792,1283,1509,85,2781,1276,1505,84.8
서울특별시,강북구,74세,2017,2860,1248,1612,77.4,2855,1246,1609,77.4
서울특별시,강북구,75~79세,2017,12074,5393,6681,80.7,12041,5382,6659,80.8
서울특별시,강북구,75세,2017,3318,1538,1780,86.4,3312,1536,1776,86.5
서울특별시,강북구,76세,2017,2630,1201,1429,84,2621,1198,1423,84.2
서울특별시,강북구,77세,2017,2197,990,1207,82,2191,988,1203,82.1
서울특별시,강북구,78세,2017,2102,881,1221,72.2,2096,878,1218,72.1
서울특별시,강북구,79세,2017,1827,783,1044,75,1821,782,1039,75.3
서울특별시,강북구,80~84세,2017,5939,2428,3511,69.2,5924,2424,3500,69.3
서울특별시,강북구,80세,2017,1562,680,882,77.1,1557,679,878,77.3
서울특별시,강북구,81세,2017,1460,608,852,71.4,1458,608,850,71.5
서울특별시,강북구,82세,2017,1191,482,709,68,1188,481,707,68
서울특별시,강북구,83세,2017,957,371,586,63.3,955,370,585,63.2
서울특별시,강북구,84세,2017,769,287,482,59.5,766,286,480,59.6
서울특별시,강북구,85세이상,2017,3370,961,2409,39.9,3351,956,2395,39.9
서울특별시,강북구,85~89세,2017,2382,731,1651,44.3,2370,729,1641,44.4
서울특별시,강북구,85세,2017,684,233,451,51.7,683,233,450,51.8
서울특별시,강북구,86세,2017,471,148,323,45.8,469,147,322,45.7
서울특별시,강북구,87세,2017,462,123,339,36.3,460,123,337,36.5
서울특별시,강북구,88세,2017,435,130,305,42.6,431,129,302,42.7
서울특별시,강북구,89세,2017,330,97,233,41.6,327,97,230,42.2
서울특별시,강북구,90~94세,2017,778,190,588,32.3,773,188,585,32.1
서울특별시,강북구,90세,2017,229,66,163,40.5,229,66,163,40.5
서울특별시,강북구,91세,2017,183,40,143,28,182,39,143,27.3
서울특별시,강북구,92세,2017,145,32,113,28.3,142,31,111,27.9
서울특별시,강북구,93세,2017,120,21,99,21.2,120,21,99,21.2
서울특별시,강북구,94세,2017,101,31,70,44.3,100,31,69,44.9
서울특별시,강북구,95~99세,2017,185,35,150,23.3,184,34,150,22.7
서울특별시,강북구,95세,2017,75,16,59,27.1,75,16,59,27.1
서울특별시,강북구,96세,2017,50,10,40,25,50,10,40,25
서울특별시,강북구,97세,2017,29,5,24,20.8,29,5,24,20.8
서울특별시,강북구,98세,2017,19,X,18,5.6,19,X,18,5.6
서울특별시,강북구,99세,2017,12,X,9,33.3,11,X,9,22.2
서울특별시,강북구,100세이상,2017,25,5,20,25,24,5,19,26.3
서울특별시,강북구,15세미만,2017,31030,15872,15158,104.7,30916,15819,15097,104.8
서울특별시,강북구,15~64세,2017,228382,113227,115155,98.3,224351,111673,112678,99.1
서울특별시,강북구,65세이상,2017,54286,23365,30921,75.6,53988,23253,30735,75.7
서울특별시,강북구,평균연령,2017,43.9,42.8,45,,43.9,42.8,45,
서울특별시,강북구,중위연령,2017,45,43.6,46.4,,45.1,43.7,46.5,
서울특별시,도봉구,합계,2017,332586,161944,170642,94.9,329957,160885,169072,95.2
서울특별시,도봉구,0~4세,2017,11070,5676,5394,105.2,11021,5651,5370,105.2
서울특별시,도봉구,0세,2017,1931,972,959,101.4,1918,967,951,101.7
서울특별시,도봉구,1세,2017,2216,1133,1083,104.6,2203,1127,1076,104.7
서울특별시,도봉구,2세,2017,2362,1217,1145,106.3,2352,1210,1142,106
서울특별시,도봉구,3세,2017,2329,1182,1147,103.1,2323,1178,1145,102.9
서울특별시,도봉구,4세,2017,2232,1172,1060,110.6,2225,1169,1056,110.7
서울특별시,도봉구,5~9세,2017,12029,6217,5812,107,12011,6206,5805,106.9
서울특별시,도봉구,5세,2017,2508,1310,1198,109.3,2504,1308,1196,109.4
서울특별시,도봉구,6세,2017,2450,1249,1201,104,2444,1245,1199,103.8
서울특별시,도봉구,7세,2017,2394,1222,1172,104.3,2391,1220,1171,104.2
서울특별시,도봉구,8세,2017,2313,1198,1115,107.4,2310,1195,1115,107.2
서울특별시,도봉구,9세,2017,2364,1238,1126,109.9,2362,1238,1124,110.1
서울특별시,도봉구,10~14세,2017,12821,6596,6225,106,12804,6588,6216,106
서울특별시,도봉구,10세,2017,2696,1400,1296,108,2692,1398,1294,108
서울특별시,도봉구,11세,2017,2377,1236,1141,108.3,2375,1235,1140,108.3
서울특별시,도봉구,12세,2017,2284,1151,1133,101.6,2279,1148,1131,101.5
서울특별시,도봉구,13세,2017,2763,1426,1337,106.7,2762,1426,1336,106.7
서울특별시,도봉구,14세,2017,2701,1383,1318,104.9,2696,1381,1315,105
서울특별시,도봉구,15~19세,2017,17489,8832,8657,102,17417,8810,8607,102.4
서울특별시,도봉구,15세,2017,2910,1487,1423,104.5,2908,1485,1423,104.4
서울특별시,도봉구,16세,2017,3305,1753,1552,113,3300,1751,1549,113
서울특별시,도봉구,17세,2017,3695,1885,1810,104.1,3690,1883,1807,104.2
서울특별시,도봉구,18세,2017,3730,1912,1818,105.2,3708,1904,1804,105.5
서울특별시,도봉구,19세,2017,3849,1795,2054,87.4,3811,1787,2024,88.3
서울특별시,도봉구,20~24세,2017,22740,11402,11338,100.6,22468,11314,11154,101.4
서울특별시,도봉구,20세,2017,4383,2182,2201,99.1,4338,2171,2167,100.2
서울특별시,도봉구,21세,2017,4440,2257,2183,103.4,4391,2243,2148,104.4
서울특별시,도봉구,22세,2017,4500,2291,2209,103.7,4455,2276,2179,104.5
서울특별시,도봉구,23세,2017,4566,2265,2301,98.4,4504,2242,2262,99.1
서울특별시,도봉구,24세,2017,4851,2407,2444,98.5,4780,2382,2398,99.3
서울특별시,도봉구,25~29세,2017,22184,11030,11154,98.9,21805,10891,10914,99.8
서울특별시,도봉구,25세,2017,4834,2340,2494,93.8,4765,2323,2442,95.1
서울특별시,도봉구,26세,2017,4579,2296,2283,100.6,4511,2269,2242,101.2
서울특별시,도봉구,27세,2017,4356,2174,2182,99.6,4280,2146,2134,100.6
서울특별시,도봉구,28세,2017,4240,2121,2119,100.1,4157,2088,2069,100.9
서울특별시,도봉구,29세,2017,4175,2099,2076,101.1,4092,2065,2027,101.9
서울특별시,도봉구,30~34세,2017,21428,11080,10348,107.1,21075,10942,10133,108
서울특별시,도봉구,30세,2017,4020,2047,1973,103.8,3953,2032,1921,105.8
서울특별시,도봉구,31세,2017,4173,2170,2003,108.3,4097,2128,1969,108.1
서울특별시,도봉구,32세,2017,4234,2151,2083,103.3,4157,2124,2033,104.5
서울특별시,도봉구,33세,2017,4340,2233,2107,106,4269,2206,2063,106.9
서울특별시,도봉구,34세,2017,4661,2479,2182,113.6,4599,2452,2147,114.2
서울특별시,도봉구,35~39세,2017,24202,12215,11987,101.9,23935,12096,11839,102.2
서울특별시,도봉구,35세,2017,5077,2567,2510,102.3,5016,2535,2481,102.2
서울특별시,도봉구,36세,2017,5011,2529,2482,101.9,4953,2506,2447,102.4
서울특별시,도봉구,37세,2017,5035,2530,2505,101,4994,2515,2479,101.5
서울특별시,도봉구,38세,2017,4776,2421,2355,102.8,4725,2397,2328,103
서울특별시,도봉구,39세,2017,4303,2168,2135,101.5,4247,2143,2104,101.9
서울특별시,도봉구,40~44세,2017,24265,12011,12254,98,24064,11925,12139,98.2
서울특별시,도봉구,40세,2017,4480,2277,2203,103.4,4444,2259,2185,103.4
서울특별시,도봉구,41세,2017,4435,2228,2207,101,4388,2211,2177,101.6
서울특별시,도봉구,42세,2017,4720,2294,2426,94.6,4685,2281,2404,94.9
서울특별시,도봉구,43세,2017,5148,2577,2571,100.2,5105,2559,2546,100.5
서울특별시,도봉구,44세,2017,5482,2635,2847,92.6,5442,2615,2827,92.5
서울특별시,도봉구,45~49세,2017,29293,14148,15145,93.4,29051,14044,15007,93.6
서울특별시,도봉구,45세,2017,5532,2770,2762,100.3,5481,2740,2741,100
서울특별시,도봉구,46세,2017,5970,2872,3098,92.7,5918,2849,3069,92.8
서울특별시,도봉구,47세,2017,5878,2883,2995,96.3,5835,2868,2967,96.7
서울특별시,도봉구,48세,2017,5897,2779,3118,89.1,5853,2758,3095,89.1
서울특별시,도봉구,49세,2017,6016,2844,3172,89.7,5964,2829,3135,90.2
서울특별시,도봉구,50~54세,2017,27485,13182,14303,92.2,27267,13083,14184,92.2
서울특별시,도봉구,50세,2017,5479,2559,2920,87.6,5443,2541,2902,87.6
서울특별시,도봉구,51세,2017,5438,2659,2779,95.7,5394,2647,2747,96.4
서울특별시,도봉구,52세,2017,5553,2608,2945,88.6,5501,2582,2919,88.5
서울특별시,도봉구,53세,2017,5338,2564,2774,92.4,5299,2542,2757,92.2
서울특별시,도봉구,54세,2017,5677,2792,2885,96.8,5630,2771,2859,96.9
서울특별시,도봉구,55~59세,2017,30631,14379,16252,88.5,30457,14312,16145,88.6
서울특별시,도봉구,55세,2017,5945,2837,3108,91.3,5907,2826,3081,91.7
서울특별시,도봉구,56세,2017,6351,2943,3408,86.4,6320,2931,3389,86.5
서울특별시,도봉구,57세,2017,6560,3055,3505,87.2,6516,3031,3485,87
서울특별시,도봉구,58세,2017,5989,2817,3172,88.8,5960,2810,3150,89.2
서울특별시,도봉구,59세,2017,5786,2727,3059,89.1,5754,2714,3040,89.3
서울특별시,도봉구,60~64세,2017,24878,12106,12772,94.8,24690,12026,12664,95
서울특별시,도봉구,60세,2017,5825,2862,2963,96.6,5778,2840,2938,96.7
서울특별시,도봉구,61세,2017,5265,2512,2753,91.2,5221,2492,2729,91.3
서울특별시,도봉구,62세,2017,5467,2601,2866,90.8,5433,2587,2846,90.9
서울특별시,도봉구,63세,2017,4463,2209,2254,98,4426,2196,2230,98.5
서울특별시,도봉구,64세,2017,3858,1922,1936,99.3,3832,1911,1921,99.5
서울특별시,도봉구,65~69세,2017,17270,8338,8932,93.3,17177,8295,8882,93.4
서울특별시,도봉구,65세,2017,4251,2068,2183,94.7,4217,2052,2165,94.8
서울특별시,도봉구,66세,2017,3047,1450,1597,90.8,3026,1445,1581,91.4
서울특별시,도봉구,67세,2017,3340,1608,1732,92.8,3324,1597,1727,92.5
서울특별시,도봉구,68세,2017,3289,1589,1700,93.5,3276,1582,1694,93.4
서울특별시,도봉구,69세,2017,3343,1623,1720,94.4,3334,1619,1715,94.4
서울특별시,도봉구,70~74세,2017,13504,6225,7279,85.5,13462,6210,7252,85.6
서울특별시,도봉구,70세,2017,3328,1533,1795,85.4,3317,1528,1789,85.4
서울특별시,도봉구,71세,2017,2565,1207,1358,88.9,2559,1205,1354,89
서울특별시,도봉구,72세,2017,2540,1178,1362,86.5,2528,1173,1355,86.6
서울특별시,도봉구,73세,2017,2500,1151,1349,85.3,2493,1149,1344,85.5
서울특별시,도봉구,74세,2017,2571,1156,1415,81.7,2565,1155,1410,81.9
서울특별시,도봉구,75~79세,2017,11178,5002,6176,81,11154,4992,6162,81
서울특별시,도봉구,75세,2017,2955,1384,1571,88.1,2953,1383,1570,88.1
서울특별시,도봉구,76세,2017,2391,1109,1282,86.5,2384,1106,1278,86.5
서울특별시,도봉구,77세,2017,2055,896,1159,77.3,2051,894,1157,77.3
서울특별시,도봉구,78세,2017,2038,869,1169,74.3,2034,868,1166,74.4
서울특별시,도봉구,79세,2017,1739,744,995,74.8,1732,741,991,74.8
서울특별시,도봉구,80~84세,2017,6059,2317,3742,61.9,6050,2315,3735,62
서울특별시,도봉구,80세,2017,1548,632,916,69,1545,631,914,69
서울특별시,도봉구,81세,2017,1350,535,815,65.6,1348,534,814,65.6
서울특별시,도봉구,82세,2017,1245,481,764,63,1242,481,761,63.2
서울특별시,도봉구,83세,2017,1019,357,662,53.9,1018,357,661,54
서울특별시,도봉구,84세,2017,897,312,585,53.3,897,312,585,53.3
서울특별시,도봉구,85세이상,2017,4060,1188,2872,41.4,4049,1185,2864,41.4
서울특별시,도봉구,85~89세,2017,2862,884,1978,44.7,2858,884,1974,44.8
서울특별시,도봉구,85세,2017,809,252,557,45.2,809,252,557,45.2
서울특별시,도봉구,86세,2017,623,203,420,48.3,621,203,418,48.6
서울특별시,도봉구,87세,2017,532,158,374,42.2,531,158,373,42.4
서울특별시,도봉구,88세,2017,499,158,341,46.3,498,158,340,46.5
서울특별시,도봉구,89세,2017,399,113,286,39.5,399,113,286,39.5
서울특별시,도봉구,90~94세,2017,967,256,711,36,963,255,708,36
서울특별시,도봉구,90세,2017,322,102,220,46.4,322,102,220,46.4
서울특별시,도봉구,91세,2017,208,60,148,40.5,206,60,146,41.1
서울특별시,도봉구,92세,2017,180,31,149,20.8,179,31,148,20.9
서울특별시,도봉구,93세,2017,122,28,94,29.8,122,28,94,29.8
서울특별시,도봉구,94세,2017,135,35,100,35,134,34,100,34
서울특별시,도봉구,95~99세,2017,202,43,159,27,200,42,158,26.6
서울특별시,도봉구,95세,2017,79,15,64,23.4,79,15,64,23.4
서울특별시,도봉구,96세,2017,57,16,41,39,56,16,40,40
서울특별시,도봉구,97세,2017,34,X,31,9.7,34,X,31,9.7
서울특별시,도봉구,98세,2017,19,6,13,46.2,19,6,13,46.2
서울특별시,도봉구,99세,2017,13,X,10,30,12,X,10,20
서울특별시,도봉구,100세이상,2017,29,5,24,20.8,28,X,24,16.7
서울특별시,도봉구,15세미만,2017,35920,18489,17431,106.1,35836,18445,17391,106.1
서울특별시,도봉구,15~64세,2017,244595,120385,124210,96.9,242229,119443,122786,97.3
서울특별시,도봉구,65세이상,2017,52071,23070,29001,79.5,51892,22997,28895,79.6
서울특별시,도봉구,평균연령,2017,43.2,42.2,44.1,,43.2,42.2,44.2,
서울특별시,도봉구,중위연령,2017,44.6,43.4,45.8,,44.7,43.5,45.9,
서울특별시,노원구,합계,2017,543499,263655,279844,94.2,538768,261563,277205,94.4
서울특별시,노원구,0~4세,2017,19139,9783,9356,104.6,19081,9757,9324,104.6
서울특별시,노원구,0세,2017,3497,1747,1750,99.8,3483,1741,1742,99.9
서울특별시,노원구,1세,2017,3877,2013,1864,108,3867,2005,1862,107.7
서울특별시,노원구,2세,2017,4024,2075,1949,106.5,4014,2073,1941,106.8
서울특별시,노원구,3세,2017,3891,1991,1900,104.8,3877,1986,1891,105
서울특별시,노원구,4세,2017,3850,1957,1893,103.4,3840,1952,1888,103.4
서울특별시,노원구,5~9세,2017,21520,11022,10498,105,21484,10999,10485,104.9
서울특별시,노원구,5세,2017,4241,2182,2059,106,4231,2177,2054,106
서울특별시,노원구,6세,2017,4176,2114,2062,102.5,4169,2110,2059,102.5
서울특별시,노원구,7세,2017,4221,2174,2047,106.2,4214,2169,2045,106.1
서울특별시,노원구,8세,2017,4162,2126,2036,104.4,4154,2120,2034,104.2
서울특별시,노원구,9세,2017,4720,2426,2294,105.8,4716,2423,2293,105.7
서울특별시,노원구,10~14세,2017,26318,13689,12629,108.4,26299,13681,12618,108.4
서울특별시,노원구,10세,2017,4974,2562,2412,106.2,4970,2559,2411,106.1
서울특별시,노원구,11세,2017,4800,2528,2272,111.3,4796,2527,2269,111.4
서울특별시,노원구,12세,2017,5056,2620,2436,107.6,5053,2619,2434,107.6
서울특별시,노원구,13세,2017,5676,2933,2743,106.9,5672,2932,2740,107
서울특별시,노원구,14세,2017,5812,3046,2766,110.1,5808,3044,2764,110.1
서울특별시,노원구,15~19세,2017,36663,18949,17714,107,36391,18822,17569,107.1
서울특별시,노원구,15세,2017,6143,3159,2984,105.9,6139,3158,2981,105.9
서울특별시,노원구,16세,2017,6856,3623,3233,112.1,6847,3615,3232,111.9
서울특별시,노원구,17세,2017,7610,4046,3564,113.5,7577,4032,3545,113.7
서울특별시,노원구,18세,2017,7605,3901,3704,105.3,7519,3858,3661,105.4
서울특별시,노원구,19세,2017,8449,4220,4229,99.8,8309,4159,4150,100.2
서울특별시,노원구,20~24세,2017,42863,21916,20947,104.6,41938,21508,20430,105.3
서울특별시,노원구,20세,2017,8579,4133,4446,93,8355,4041,4314,93.7
서울특별시,노원구,21세,2017,8348,4118,4230,97.4,8167,4032,4135,97.5
서울특별시,노원구,22세,2017,8781,4509,4272,105.5,8615,4442,4173,106.4
서울특별시,노원구,23세,2017,8675,4586,4089,112.2,8490,4512,3978,113.4
서울특별시,노원구,24세,2017,8480,4570,3910,116.9,8311,4481,3830,117
서울특별시,노원구,25~29세,2017,34403,17717,16686,106.2,33640,17391,16249,107
서울특별시,노원구,25세,2017,7985,4284,3701,115.8,7831,4213,3618,116.4
서울특별시,노원구,26세,2017,7288,3767,3521,107,7114,3690,3424,107.8
서울특별시,노원구,27세,2017,6689,3464,3225,107.4,6530,3396,3134,108.4
서울특별시,노원구,28세,2017,6307,3182,3125,101.8,6168,3126,3042,102.8
서울특별시,노원구,29세,2017,6134,3020,3114,97,5997,2966,3031,97.9
서울특별시,노원구,30~34세,2017,33386,16484,16902,97.5,32828,16251,16577,98
서울특별시,노원구,30세,2017,6145,3046,3099,98.3,6007,2996,3011,99.5
서울특별시,노원구,31세,2017,6440,3135,3305,94.9,6318,3083,3235,95.3
서울특별시,노원구,32세,2017,6535,3244,3291,98.6,6422,3199,3223,99.3
서울특별시,노원구,33세,2017,6742,3322,3420,97.1,6654,3280,3374,97.2
서울특별시,노원구,34세,2017,7524,3737,3787,98.7,7427,3693,3734,98.9
서울특별시,노원구,35~39세,2017,39805,19797,20008,98.9,39392,19615,19777,99.2
서울특별시,노원구,35세,2017,8065,4020,4045,99.4,7971,3982,3989,99.8
서울특별시,노원구,36세,2017,8108,4129,3979,103.8,8017,4089,3928,104.1
서울특별시,노원구,37세,2017,8317,4072,4245,95.9,8237,4039,4198,96.2
서울특별시,노원구,38세,2017,7975,3956,4019,98.4,7903,3925,3978,98.7
서울특별시,노원구,39세,2017,7340,3620,3720,97.3,7264,3580,3684,97.2
서울특별시,노원구,40~44세,2017,43094,20522,22572,90.9,42746,20352,22394,90.9
서울특별시,노원구,40세,2017,7748,3688,4060,90.8,7681,3656,4025,90.8
서울특별시,노원구,41세,2017,7624,3697,3927,94.1,7560,3666,3894,94.1
서울특별시,노원구,42세,2017,8489,3967,4522,87.7,8411,3925,4486,87.5
서울특별시,노원구,43세,2017,9383,4475,4908,91.2,9315,4442,4873,91.2
서울특별시,노원구,44세,2017,9850,4695,5155,91.1,9779,4663,5116,91.1
서울특별시,노원구,45~49세,2017,52511,25197,27314,92.2,52124,25008,27116,92.2
서울특별시,노원구,45세,2017,10069,4766,5303,89.9,9995,4724,5271,89.6
서울특별시,노원구,46세,2017,11096,5303,5793,91.5,11022,5267,5755,91.5
서울특별시,노원구,47세,2017,10618,5079,5539,91.7,10532,5037,5495,91.7
서울특별시,노원구,48세,2017,10513,5126,5387,95.2,10437,5092,5345,95.3
서울특별시,노원구,49세,2017,10215,4923,5292,93,10138,4888,5250,93.1
서울특별시,노원구,50~54세,2017,43850,21467,22383,95.9,43495,21315,22180,96.1
서울특별시,노원구,50세,2017,9257,4522,4735,95.5,9182,4483,4699,95.4
서울특별시,노원구,51세,2017,8754,4390,4364,100.6,8682,4353,4329,100.6
서울특별시,노원구,52세,2017,8840,4269,4571,93.4,8771,4243,4528,93.7
서울특별시,노원구,53세,2017,8293,4136,4157,99.5,8220,4105,4115,99.8
서울특별시,노원구,54세,2017,8706,4150,4556,91.1,8640,4131,4509,91.6
서울특별시,노원구,55~59세,2017,43849,20965,22884,91.6,43629,20882,22747,91.8
서울특별시,노원구,55세,2017,8779,4308,4471,96.4,8723,4287,4436,96.6
서울특별시,노원구,56세,2017,9274,4478,4796,93.4,9232,4466,4766,93.7
서울특별시,노원구,57세,2017,9348,4382,4966,88.2,9301,4365,4936,88.4
서울특별시,노원구,58세,2017,8357,3928,4429,88.7,8319,3915,4404,88.9
서울특별시,노원구,59세,2017,8091,3869,4222,91.6,8054,3849,4205,91.5
서울특별시,노원구,60~64세,2017,34479,16310,18169,89.8,34290,16230,18060,89.9
서울특별시,노원구,60세,2017,7932,3770,4162,90.6,7885,3743,4142,90.4
서울특별시,노원구,61세,2017,7284,3420,3864,88.5,7247,3410,3837,88.9
서울특별시,노원구,62세,2017,7521,3476,4045,85.9,7482,3462,4020,86.1
서울특별시,노원구,63세,2017,6324,3024,3300,91.6,6284,3007,3277,91.8
서울특별시,노원구,64세,2017,5418,2620,2798,93.6,5392,2608,2784,93.7
서울특별시,노원구,65~69세,2017,23815,11113,12702,87.5,23726,11071,12655,87.5
서울특별시,노원구,65세,2017,5948,2845,3103,91.7,5912,2829,3083,91.8
서울특별시,노원구,66세,2017,4175,1953,2222,87.9,4156,1944,2212,87.9
서울특별시,노원구,67세,2017,4623,2161,2462,87.8,4612,2157,2455,87.9
서울특별시,노원구,68세,2017,4637,2118,2519,84.1,4620,2108,2512,83.9
서울특별시,노원구,69세,2017,4432,2036,2396,85,4426,2033,2393,85
서울특별시,노원구,70~74세,2017,17972,7850,10122,77.6,17927,7828,10099,77.5
서울특별시,노원구,70세,2017,4466,1979,2487,79.6,4455,1973,2482,79.5
서울특별시,노원구,71세,2017,3499,1515,1984,76.4,3489,1508,1981,76.1
서울특별시,노원구,72세,2017,3276,1472,1804,81.6,3270,1470,1800,81.7
서울특별시,노원구,73세,2017,3292,1399,1893,73.9,3282,1394,1888,73.8
서울특별시,노원구,74세,2017,3439,1485,1954,76,3431,1483,1948,76.1
서울특별시,노원구,75~79세,2017,15167,6239,8928,69.9,15140,6230,8910,69.9
서울특별시,노원구,75세,2017,3918,1703,2215,76.9,3910,1699,2211,76.8
서울특별시,노원구,76세,2017,3116,1253,1863,67.3,3113,1253,1860,67.4
서울특별시,노원구,77세,2017,2896,1233,1663,74.1,2889,1230,1659,74.1
서울특별시,노원구,78세,2017,2747,1114,1633,68.2,2743,1114,1629,68.4
서울특별시,노원구,79세,2017,2490,936,1554,60.2,2485,934,1551,60.2
서울특별시,노원구,80~84세,2017,8840,3034,5806,52.3,8828,3029,5799,52.2
서울특별시,노원구,80세,2017,2249,837,1412,59.3,2247,836,1411,59.2
서울특별시,노원구,81세,2017,1907,684,1223,55.9,1904,683,1221,55.9
서울특별시,노원구,82세,2017,1867,600,1267,47.4,1865,599,1266,47.3
서울특별시,노원구,83세,2017,1544,498,1046,47.6,1541,497,1044,47.6
서울특별시,노원구,84세,2017,1273,415,858,48.4,1271,414,857,48.3
서울특별시,노원구,85세이상,2017,5825,1601,4224,37.9,5810,1594,4216,37.8
서울특별시,노원구,85~89세,2017,4126,1233,2893,42.6,4115,1227,2888,42.5
서울특별시,노원구,85세,2017,1150,368,782,47.1,1145,366,779,47
서울특별시,노원구,86세,2017,902,268,634,42.3,901,268,633,42.3
서울특별시,노원구,87세,2017,848,249,599,41.6,848,249,599,41.6
서울특별시,노원구,88세,2017,667,202,465,43.4,664,199,465,42.8
서울특별시,노원구,89세,2017,559,146,413,35.4,557,145,412,35.2
서울특별시,노원구,90~94세,2017,1336,289,1047,27.6,1335,289,1046,27.6
서울특별시,노원구,90세,2017,418,89,329,27.1,417,89,328,27.1
서울특별시,노원구,91세,2017,322,66,256,25.8,322,66,256,25.8
서울특별시,노원구,92세,2017,242,54,188,28.7,242,54,188,28.7
서울특별시,노원구,93세,2017,193,44,149,29.5,193,44,149,29.5
서울특별시,노원구,94세,2017,161,36,125,28.8,161,36,125,28.8
서울특별시,노원구,95~99세,2017,324,76,248,30.6,323,75,248,30.2
서울특별시,노원구,95세,2017,114,27,87,31,114,27,87,31
서울특별시,노원구,96세,2017,82,18,64,28.1,81,17,64,26.6
서울특별시,노원구,97세,2017,66,22,44,50,66,22,44,50
서울특별시,노원구,98세,2017,40,9,31,29,40,9,31,29
서울특별시,노원구,99세,2017,22,X,22,0,22,X,22,0
서울특별시,노원구,100세이상,2017,39,X,36,8.3,37,X,34,8.8
서울특별시,노원구,15세미만,2017,66977,34494,32483,106.2,66864,34437,32427,106.2
서울특별시,노원구,15~64세,2017,404903,199324,205579,97,400473,197374,203099,97.2
서울특별시,노원구,65세이상,2017,71619,29837,41782,71.4,71431,29752,41679,71.4
서울특별시,노원구,평균연령,2017,41,39.7,42.2,,41.1,39.8,42.3,
서울특별시,노원구,중위연령,2017,42.3,40.7,43.5,,42.4,40.8,43.7,
서울특별시,은평구,합계,2017,466243,225813,240430,93.9,460651,223388,237263,94.2
서울특별시,은평구,0~4세,2017,16641,8554,8087,105.8,16539,8510,8029,106
서울특별시,은평구,0세,2017,2954,1515,1439,105.3,2930,1503,1427,105.3
서울특별시,은평구,1세,2017,3354,1723,1631,105.6,3334,1713,1621,105.7
서울특별시,은평구,2세,2017,3538,1771,1767,100.2,3521,1764,1757,100.4
서울특별시,은평구,3세,2017,3363,1736,1627,106.7,3343,1730,1613,107.3
서울특별시,은평구,4세,2017,3432,1809,1623,111.5,3411,1800,1611,111.7
서울특별시,은평구,5~9세,2017,18184,9382,8802,106.6,18122,9347,8775,106.5
서울특별시,은평구,5세,2017,3796,1979,1817,108.9,3773,1964,1809,108.6
서울특별시,은평구,6세,2017,3633,1849,1784,103.6,3626,1847,1779,103.8
서울특별시,은평구,7세,2017,3558,1836,1722,106.6,3549,1829,1720,106.3
서울특별시,은평구,8세,2017,3549,1832,1717,106.7,3539,1828,1711,106.8
서울특별시,은평구,9세,2017,3648,1886,1762,107,3635,1879,1756,107
서울특별시,은평구,10~14세,2017,18750,9735,9015,108,18693,9706,8987,108
서울특별시,은평구,10세,2017,3853,2030,1823,111.4,3845,2025,1820,111.3
서울특별시,은평구,11세,2017,3586,1833,1753,104.6,3580,1831,1749,104.7
서울특별시,은평구,12세,2017,3377,1787,1590,112.4,3373,1785,1588,112.4
서울특별시,은평구,13세,2017,3895,1987,1908,104.1,3882,1979,1903,104
서울특별시,은평구,14세,2017,4039,2098,1941,108.1,4013,2086,1927,108.3
서울특별시,은평구,15~19세,2017,24306,12337,11969,103.1,24104,12241,11863,103.2
서울특별시,은평구,15세,2017,4192,2143,2049,104.6,4159,2126,2033,104.6
서울특별시,은평구,16세,2017,4619,2327,2292,101.5,4583,2313,2270,101.9
서울특별시,은평구,17세,2017,5486,2800,2686,104.2,5443,2772,2671,103.8
서울특별시,은평구,18세,2017,5176,2661,2515,105.8,5133,2638,2495,105.7
서울특별시,은평구,19세,2017,4833,2406,2427,99.1,4786,2392,2394,99.9
서울특별시,은평구,20~24세,2017,29105,14604,14501,100.7,28702,14448,14254,101.4
서울특별시,은평구,20세,2017,5333,2694,2639,102.1,5299,2685,2614,102.7
서울특별시,은평구,21세,2017,5610,2898,2712,106.9,5562,2885,2677,107.8
서울특별시,은평구,22세,2017,5820,2996,2824,106.1,5739,2969,2770,107.2
서울특별시,은평구,23세,2017,5990,2942,3048,96.5,5870,2885,2985,96.6
서울특별시,은평구,24세,2017,6352,3074,3278,93.8,6232,3024,3208,94.3
서울특별시,은평구,25~29세,2017,31789,15396,16393,93.9,31074,15114,15960,94.7
서울특별시,은평구,25세,2017,6635,3198,3437,93,6510,3143,3367,93.3
서울특별시,은평구,26세,2017,6577,3207,3370,95.2,6442,3156,3286,96
서울특별시,은평구,27세,2017,6359,3044,3315,91.8,6207,2991,3216,93
서울특별시,은평구,28세,2017,6153,2987,3166,94.3,6017,2937,3080,95.4
서울특별시,은평구,29세,2017,6065,2960,3105,95.3,5898,2887,3011,95.9
서울특별시,은평구,30~34세,2017,32755,16126,16629,97,32003,15808,16195,97.6
서울특별시,은평구,30세,2017,6151,3002,3149,95.3,5978,2926,3052,95.9
서울특별시,은평구,31세,2017,6210,3003,3207,93.6,6047,2932,3115,94.1
서울특별시,은평구,32세,2017,6393,3140,3253,96.5,6247,3082,3165,97.4
서울특별시,은평구,33세,2017,6650,3279,3371,97.3,6519,3222,3297,97.7
서울특별시,은평구,34세,2017,7351,3702,3649,101.5,7212,3646,3566,102.2
서울특별시,은평구,35~39세,2017,38384,19389,18995,102.1,37804,19124,18680,102.4
서울특별시,은평구,35세,2017,7975,4066,3909,104,7838,3998,3840,104.1
서울특별시,은평구,36세,2017,8023,4047,3976,101.8,7907,3996,3911,102.2
서울특별시,은평구,37세,2017,8193,4198,3995,105.1,8080,4150,3930,105.6
서울특별시,은평구,38세,2017,7552,3799,3753,101.2,7423,3740,3683,101.5
서울특별시,은평구,39세,2017,6641,3279,3362,97.5,6556,3240,3316,97.7
서울특별시,은평구,40~44세,2017,37557,18844,18713,100.7,37111,18617,18494,100.7
서울특별시,은평구,40세,2017,7121,3579,3542,101,7039,3537,3502,101
서울특별시,은평구,41세,2017,6979,3509,3470,101.1,6888,3463,3425,101.1
서울특별시,은평구,42세,2017,7284,3638,3646,99.8,7182,3589,3593,99.9
서울특별시,은평구,43세,2017,7987,3995,3992,100.1,7908,3955,3953,100.1
서울특별시,은평구,44세,2017,8186,4123,4063,101.5,8094,4073,4021,101.3
서울특별시,은평구,45~49세,2017,41393,20279,21114,96,40877,20053,20824,96.3
서울특별시,은평구,45세,2017,8266,4123,4143,99.5,8171,4077,4094,99.6
서울특별시,은평구,46세,2017,8735,4301,4434,97,8633,4260,4373,97.4
서울특별시,은평구,47세,2017,8160,3947,4213,93.7,8055,3897,4158,93.7
서울특별시,은평구,48세,2017,8230,4055,4175,97.1,8127,4005,4122,97.2
서울특별시,은평구,49세,2017,8002,3853,4149,92.9,7891,3814,4077,93.5
서울특별시,은평구,50~54세,2017,35903,17241,18662,92.4,35413,17032,18381,92.7
서울특별시,은평구,50세,2017,7288,3503,3785,92.5,7213,3469,3744,92.7
서울특별시,은평구,51세,2017,7050,3437,3613,95.1,6968,3402,3566,95.4
서울특별시,은평구,52세,2017,7212,3387,3825,88.5,7115,3347,3768,88.8
서울특별시,은평구,53세,2017,7018,3401,3617,94,6910,3357,3553,94.5
서울특별시,은평구,54세,2017,7335,3513,3822,91.9,7207,3457,3750,92.2
서울특별시,은평구,55~59세,2017,38659,18223,20436,89.2,38208,18027,20181,89.3
서울특별시,은평구,55세,2017,7571,3681,3890,94.6,7471,3631,3840,94.6
서울특별시,은평구,56세,2017,8007,3764,4243,88.7,7928,3734,4194,89
서울특별시,은평구,57세,2017,8235,3772,4463,84.5,8146,3733,4413,84.6
서울특별시,은평구,58세,2017,7660,3617,4043,89.5,7557,3571,3986,89.6
서울특별시,은평구,59세,2017,7186,3389,3797,89.3,7106,3358,3748,89.6
서울특별시,은평구,60~64세,2017,31708,14733,16975,86.8,31289,14560,16729,87
서울특별시,은평구,60세,2017,7079,3283,3796,86.5,6983,3249,3734,87
서울특별시,은평구,61세,2017,6702,3176,3526,90.1,6610,3140,3470,90.5
서울특별시,은평구,62세,2017,6819,3215,3604,89.2,6734,3178,3556,89.4
서울특별시,은평구,63세,2017,5885,2691,3194,84.3,5804,2657,3147,84.4
서울특별시,은평구,64세,2017,5223,2368,2855,82.9,5158,2336,2822,82.8
서울특별시,은평구,65~69세,2017,23512,10810,12702,85.1,23297,10715,12582,85.2
서울특별시,은평구,65세,2017,5446,2596,2850,91.1,5372,2562,2810,91.2
서울특별시,은평구,66세,2017,4101,1850,2251,82.2,4061,1830,2231,82
서울특별시,은평구,67세,2017,4584,2111,2473,85.4,4554,2102,2452,85.7
서울특별시,은평구,68세,2017,4699,2120,2579,82.2,4662,2104,2558,82.3
서울특별시,은평구,69세,2017,4682,2133,2549,83.7,4648,2117,2531,83.6
서울특별시,은평구,70~74세,2017,19087,8498,10589,80.3,19016,8465,10551,80.2
서울특별시,은평구,70세,2017,4693,2122,2571,82.5,4677,2113,2564,82.4
서울특별시,은평구,71세,2017,3651,1640,2011,81.6,3639,1631,2008,81.2
서울특별시,은평구,72세,2017,3557,1580,1977,79.9,3542,1573,1969,79.9
서울특별시,은평구,73세,2017,3521,1563,1958,79.8,3508,1560,1948,80.1
서울특별시,은평구,74세,2017,3665,1593,2072,76.9,3650,1588,2062,77
서울특별시,은평구,75~79세,2017,15499,6941,8558,81.1,15435,6918,8517,81.2
서울특별시,은평구,75세,2017,4185,1890,2295,82.4,4167,1886,2281,82.7
서울특별시,은평구,76세,2017,3246,1495,1751,85.4,3237,1491,1746,85.4
서울특별시,은평구,77세,2017,2898,1331,1567,84.9,2888,1327,1561,85
서울특별시,은평구,78세,2017,2769,1197,1572,76.1,2757,1193,1564,76.3
서울특별시,은평구,79세,2017,2401,1028,1373,74.9,2386,1021,1365,74.8
서울특별시,은평구,80~84세,2017,8184,3292,4892,67.3,8158,3283,4875,67.3
서울특별시,은평구,80세,2017,2217,943,1274,74,2206,939,1267,74.1
서울특별시,은평구,81세,2017,1882,752,1130,66.5,1879,752,1127,66.7
서울특별시,은평구,82세,2017,1686,678,1008,67.3,1682,675,1007,67
서울특별시,은평구,83세,2017,1323,529,794,66.6,1319,527,792,66.5
서울특별시,은평구,84세,2017,1076,390,686,56.9,1072,390,682,57.2
서울특별시,은평구,85세이상,2017,4827,1429,3398,42.1,4806,1420,3386,41.9
서울특별시,은평구,85~89세,2017,3430,1098,2332,47.1,3415,1091,2324,46.9
서울특별시,은평구,85세,2017,974,345,629,54.8,968,341,627,54.4
서울특별시,은평구,86세,2017,751,233,518,45,749,233,516,45.2
서울특별시,은평구,87세,2017,630,193,437,44.2,627,191,436,43.8
서울특별시,은평구,88세,2017,608,188,420,44.8,606,187,419,44.6
서울특별시,은평구,89세,2017,467,139,328,42.4,465,139,326,42.6
서울특별시,은평구,90~94세,2017,1158,284,874,32.5,1152,282,870,32.4
서울특별시,은평구,90세,2017,377,84,293,28.7,373,83,290,28.6
서울특별시,은평구,91세,2017,261,70,191,36.6,260,69,191,36.1
서울특별시,은평구,92세,2017,215,44,171,25.7,215,44,171,25.7
서울특별시,은평구,93세,2017,172,50,122,41,172,50,122,41
서울특별시,은평구,94세,2017,133,36,97,37.1,132,36,96,37.5
서울특별시,은평구,95~99세,2017,213,46,167,27.5,213,46,167,27.5
서울특별시,은평구,95세,2017,87,18,69,26.1,87,18,69,26.1
서울특별시,은평구,96세,2017,50,11,39,28.2,50,11,39,28.2
서울특별시,은평구,97세,2017,36,9,27,33.3,36,9,27,33.3
서울특별시,은평구,98세,2017,27,6,21,28.6,27,6,21,28.6
서울특별시,은평구,99세,2017,13,X,11,18.2,13,X,11,18.2
서울특별시,은평구,100세이상,2017,26,X,25,4,26,X,25,4
서울특별시,은평구,15세미만,2017,53575,27671,25904,106.8,53354,27563,25791,106.9
서울특별시,은평구,15~64세,2017,341559,167172,174387,95.9,336585,165024,171561,96.2
서울특별시,은평구,65세이상,2017,71109,30970,40139,77.2,70712,30801,39911,77.2
서울특별시,은평구,평균연령,2017,42.4,41.4,43.4,,42.5,41.4,43.5,
서울특별시,은평구,중위연령,2017,43.2,42.1,44.3,,43.3,42.1,44.4,
서울특별시,서대문구,합계,2017,321345,151132,170213,88.8,308193,146320,161873,90.4
서울특별시,서대문구,0~4세,2017,10712,5458,5254,103.9,10532,5368,5164,104
서울특별시,서대문구,0세,2017,2004,1036,968,107,1978,1022,956,106.9
서울특별시,서대문구,1세,2017,2211,1133,1078,105.1,2164,1111,1053,105.5
서울특별시,서대문구,2세,2017,2176,1090,1086,100.4,2135,1069,1066,100.3
서울특별시,서대문구,3세,2017,2232,1118,1114,100.4,2198,1105,1093,101.1
서울특별시,서대문구,4세,2017,2089,1081,1008,107.2,2057,1061,996,106.5
서울특별시,서대문구,5~9세,2017,10558,5338,5220,102.3,10417,5265,5152,102.2
서울특별시,서대문구,5세,2017,2222,1119,1103,101.5,2189,1106,1083,102.1
서울특별시,서대문구,6세,2017,2084,1033,1051,98.3,2058,1018,1040,97.9
서울특별시,서대문구,7세,2017,2070,1077,993,108.5,2046,1062,984,107.9
서울특별시,서대문구,8세,2017,2145,1075,1070,100.5,2118,1061,1057,100.4
서울특별시,서대문구,9세,2017,2037,1034,1003,103.1,2006,1018,988,103
서울특별시,서대문구,10~14세,2017,11067,5599,5468,102.4,10914,5521,5393,102.4
서울특별시,서대문구,10세,2017,2144,1074,1070,100.4,2119,1064,1055,100.9
서울특별시,서대문구,11세,2017,2132,1086,1046,103.8,2101,1069,1032,103.6
서울특별시,서대문구,12세,2017,2061,1043,1018,102.5,2035,1028,1007,102.1
서울특별시,서대문구,13세,2017,2303,1172,1131,103.6,2260,1152,1108,104
서울특별시,서대문구,14세,2017,2427,1224,1203,101.7,2399,1208,1191,101.4
서울특별시,서대문구,15~19세,2017,17558,8120,9438,86,16662,7846,8816,89
서울특별시,서대문구,15세,2017,2467,1267,1200,105.6,2433,1245,1188,104.8
서울특별시,서대문구,16세,2017,2978,1560,1418,110,2929,1529,1400,109.2
서울특별시,서대문구,17세,2017,3300,1770,1530,115.7,3223,1736,1487,116.7
서울특별시,서대문구,18세,2017,3520,1612,1908,84.5,3320,1551,1769,87.7
서울특별시,서대문구,19세,2017,5293,1911,3382,56.5,4757,1785,2972,60.1
서울특별시,서대문구,20~24세,2017,33583,13410,20173,66.5,29569,12476,17093,73
서울특별시,서대문구,20세,2017,6372,2175,4197,51.8,5548,1994,3554,56.1
서울특별시,서대문구,21세,2017,6587,2371,4216,56.2,5749,2204,3545,62.2
서울특별시,서대문구,22세,2017,6805,2729,4076,67,5970,2542,3428,74.2
서울특별시,서대문구,23세,2017,6813,2938,3875,75.8,6065,2739,3326,82.4
서울특별시,서대문구,24세,2017,7006,3197,3809,83.9,6237,2997,3240,92.5
서울특별시,서대문구,25~29세,2017,28244,13759,14485,95,26104,13030,13074,99.7
서울특별시,서대문구,25세,2017,6608,3151,3457,91.1,6026,2980,3046,97.8
서울특별시,서대문구,26세,2017,6217,2987,3230,92.5,5796,2845,2951,96.4
서울특별시,서대문구,27세,2017,5602,2709,2893,93.6,5151,2565,2586,99.2
서울특별시,서대문구,28세,2017,5145,2596,2549,101.8,4767,2461,2306,106.7
서울특별시,서대문구,29세,2017,4672,2316,2356,98.3,4364,2179,2185,99.7
서울특별시,서대문구,30~34세,2017,22711,11197,11514,97.2,21431,10652,10779,98.8
서울특별시,서대문구,30세,2017,4606,2247,2359,95.3,4299,2135,2164,98.7
서울특별시,서대문구,31세,2017,4404,2211,2193,100.8,4119,2087,2032,102.7
서울특별시,서대문구,32세,2017,4495,2181,2314,94.3,4224,2066,2158,95.7
서울특별시,서대문구,33세,2017,4435,2150,2285,94.1,4231,2064,2167,95.2
서울특별시,서대문구,34세,2017,4771,2408,2363,101.9,4558,2300,2258,101.9
서울특별시,서대문구,35~39세,2017,23594,11761,11833,99.4,22756,11374,11382,99.9
서울특별시,서대문구,35세,2017,5013,2442,2571,95,4807,2348,2459,95.5
서울특별시,서대문구,36세,2017,5003,2528,2475,102.1,4827,2445,2382,102.6
서울특별시,서대문구,37세,2017,4921,2449,2472,99.1,4773,2379,2394,99.4
서울특별시,서대문구,38세,2017,4496,2252,2244,100.4,4346,2188,2158,101.4
서울특별시,서대문구,39세,2017,4161,2090,2071,100.9,4003,2014,1989,101.3
서울특별시,서대문구,40~44세,2017,22856,11358,11498,98.8,22205,11018,11187,98.5
서울특별시,서대문구,40세,2017,4336,2190,2146,102.1,4192,2102,2090,100.6
서울특별시,서대문구,41세,2017,4285,2166,2119,102.2,4164,2108,2056,102.5
서울특별시,서대문구,42세,2017,4445,2245,2200,102,4331,2190,2141,102.3
서울특별시,서대문구,43세,2017,4907,2417,2490,97.1,4767,2341,2426,96.5
서울특별시,서대문구,44세,2017,4883,2340,2543,92,4751,2277,2474,92
서울특별시,서대문구,45~49세,2017,26656,13141,13515,97.2,25905,12756,13149,97
서울특별시,서대문구,45세,2017,5267,2673,2594,103,5096,2583,2513,102.8
서울특별시,서대문구,46세,2017,5635,2828,2807,100.7,5458,2740,2718,100.8
서울특별시,서대문구,47세,2017,5324,2601,2723,95.5,5187,2527,2660,95
서울특별시,서대문구,48세,2017,5243,2542,2701,94.1,5111,2474,2637,93.8
서울특별시,서대문구,49세,2017,5187,2497,2690,92.8,5053,2432,2621,92.8
서울특별시,서대문구,50~54세,2017,23546,11393,12153,93.7,22925,11087,11838,93.7
서울특별시,서대문구,50세,2017,4751,2224,2527,88,4649,2169,2480,87.5
서울특별시,서대문구,51세,2017,4599,2378,2221,107.1,4470,2321,2149,108
서울특별시,서대문구,52세,2017,4782,2253,2529,89.1,4650,2185,2465,88.6
서울특별시,서대문구,53세,2017,4592,2182,2410,90.5,4477,2124,2353,90.3
서울특별시,서대문구,54세,2017,4822,2356,2466,95.5,4679,2288,2391,95.7
서울특별시,서대문구,55~59세,2017,24373,11716,12657,92.6,23806,11460,12346,92.8
서울특별시,서대문구,55세,2017,4884,2400,2484,96.6,4753,2337,2416,96.7
서울특별시,서대문구,56세,2017,5143,2468,2675,92.3,5020,2415,2605,92.7
서울특별시,서대문구,57세,2017,5116,2380,2736,87,5010,2331,2679,87
서울특별시,서대문구,58세,2017,4684,2245,2439,92,4592,2206,2386,92.5
서울특별시,서대문구,59세,2017,4546,2223,2323,95.7,4431,2171,2260,96.1
서울특별시,서대문구,60~64세,2017,19322,9139,10183,89.7,18853,8907,9946,89.6
서울특별시,서대문구,60세,2017,4372,2084,2288,91.1,4256,2021,2235,90.4
서울특별시,서대문구,61세,2017,4066,1935,2131,90.8,3978,1894,2084,90.9
서울특별시,서대문구,62세,2017,4210,1981,2229,88.9,4104,1930,2174,88.8
서울특별시,서대문구,63세,2017,3510,1663,1847,90,3422,1625,1797,90.4
서울특별시,서대문구,64세,2017,3164,1476,1688,87.4,3093,1437,1656,86.8
서울특별시,서대문구,65~69세,2017,14230,6398,7832,81.7,14017,6295,7722,81.5
서울특별시,서대문구,65세,2017,3297,1504,1793,83.9,3238,1483,1755,84.5
서울특별시,서대문구,66세,2017,2515,1196,1319,90.7,2473,1167,1306,89.4
서울특별시,서대문구,67세,2017,2798,1222,1576,77.5,2761,1204,1557,77.3
서울특별시,서대문구,68세,2017,2839,1239,1600,77.4,2800,1220,1580,77.2
서울특별시,서대문구,69세,2017,2781,1237,1544,80.1,2745,1221,1524,80.1
서울특별시,서대문구,70~74세,2017,12221,5341,6880,77.6,12130,5306,6824,77.8
서울특별시,서대문구,70세,2017,3009,1335,1674,79.7,2983,1324,1659,79.8
서울특별시,서대문구,71세,2017,2333,1044,1289,81,2308,1033,1275,81
서울특별시,서대문구,72세,2017,2319,1003,1316,76.2,2301,995,1306,76.2
서울특별시,서대문구,73세,2017,2248,964,1284,75.1,2235,962,1273,75.6
서울특별시,서대문구,74세,2017,2312,995,1317,75.6,2303,992,1311,75.7
서울특별시,서대문구,75~79세,2017,10699,4629,6070,76.3,10637,4613,6024,76.6
서울특별시,서대문구,75세,2017,2736,1226,1510,81.2,2727,1223,1504,81.3
서울특별시,서대문구,76세,2017,2180,963,1217,79.1,2160,957,1203,79.6
서울특별시,서대문구,77세,2017,2041,873,1168,74.7,2031,871,1160,75.1
서울특별시,서대문구,78세,2017,2045,861,1184,72.7,2029,857,1172,73.1
서울특별시,서대문구,79세,2017,1697,706,991,71.2,1690,705,985,71.6
서울특별시,서대문구,80~84세,2017,6000,2357,3643,64.7,5951,2340,3611,64.8
서울특별시,서대문구,80세,2017,1526,626,900,69.6,1511,623,888,70.2
서울특별시,서대문구,81세,2017,1375,568,807,70.4,1358,559,799,70
서울특별시,서대문구,82세,2017,1271,505,766,65.9,1266,503,763,65.9
서울특별시,서대문구,83세,2017,1015,375,640,58.6,1007,373,634,58.8
서울특별시,서대문구,84세,2017,813,283,530,53.4,809,282,527,53.5
서울특별시,서대문구,85세이상,2017,3415,1018,2397,42.5,3379,1006,2373,42.4
서울특별시,서대문구,85~89세,2017,2441,788,1653,47.7,2419,782,1637,47.8
서울특별시,서대문구,85세,2017,654,228,426,53.5,652,227,425,53.4
서울특별시,서대문구,86세,2017,505,155,350,44.3,496,154,342,45
서울특별시,서대문구,87세,2017,523,166,357,46.5,521,166,355,46.8
서울특별시,서대문구,88세,2017,422,144,278,51.8,415,141,274,51.5
서울특별시,서대문구,89세,2017,337,95,242,39.3,335,94,241,39
서울특별시,서대문구,90~94세,2017,789,195,594,32.8,779,192,587,32.7
서울특별시,서대문구,90세,2017,258,62,196,31.6,256,61,195,31.3
서울특별시,서대문구,91세,2017,178,49,129,38,177,49,128,38.3
서울특별시,서대문구,92세,2017,141,34,107,31.8,138,34,104,32.7
서울특별시,서대문구,93세,2017,123,28,95,29.5,121,27,94,28.7
서울특별시,서대문구,94세,2017,89,22,67,32.8,87,21,66,31.8
서울특별시,서대문구,95~99세,2017,160,27,133,20.3,157,25,132,18.9
서울특별시,서대문구,95세,2017,75,13,62,21,74,13,61,21.3
서울특별시,서대문구,96세,2017,38,X,34,11.8,38,X,34,11.8
서울특별시,서대문구,97세,2017,23,6,17,35.3,23,6,17,35.3
서울특별시,서대문구,98세,2017,17,X,14,21.4,16,X,14,14.3
서울특별시,서대문구,99세,2017,7,X,6,16.7,6,X,6,0
서울특별시,서대문구,100세이상,2017,25,8,17,47.1,24,7,17,41.2
서울특별시,서대문구,15세미만,2017,32337,16395,15942,102.8,31863,16154,15709,102.8
서울특별시,서대문구,15~64세,2017,242443,114994,127449,90.2,230216,110606,119610,92.5
서울특별시,서대문구,65세이상,2017,46565,19743,26822,73.6,46114,19560,26554,73.7
서울특별시,서대문구,평균연령,2017,41.3,40.8,41.7,,41.6,40.9,42.2,
서울특별시,서대문구,중위연령,2017,40.6,40.4,40.8,,41.4,40.8,42,
서울특별시,마포구,합계,2017,368841,175326,193515,90.6,356881,170311,186570,91.3
서울특별시,마포구,0~4세,2017,14424,7373,7051,104.6,14247,7288,6959,104.7
서울특별시,마포구,0세,2017,2938,1559,1379,113.1,2905,1548,1357,114.1
서울특별시,마포구,1세,2017,3032,1544,1488,103.8,2999,1525,1474,103.5
서울특별시,마포구,2세,2017,2933,1489,1444,103.1,2888,1467,1421,103.2
서울특별시,마포구,3세,2017,2794,1411,1383,102,2762,1398,1364,102.5
서울특별시,마포구,4세,2017,2727,1370,1357,101,2693,1350,1343,100.5
서울특별시,마포구,5~9세,2017,13927,7072,6855,103.2,13781,6999,6782,103.2
서울특별시,마포구,5세,2017,2846,1437,1409,102,2808,1416,1392,101.7
서울특별시,마포구,6세,2017,2826,1429,1397,102.3,2800,1415,1385,102.2
서울특별시,마포구,7세,2017,2710,1357,1353,100.3,2688,1350,1338,100.9
서울특별시,마포구,8세,2017,2683,1391,1292,107.7,2654,1376,1278,107.7
서울특별시,마포구,9세,2017,2862,1458,1404,103.8,2831,1442,1389,103.8
서울특별시,마포구,10~14세,2017,13642,6969,6673,104.4,13537,6909,6628,104.2
서울특별시,마포구,10세,2017,2873,1459,1414,103.2,2857,1449,1408,102.9
서울특별시,마포구,11세,2017,2603,1304,1299,100.4,2579,1288,1291,99.8
서울특별시,마포구,12세,2017,2608,1347,1261,106.8,2586,1333,1253,106.4
서울특별시,마포구,13세,2017,2779,1380,1399,98.6,2753,1368,1385,98.8
서울특별시,마포구,14세,2017,2779,1479,1300,113.8,2762,1471,1291,113.9
서울특별시,마포구,15~19세,2017,16795,8230,8565,96.1,16324,8093,8231,98.3
서울특별시,마포구,15세,2017,2771,1381,1390,99.4,2755,1372,1383,99.2
서울특별시,마포구,16세,2017,2970,1538,1432,107.4,2955,1530,1425,107.4
서울특별시,마포구,17세,2017,3301,1633,1668,97.9,3268,1619,1649,98.2
서울특별시,마포구,18세,2017,3500,1729,1771,97.6,3384,1698,1686,100.7
서울특별시,마포구,19세,2017,4253,1949,2304,84.6,3962,1874,2088,89.8
서울특별시,마포구,20~24세,2017,28444,12948,15496,83.6,26116,12297,13819,89
서울특별시,마포구,20세,2017,4916,2188,2728,80.2,4494,2078,2416,86
서울특별시,마포구,21세,2017,5170,2327,2843,81.9,4757,2213,2544,87
서울특별시,마포구,22세,2017,5616,2503,3113,80.4,5141,2386,2755,86.6
서울특별시,마포구,23세,2017,6192,2891,3301,87.6,5649,2726,2923,93.3
서울특별시,마포구,24세,2017,6550,3039,3511,86.6,6075,2894,3181,91
서울특별시,마포구,25~29세,2017,33369,15336,18033,85,31331,14646,16685,87.8
서울특별시,마포구,25세,2017,6983,3168,3815,83,6551,3045,3506,86.9
서울특별시,마포구,26세,2017,6803,3187,3616,88.1,6381,3054,3327,91.8
서울특별시,마포구,27세,2017,6676,3051,3625,84.2,6258,2916,3342,87.3
서울특별시,마포구,28세,2017,6437,2979,3458,86.1,6060,2832,3228,87.7
서울특별시,마포구,29세,2017,6470,2951,3519,83.9,6081,2799,3282,85.3
서울특별시,마포구,30~34세,2017,33864,15963,17901,89.2,32290,15199,17091,88.9
서울특별시,마포구,30세,2017,6566,2930,3636,80.6,6218,2779,3439,80.8
서울특별시,마포구,31세,2017,6658,3055,3603,84.8,6324,2891,3433,84.2
서울특별시,마포구,32세,2017,6679,3176,3503,90.7,6384,3037,3347,90.7
서울특별시,마포구,33세,2017,6893,3370,3523,95.7,6568,3205,3363,95.3
서울특별시,마포구,34세,2017,7068,3432,3636,94.4,6796,3287,3509,93.7
서울특별시,마포구,35~39세,2017,33593,16643,16950,98.2,32531,16054,16477,97.4
서울특별시,마포구,35세,2017,7492,3680,3812,96.5,7254,3553,3701,96
서울특별시,마포구,36세,2017,7101,3569,3532,101,6891,3452,3439,100.4
서울특별시,마포구,37세,2017,6794,3362,3432,98,6592,3247,3345,97.1
서울특별시,마포구,38세,2017,6403,3128,3275,95.5,6171,3003,3168,94.8
서울특별시,마포구,39세,2017,5803,2904,2899,100.2,5623,2799,2824,99.1
서울특별시,마포구,40~44세,2017,30884,15126,15758,96,30079,14690,15389,95.5
서울특별시,마포구,40세,2017,5997,2869,3128,91.7,5830,2783,3047,91.3
서울특별시,마포구,41세,2017,5971,2919,3052,95.6,5798,2821,2977,94.8
서울특별시,마포구,42세,2017,6089,3046,3043,100.1,5923,2953,2970,99.4
서울특별시,마포구,43세,2017,6346,3178,3168,100.3,6213,3105,3108,99.9
서울특별시,마포구,44세,2017,6481,3114,3367,92.5,6315,3028,3287,92.1
서울특별시,마포구,45~49세,2017,31485,15634,15851,98.6,30665,15218,15447,98.5
서울특별시,마포구,45세,2017,6517,3302,3215,102.7,6362,3217,3145,102.3
서울특별시,마포구,46세,2017,6720,3336,3384,98.6,6557,3253,3304,98.5
서울특별시,마포구,47세,2017,6259,3121,3138,99.5,6084,3041,3043,99.9
서울특별시,마포구,48세,2017,6159,3092,3067,100.8,6000,3003,2997,100.2
서울특별시,마포구,49세,2017,5830,2783,3047,91.3,5662,2704,2958,91.4
서울특별시,마포구,50~54세,2017,25708,12548,13160,95.3,24940,12196,12744,95.7
서울특별시,마포구,50세,2017,5238,2535,2703,93.8,5084,2450,2634,93
서울특별시,마포구,51세,2017,4956,2491,2465,101.1,4807,2424,2383,101.7
서울특별시,마포구,52세,2017,5363,2569,2794,91.9,5211,2506,2705,92.6
서울특별시,마포구,53세,2017,4977,2429,2548,95.3,4825,2360,2465,95.7
서울특별시,마포구,54세,2017,5174,2524,2650,95.2,5013,2456,2557,96.1
서울특별시,마포구,55~59세,2017,25771,12361,13410,92.2,25135,12080,13055,92.5
서울특별시,마포구,55세,2017,5149,2491,2658,93.7,4986,2416,2570,94
서울특별시,마포구,56세,2017,5398,2615,2783,94,5309,2574,2735,94.1
서울특별시,마포구,57세,2017,5584,2675,2909,92,5451,2618,2833,92.4
서울특별시,마포구,58세,2017,5018,2390,2628,90.9,4895,2332,2563,91
서울특별시,마포구,59세,2017,4622,2190,2432,90,4494,2140,2354,90.9
서울특별시,마포구,60~64세,2017,20172,9371,10801,86.8,19656,9123,10533,86.6
서울특별시,마포구,60세,2017,4655,2183,2472,88.3,4549,2119,2430,87.2
서울특별시,마포구,61세,2017,4275,1977,2298,86,4171,1934,2237,86.5
서울특별시,마포구,62세,2017,4442,2086,2356,88.5,4336,2040,2296,88.9
서울특별시,마포구,63세,2017,3627,1670,1957,85.3,3519,1622,1897,85.5
서울특별시,마포구,64세,2017,3173,1455,1718,84.7,3081,1408,1673,84.2
서울특별시,마포구,65~69세,2017,14744,6529,8215,79.5,14481,6390,8091,79
서울특별시,마포구,65세,2017,3503,1610,1893,85.1,3411,1563,1848,84.6
서울특별시,마포구,66세,2017,2476,1112,1364,81.5,2426,1085,1341,80.9
서울특별시,마포구,67세,2017,2881,1286,1595,80.6,2823,1251,1572,79.6
서울특별시,마포구,68세,2017,2944,1256,1688,74.4,2914,1239,1675,74
서울특별시,마포구,69세,2017,2940,1265,1675,75.5,2907,1252,1655,75.6
서울특별시,마포구,70~74세,2017,12324,5297,7027,75.4,12211,5247,6964,75.3
서울특별시,마포구,70세,2017,2978,1280,1698,75.4,2945,1267,1678,75.5
서울특별시,마포구,71세,2017,2302,969,1333,72.7,2275,957,1318,72.6
서울특별시,마포구,72세,2017,2374,1011,1363,74.2,2358,1002,1356,73.9
서울특별시,마포구,73세,2017,2351,1005,1346,74.7,2326,993,1333,74.5
서울특별시,마포구,74세,2017,2319,1032,1287,80.2,2307,1028,1279,80.4
서울특별시,마포구,75~79세,2017,10309,4488,5821,77.1,10247,4470,5777,77.4
서울특별시,마포구,75세,2017,2736,1215,1521,79.9,2720,1212,1508,80.4
서울특별시,마포구,76세,2017,2138,953,1185,80.4,2123,947,1176,80.5
서울특별시,마포구,77세,2017,1995,847,1148,73.8,1981,841,1140,73.8
서울특별시,마포구,78세,2017,1850,799,1051,76,1842,797,1045,76.3
서울특별시,마포구,79세,2017,1590,674,916,73.6,1581,673,908,74.1
서울특별시,마포구,80~84세,2017,5941,2328,3613,64.4,5899,2311,3588,64.4
서울특별시,마포구,80세,2017,1574,649,925,70.2,1564,646,918,70.4
서울특별시,마포구,81세,2017,1333,536,797,67.3,1318,530,788,67.3
서울특별시,마포구,82세,2017,1253,477,776,61.5,1247,473,774,61.1
서울특별시,마포구,83세,2017,944,328,616,53.2,939,326,613,53.2
서울특별시,마포구,84세,2017,837,338,499,67.7,831,336,495,67.9
서울특별시,마포구,85세이상,2017,3445,1110,2335,47.5,3411,1101,2310,47.7
서울특별시,마포구,85~89세,2017,2485,842,1643,51.2,2464,836,1628,51.4
서울특별시,마포구,85세,2017,696,246,450,54.7,689,244,445,54.8
서울특별시,마포구,86세,2017,530,184,346,53.2,526,183,343,53.4
서울특별시,마포구,87세,2017,497,162,335,48.4,489,160,329,48.6
서울특별시,마포구,88세,2017,426,148,278,53.2,424,147,277,53.1
서울특별시,마포구,89세,2017,336,102,234,43.6,336,102,234,43.6
서울특별시,마포구,90~94세,2017,743,213,530,40.2,736,211,525,40.2
서울특별시,마포구,90세,2017,244,72,172,41.9,241,71,170,41.8
서울특별시,마포구,91세,2017,168,46,122,37.7,166,45,121,37.2
서울특별시,마포구,92세,2017,128,35,93,37.6,127,35,92,38
서울특별시,마포구,93세,2017,108,33,75,44,108,33,75,44
서울특별시,마포구,94세,2017,95,27,68,39.7,94,27,67,40.3
서울특별시,마포구,95~99세,2017,188,49,139,35.3,183,48,135,35.6
서울특별시,마포구,95세,2017,73,15,58,25.9,71,15,56,26.8
서울특별시,마포구,96세,2017,45,19,26,73.1,43,18,25,72
서울특별시,마포구,97세,2017,30,8,22,36.4,30,8,22,36.4
서울특별시,마포구,98세,2017,23,5,18,27.8,22,5,17,29.4
서울특별시,마포구,99세,2017,17,X,15,13.3,17,X,15,13.3
서울특별시,마포구,100세이상,2017,29,6,23,26.1,28,6,22,27.3
서울특별시,마포구,15세미만,2017,41993,21414,20579,104.1,41565,21196,20369,104.1
서울특별시,마포구,15~64세,2017,280085,134160,145925,91.9,269067,129596,139471,92.9
서울특별시,마포구,65세이상,2017,46763,19752,27011,73.1,46249,19519,26730,73
서울특별시,마포구,평균연령,2017,40.4,39.7,41,,40.5,39.7,41.3,
서울특별시,마포구,중위연령,2017,39.4,39,39.7,,39.7,39.2,40.2,
서울특별시,양천구,합계,2017,452111,222503,229608,96.9,446643,220035,226608,97.1
서울특별시,양천구,0~4세,2017,16004,8198,7806,105,15908,8149,7759,105
서울특별시,양천구,0세,2017,2855,1469,1386,106,2839,1462,1377,106.2
서울특별시,양천구,1세,2017,3210,1588,1622,97.9,3189,1578,1611,98
서울특별시,양천구,2세,2017,3212,1681,1531,109.8,3194,1668,1526,109.3
서울특별시,양천구,3세,2017,3308,1679,1629,103.1,3286,1669,1617,103.2
서울특별시,양천구,4세,2017,3419,1781,1638,108.7,3400,1772,1628,108.8
서울특별시,양천구,5~9세,2017,19991,10334,9657,107,19926,10306,9620,107.1
서울특별시,양천구,5세,2017,3726,1909,1817,105.1,3710,1902,1808,105.2
서울특별시,양천구,6세,2017,3856,2015,1841,109.5,3842,2011,1831,109.8
서울특별시,양천구,7세,2017,4007,2053,1954,105.1,3994,2046,1948,105
서울특별시,양천구,8세,2017,3953,2066,1887,109.5,3945,2062,1883,109.5
서울특별시,양천구,9세,2017,4449,2291,2158,106.2,4435,2285,2150,106.3
서울특별시,양천구,10~14세,2017,24346,12733,11613,109.6,24311,12712,11599,109.6
서울특별시,양천구,10세,2017,4649,2388,2261,105.6,4640,2382,2258,105.5
서울특별시,양천구,11세,2017,4375,2271,2104,107.9,4369,2266,2103,107.8
서울특별시,양천구,12세,2017,4787,2539,2248,112.9,4782,2536,2246,112.9
서울특별시,양천구,13세,2017,5241,2804,2437,115.1,5232,2799,2433,115
서울특별시,양천구,14세,2017,5294,2731,2563,106.6,5288,2729,2559,106.6
서울특별시,양천구,15~19세,2017,29457,15378,14079,109.2,29410,15358,14052,109.3
서울특별시,양천구,15세,2017,5493,2848,2645,107.7,5487,2844,2643,107.6
서울특별시,양천구,16세,2017,5904,3119,2785,112,5893,3113,2780,112
서울특별시,양천구,17세,2017,6252,3292,2960,111.2,6241,3288,2953,111.3
서울특별시,양천구,18세,2017,6302,3295,3007,109.6,6291,3291,3000,109.7
서울특별시,양천구,19세,2017,5506,2824,2682,105.3,5498,2822,2676,105.5
서울특별시,양천구,20~24세,2017,29424,15445,13979,110.5,29167,15355,13812,111.2
서울특별시,양천구,20세,2017,5724,3087,2637,117.1,5695,3074,2621,117.3
서울특별시,양천구,21세,2017,5902,3224,2678,120.4,5870,3218,2652,121.3
서울특별시,양천구,22세,2017,5848,3145,2703,116.4,5797,3129,2668,117.3
서울특별시,양천구,23세,2017,5993,3031,2962,102.3,5931,3008,2923,102.9
서울특별시,양천구,24세,2017,5957,2958,2999,98.6,5874,2926,2948,99.3
서울특별시,양천구,25~29세,2017,28246,13901,14345,96.9,27628,13656,13972,97.7
서울특별시,양천구,25세,2017,5919,2885,3034,95.1,5822,2848,2974,95.8
서울특별시,양천구,26세,2017,5913,2891,3022,95.7,5799,2851,2948,96.7
서울특별시,양천구,27세,2017,5514,2806,2708,103.6,5390,2760,2630,104.9
서울특별시,양천구,28세,2017,5487,2664,2823,94.4,5357,2605,2752,94.7
서울특별시,양천구,29세,2017,5413,2655,2758,96.3,5260,2592,2668,97.2
서울특별시,양천구,30~34세,2017,28954,14445,14509,99.6,28286,14151,14135,100.1
서울특별시,양천구,30세,2017,5435,2657,2778,95.6,5286,2592,2694,96.2
서울특별시,양천구,31세,2017,5543,2780,2763,100.6,5401,2719,2682,101.4
서울특별시,양천구,32세,2017,5623,2785,2838,98.1,5506,2734,2772,98.6
서울특별시,양천구,33세,2017,5930,2997,2933,102.2,5797,2942,2855,103
서울특별시,양천구,34세,2017,6423,3226,3197,100.9,6296,3164,3132,101
서울특별시,양천구,35~39세,2017,34044,16667,17377,95.9,33486,16383,17103,95.8
서울특별시,양천구,35세,2017,6904,3456,3448,100.2,6784,3397,3387,100.3
서울특별시,양천구,36세,2017,6916,3429,3487,98.3,6818,3375,3443,98
서울특별시,양천구,37세,2017,7021,3470,3551,97.7,6906,3403,3503,97.1
서울특별시,양천구,38세,2017,6843,3315,3528,94,6727,3264,3463,94.3
서울특별시,양천구,39세,2017,6360,2997,3363,89.1,6251,2944,3307,89
서울특별시,양천구,40~44세,2017,37249,17561,19688,89.2,36781,17337,19444,89.2
서울특별시,양천구,40세,2017,6599,3123,3476,89.8,6500,3080,3420,90.1
서울특별시,양천구,41세,2017,6771,3229,3542,91.2,6672,3188,3484,91.5
서울특별시,양천구,42세,2017,7262,3360,3902,86.1,7186,3318,3868,85.8
서울특별시,양천구,43세,2017,8164,3901,4263,91.5,8065,3855,4210,91.6
서울특별시,양천구,44세,2017,8453,3948,4505,87.6,8358,3896,4462,87.3
서울특별시,양천구,45~49세,2017,45814,22187,23627,93.9,45242,21920,23322,94
서울특별시,양천구,45세,2017,8721,4100,4621,88.7,8595,4039,4556,88.7
서울특별시,양천구,46세,2017,9606,4652,4954,93.9,9497,4600,4897,93.9
서울특별시,양천구,47세,2017,9283,4472,4811,93,9155,4416,4739,93.2
서울특별시,양천구,48세,2017,9336,4578,4758,96.2,9232,4526,4706,96.2
서울특별시,양천구,49세,2017,8868,4385,4483,97.8,8763,4339,4424,98.1
서울특별시,양천구,50~54세,2017,39133,19523,19610,99.6,38478,19234,19244,99.9
서울특별시,양천구,50세,2017,8165,3997,4168,95.9,8049,3934,4115,95.6
서울특별시,양천구,51세,2017,7824,3938,3886,101.3,7706,3891,3815,102
서울특별시,양천구,52세,2017,7969,3920,4049,96.8,7855,3868,3987,97
서울특별시,양천구,53세,2017,7447,3753,3694,101.6,7317,3702,3615,102.4
서울특별시,양천구,54세,2017,7728,3915,3813,102.7,7551,3839,3712,103.4
서울특별시,양천구,55~59세,2017,37455,18393,19062,96.5,36948,18140,18808,96.4
서울특별시,양천구,55세,2017,7621,3861,3760,102.7,7506,3797,3709,102.4
서울특별시,양천구,56세,2017,7943,3882,4061,95.6,7880,3854,4026,95.7
서울특별시,양천구,57세,2017,7942,3884,4058,95.7,7820,3828,3992,95.9
서울특별시,양천구,58세,2017,7145,3479,3666,94.9,7039,3419,3620,94.4
서울특별시,양천구,59세,2017,6804,3287,3517,93.5,6703,3242,3461,93.7
서울특별시,양천구,60~64세,2017,28974,14032,14942,93.9,28477,13806,14671,94.1
서울특별시,양천구,60세,2017,6587,3167,3420,92.6,6482,3129,3353,93.3
서울특별시,양천구,61세,2017,6084,2936,3148,93.3,5974,2884,3090,93.3
서울특별시,양천구,62세,2017,6412,3087,3325,92.8,6303,3030,3273,92.6
서울특별시,양천구,63세,2017,5219,2568,2651,96.9,5116,2526,2590,97.5
서울특별시,양천구,64세,2017,4672,2274,2398,94.8,4602,2237,2365,94.6
서울특별시,양천구,65~69세,2017,19790,9770,10020,97.5,19534,9658,9876,97.8
서울특별시,양천구,65세,2017,4938,2407,2531,95.1,4855,2367,2488,95.1
서울특별시,양천구,66세,2017,3536,1751,1785,98.1,3485,1731,1754,98.7
서울특별시,양천구,67세,2017,3923,1970,1953,100.9,3874,1946,1928,100.9
서울특별시,양천구,68세,2017,3777,1859,1918,96.9,3735,1841,1894,97.2
서울특별시,양천구,69세,2017,3616,1783,1833,97.3,3585,1773,1812,97.8
서울특별시,양천구,70~74세,2017,13582,6544,7038,93,13510,6510,7000,93
서울특별시,양천구,70세,2017,3548,1750,1798,97.3,3527,1735,1792,96.8
서울특별시,양천구,71세,2017,2683,1299,1384,93.9,2665,1291,1374,94
서울특별시,양천구,72세,2017,2492,1184,1308,90.5,2482,1180,1302,90.6
서울특별시,양천구,73세,2017,2449,1152,1297,88.8,2437,1148,1289,89.1
서울특별시,양천구,74세,2017,2410,1159,1251,92.6,2399,1156,1243,93
서울특별시,양천구,75~79세,2017,9974,4352,5622,77.4,9927,4336,5591,77.6
서울특별시,양천구,75세,2017,2632,1204,1428,84.3,2626,1203,1423,84.5
서울특별시,양천구,76세,2017,2146,989,1157,85.5,2138,986,1152,85.6
서울특별시,양천구,77세,2017,1841,767,1074,71.4,1829,764,1065,71.7
서울특별시,양천구,78세,2017,1787,734,1053,69.7,1776,729,1047,69.6
서울특별시,양천구,79세,2017,1568,658,910,72.3,1558,654,904,72.3
서울특별시,양천구,80~84세,2017,5786,2009,3777,53.2,5752,1999,3753,53.3
서울특별시,양천구,80세,2017,1516,553,963,57.4,1507,549,958,57.3
서울특별시,양천구,81세,2017,1285,462,823,56.1,1276,460,816,56.4
서울특별시,양천구,82세,2017,1159,397,762,52.1,1151,395,756,52.2
서울특별시,양천구,83세,2017,977,321,656,48.9,972,320,652,49.1
서울특별시,양천구,84세,2017,849,276,573,48.2,846,275,571,48.2
서울특별시,양천구,85세이상,2017,3888,1031,2857,36.1,3872,1025,2847,36
서울특별시,양천구,85~89세,2017,2798,782,2016,38.8,2788,778,2010,38.7
서울특별시,양천구,85세,2017,769,226,543,41.6,766,225,541,41.6
서울특별시,양천구,86세,2017,602,171,431,39.7,598,169,429,39.4
서울특별시,양천구,87세,2017,558,140,418,33.5,557,140,417,33.6
서울특별시,양천구,88세,2017,490,144,346,41.6,489,144,345,41.7
서울특별시,양천구,89세,2017,379,101,278,36.3,378,100,278,36
서울특별시,양천구,90~94세,2017,867,196,671,29.2,862,195,667,29.2
서울특별시,양천구,90세,2017,253,65,188,34.6,252,65,187,34.8
서울특별시,양천구,91세,2017,205,41,164,25,201,40,161,24.8
서울특별시,양천구,92세,2017,172,36,136,26.5,172,36,136,26.5
서울특별시,양천구,93세,2017,103,22,81,27.2,103,22,81,27.2
서울특별시,양천구,94세,2017,134,32,102,31.4,134,32,102,31.4
서울특별시,양천구,95~99세,2017,196,49,147,33.3,196,49,147,33.3
서울특별시,양천구,95세,2017,77,14,63,22.2,77,14,63,22.2
서울특별시,양천구,96세,2017,54,13,41,31.7,54,13,41,31.7
서울특별시,양천구,97세,2017,30,11,19,57.9,30,11,19,57.9
서울특별시,양천구,98세,2017,25,7,18,38.9,25,7,18,38.9
서울특별시,양천구,99세,2017,10,X,6,66.7,10,X,6,66.7
서울특별시,양천구,100세이상,2017,27,X,23,17.4,26,X,23,13
서울특별시,양천구,15세미만,2017,60341,31265,29076,107.5,60145,31167,28978,107.6
서울특별시,양천구,15~64세,2017,338750,167532,171218,97.8,333903,165340,168563,98.1
서울특별시,양천구,65세이상,2017,53020,23706,29314,80.9,52595,23528,29067,80.9
서울특별시,양천구,평균연령,2017,40.6,39.7,41.5,,40.6,39.7,41.4,
서울특별시,양천구,중위연령,2017,42.3,41.3,43.1,,42.3,41.3,43.1,
서울특별시,강서구,합계,2017,581675,282678,298997,94.5,572993,278564,294429,94.6
서울특별시,강서구,0~4세,2017,25259,12817,12442,103,25045,12707,12338,103
서울특별시,강서구,0세,2017,4738,2450,2288,107.1,4684,2417,2267,106.6
서울특별시,강서구,1세,2017,5395,2758,2637,104.6,5349,2739,2610,104.9
서울특별시,강서구,2세,2017,5189,2618,2571,101.8,5145,2593,2552,101.6
서울특별시,강서구,3세,2017,5031,2537,2494,101.7,4986,2513,2473,101.6
서울특별시,강서구,4세,2017,4906,2454,2452,100.1,4881,2445,2436,100.4
서울특별시,강서구,5~9세,2017,23175,11881,11294,105.2,23070,11824,11246,105.1
서울특별시,강서구,5세,2017,5202,2666,2536,105.1,5176,2651,2525,105
서울특별시,강서구,6세,2017,4803,2457,2346,104.7,4779,2444,2335,104.7
서울특별시,강서구,7세,2017,4378,2271,2107,107.8,4360,2260,2100,107.6
서울특별시,강서구,8세,2017,4196,2181,2015,108.2,4177,2172,2005,108.3
서울특별시,강서구,9세,2017,4596,2306,2290,100.7,4578,2297,2281,100.7
서울특별시,강서구,10~14세,2017,21866,11162,10704,104.3,21829,11146,10683,104.3
서울특별시,강서구,10세,2017,4512,2305,2207,104.4,4503,2302,2201,104.6
서울특별시,강서구,11세,2017,4174,2145,2029,105.7,4164,2141,2023,105.8
서울특별시,강서구,12세,2017,4065,2050,2015,101.7,4059,2049,2010,101.9
서울특별시,강서구,13세,2017,4533,2325,2208,105.3,4530,2322,2208,105.2
서울특별시,강서구,14세,2017,4582,2337,2245,104.1,4573,2332,2241,104.1
서울특별시,강서구,15~19세,2017,26958,13645,13313,102.5,26858,13608,13250,102.7
서울특별시,강서구,15세,2017,4726,2421,2305,105,4717,2417,2300,105.1
서울특별시,강서구,16세,2017,5346,2659,2687,99,5338,2656,2682,99
서울특별시,강서구,17세,2017,5940,2952,2988,98.8,5915,2945,2970,99.2
서울특별시,강서구,18세,2017,5504,2819,2685,105,5471,2805,2666,105.2
서울특별시,강서구,19세,2017,5442,2794,2648,105.5,5417,2785,2632,105.8
서울특별시,강서구,20~24세,2017,35728,17506,18222,96.1,35310,17344,17966,96.5
서울특별시,강서구,20세,2017,6194,3147,3047,103.3,6168,3141,3027,103.8
서울특별시,강서구,21세,2017,6545,3425,3120,109.8,6483,3393,3090,109.8
서울특별시,강서구,22세,2017,7082,3548,3534,100.4,7004,3520,3484,101
서울특별시,강서구,23세,2017,7528,3526,4002,88.1,7431,3491,3940,88.6
서울특별시,강서구,24세,2017,8379,3860,4519,85.4,8224,3799,4425,85.9
서울특별시,강서구,25~29세,2017,46711,21874,24837,88.1,45649,21418,24231,88.4
서울특별시,강서구,25세,2017,9114,4170,4944,84.3,8962,4107,4855,84.6
서울특별시,강서구,26세,2017,9290,4259,5031,84.7,9116,4189,4927,85
서울특별시,강서구,27세,2017,9415,4398,5017,87.7,9155,4279,4876,87.8
서울특별시,강서구,28세,2017,9279,4442,4837,91.8,9051,4354,4697,92.7
서울특별시,강서구,29세,2017,9613,4605,5008,92,9365,4489,4876,92.1
서울특별시,강서구,30~34세,2017,51685,25909,25776,100.5,50399,25320,25079,101
서울특별시,강서구,30세,2017,9619,4620,4999,92.4,9328,4490,4838,92.8
서울특별시,강서구,31세,2017,10014,4948,5066,97.7,9756,4842,4914,98.5
서울특별시,강서구,32세,2017,10263,5220,5043,103.5,9996,5083,4913,103.5
서울특별시,강서구,33세,2017,10470,5277,5193,101.6,10218,5163,5055,102.1
서울특별시,강서구,34세,2017,11319,5844,5475,106.7,11101,5742,5359,107.1
서울특별시,강서구,35~39세,2017,54141,27878,26263,106.1,53218,27413,25805,106.2
서울특별시,강서구,35세,2017,11751,5997,5754,104.2,11531,5884,5647,104.2
서울특별시,강서구,36세,2017,11391,6020,5371,112.1,11202,5935,5267,112.7
서울특별시,강서구,37세,2017,11390,5808,5582,104,11200,5718,5482,104.3
서울특별시,강서구,38세,2017,10518,5404,5114,105.7,10347,5317,5030,105.7
서울특별시,강서구,39세,2017,9091,4649,4442,104.7,8938,4559,4379,104.1
서울특별시,강서구,40~44세,2017,46258,23485,22773,103.1,45601,23114,22487,102.8
서울특별시,강서구,40세,2017,9185,4649,4536,102.5,9050,4573,4477,102.1
서울특별시,강서구,41세,2017,8699,4434,4265,104,8568,4353,4215,103.3
서울특별시,강서구,42세,2017,8975,4549,4426,102.8,8866,4496,4370,102.9
서울특별시,강서구,43세,2017,9746,4881,4865,100.3,9621,4801,4820,99.6
서울특별시,강서구,44세,2017,9653,4972,4681,106.2,9496,4891,4605,106.2
서울특별시,강서구,45~49세,2017,46565,23048,23517,98,45775,22646,23129,97.9
서울특별시,강서구,45세,2017,9394,4751,4643,102.3,9238,4677,4561,102.5
서울특별시,강서구,46세,2017,9692,4841,4851,99.8,9537,4747,4790,99.1
서울특별시,강서구,47세,2017,9188,4525,4663,97,9017,4434,4583,96.7
서울특별시,강서구,48세,2017,9208,4554,4654,97.9,9058,4488,4570,98.2
서울특별시,강서구,49세,2017,9083,4377,4706,93,8925,4300,4625,93
서울특별시,강서구,50~54세,2017,42510,20145,22365,90.1,41592,19706,21886,90
서울특별시,강서구,50세,2017,8326,3935,4391,89.6,8177,3858,4319,89.3
서울특별시,강서구,51세,2017,8181,3905,4276,91.3,8015,3827,4188,91.4
서울특별시,강서구,52세,2017,8673,4122,4551,90.6,8486,4024,4462,90.2
서울특별시,강서구,53세,2017,8301,3879,4422,87.7,8099,3790,4309,88
서울특별시,강서구,54세,2017,9029,4304,4725,91.1,8815,4207,4608,91.3
서울특별시,강서구,55~59세,2017,48091,22554,25537,88.3,47282,22159,25123,88.2
서울특별시,강서구,55세,2017,9240,4422,4818,91.8,9032,4313,4719,91.4
서울특별시,강서구,56세,2017,10114,4700,5414,86.8,9991,4637,5354,86.6
서울특별시,강서구,57세,2017,10200,4702,5498,85.5,10037,4618,5419,85.2
서울특별시,강서구,58세,2017,9557,4548,5009,90.8,9398,4476,4922,90.9
서울특별시,강서구,59세,2017,8980,4182,4798,87.2,8824,4115,4709,87.4
서울특별시,강서구,60~64세,2017,39422,18332,21090,86.9,38642,17953,20689,86.8
서울특별시,강서구,60세,2017,9180,4309,4871,88.5,9005,4223,4782,88.3
서울특별시,강서구,61세,2017,8157,3768,4389,85.9,7989,3687,4302,85.7
서울특별시,강서구,62세,2017,8630,3910,4720,82.8,8469,3833,4636,82.7
서울특별시,강서구,63세,2017,7083,3291,3792,86.8,6934,3224,3710,86.9
서울특별시,강서구,64세,2017,6372,3054,3318,92,6245,2986,3259,91.6
서울특별시,강서구,65~69세,2017,27324,13119,14205,92.4,27002,12974,14028,92.5
서울특별시,강서구,65세,2017,6783,3244,3539,91.7,6674,3193,3481,91.7
서울특별시,강서구,66세,2017,4731,2258,2473,91.3,4659,2226,2433,91.5
서울특별시,강서구,67세,2017,5402,2589,2813,92,5338,2560,2778,92.2
서울특별시,강서구,68세,2017,5384,2570,2814,91.3,5333,2548,2785,91.5
서울특별시,강서구,69세,2017,5024,2458,2566,95.8,4998,2447,2551,95.9
서울특별시,강서구,70~74세,2017,18967,9180,9787,93.8,18842,9129,9713,94
서울특별시,강서구,70세,2017,5110,2488,2622,94.9,5077,2474,2603,95
서울특별시,강서구,71세,2017,3773,1857,1916,96.9,3751,1848,1903,97.1
서울특별시,강서구,72세,2017,3532,1716,1816,94.5,3502,1703,1799,94.7
서울특별시,강서구,73세,2017,3344,1638,1706,96,3325,1631,1694,96.3
서울특별시,강서구,74세,2017,3208,1481,1727,85.8,3187,1473,1714,85.9
서울특별시,강서구,75~79세,2017,13805,5989,7816,76.6,13725,5967,7758,76.9
서울특별시,강서구,75세,2017,3651,1715,1936,88.6,3629,1707,1922,88.8
서울특별시,강서구,76세,2017,2865,1249,1616,77.3,2857,1245,1612,77.2
서울특별시,강서구,77세,2017,2639,1154,1485,77.7,2619,1147,1472,77.9
서울특별시,강서구,78세,2017,2515,1003,1512,66.3,2498,1000,1498,66.8
서울특별시,강서구,79세,2017,2135,868,1267,68.5,2122,868,1254,69.2
서울특별시,강서구,80~84세,2017,7700,2708,4992,54.2,7666,2696,4970,54.2
서울특별시,강서구,80세,2017,1873,685,1188,57.7,1866,682,1184,57.6
서울특별시,강서구,81세,2017,1644,597,1047,57,1636,594,1042,57
서울특별시,강서구,82세,2017,1667,591,1076,54.9,1663,589,1074,54.8
서울특별시,강서구,83세,2017,1345,450,895,50.3,1337,448,889,50.4
서울특별시,강서구,84세,2017,1171,385,786,49,1164,383,781,49
서울특별시,강서구,85세이상,2017,5510,1446,4064,35.6,5488,1440,4048,35.6
서울특별시,강서구,85~89세,2017,3868,1059,2809,37.7,3852,1055,2797,37.7
서울특별시,강서구,85세,2017,1028,310,718,43.2,1025,310,715,43.4
서울특별시,강서구,86세,2017,802,232,570,40.7,796,229,567,40.4
서울특별시,강서구,87세,2017,802,210,592,35.5,797,209,588,35.5
서울특별시,강서구,88세,2017,688,178,510,34.9,686,178,508,35
서울특별시,강서구,89세,2017,548,129,419,30.8,548,129,419,30.8
서울특별시,강서구,90~94세,2017,1315,313,1002,31.2,1310,311,999,31.1
서울특별시,강서구,90세,2017,428,99,329,30.1,427,99,328,30.2
서울특별시,강서구,91세,2017,298,65,233,27.9,296,64,232,27.6
서울특별시,강서구,92세,2017,249,57,192,29.7,249,57,192,29.7
서울특별시,강서구,93세,2017,191,58,133,43.6,189,57,132,43.2
서울특별시,강서구,94세,2017,149,34,115,29.6,149,34,115,29.6
서울특별시,강서구,95~99세,2017,293,70,223,31.4,292,70,222,31.5
서울특별시,강서구,95세,2017,125,26,99,26.3,124,26,98,26.5
서울특별시,강서구,96세,2017,64,16,48,33.3,64,16,48,33.3
서울특별시,강서구,97세,2017,48,14,34,41.2,48,14,34,41.2
서울특별시,강서구,98세,2017,41,7,34,20.6,41,7,34,20.6
서울특별시,강서구,99세,2017,15,7,8,87.5,15,7,8,87.5
서울특별시,강서구,100세이상,2017,34,X,30,13.3,34,X,30,13.3
서울특별시,강서구,15세미만,2017,70300,35860,34440,104.1,69944,35677,34267,104.1
서울특별시,강서구,15~64세,2017,438069,214376,223693,95.8,430326,210681,219645,95.9
서울특별시,강서구,65세이상,2017,73306,32442,40864,79.4,72723,32206,40517,79.5
서울특별시,강서구,평균연령,2017,41,40.1,41.8,,40.9,40.1,41.7,
서울특별시,강서구,중위연령,2017,40.6,39.7,41.5,,40.6,39.7,41.5,
서울특별시,구로구,합계,2017,436869,218428,218441,100,394962,195772,199190,98.3
서울특별시,구로구,0~4세,2017,18025,9174,8851,103.6,16969,8637,8332,103.7
서울특별시,구로구,0세,2017,3318,1696,1622,104.6,3076,1568,1508,104
서울특별시,구로구,1세,2017,3608,1866,1742,107.1,3374,1742,1632,106.7
서울특별시,구로구,2세,2017,3777,1897,1880,100.9,3575,1806,1769,102.1
서울특별시,구로구,3세,2017,3597,1834,1763,104,3419,1740,1679,103.6
서울특별시,구로구,4세,2017,3725,1881,1844,102,3525,1781,1744,102.1
서울특별시,구로구,5~9세,2017,17196,8674,8522,101.8,16632,8373,8259,101.4
서울특별시,구로구,5세,2017,3768,1881,1887,99.7,3610,1801,1809,99.6
서울특별시,구로구,6세,2017,3574,1810,1764,102.6,3462,1748,1714,102
서울특별시,구로구,7세,2017,3425,1752,1673,104.7,3315,1690,1625,104
서울특별시,구로구,8세,2017,3157,1580,1577,100.2,3064,1536,1528,100.5
서울특별시,구로구,9세,2017,3272,1651,1621,101.9,3181,1598,1583,100.9
서울특별시,구로구,10~14세,2017,14708,7581,7127,106.4,14389,7422,6967,106.5
서울특별시,구로구,10세,2017,3263,1622,1641,98.8,3156,1574,1582,99.5
서울특별시,구로구,11세,2017,2939,1541,1398,110.2,2881,1516,1365,111.1
서울특별시,구로구,12세,2017,2683,1443,1240,116.4,2623,1405,1218,115.4
서울특별시,구로구,13세,2017,2924,1513,1411,107.2,2876,1487,1389,107.1
서울특별시,구로구,14세,2017,2899,1462,1437,101.7,2853,1440,1413,101.9
서울특별시,구로구,15~19세,2017,18416,9772,8644,113,18081,9584,8497,112.8
서울특별시,구로구,15세,2017,3099,1627,1472,110.5,3061,1602,1459,109.8
서울특별시,구로구,16세,2017,3596,1966,1630,120.6,3549,1935,1614,119.9
서울특별시,구로구,17세,2017,3954,2101,1853,113.4,3886,2062,1824,113
서울특별시,구로구,18세,2017,3826,2016,1810,111.4,3757,1976,1781,110.9
서울특별시,구로구,19세,2017,3941,2062,1879,109.7,3828,2009,1819,110.4
서울특별시,구로구,20~24세,2017,24989,12505,12484,100.2,23850,12001,11849,101.3
서울특별시,구로구,20세,2017,4342,2228,2114,105.4,4194,2162,2032,106.4
서울특별시,구로구,21세,2017,4608,2382,2226,107,4457,2302,2155,106.8
서울특별시,구로구,22세,2017,4891,2461,2430,101.3,4680,2364,2316,102.1
서울특별시,구로구,23세,2017,5459,2744,2715,101.1,5172,2616,2556,102.3
서울특별시,구로구,24세,2017,5689,2690,2999,89.7,5347,2557,2790,91.6
서울특별시,구로구,25~29세,2017,31989,15766,16223,97.2,28269,13788,14481,95.2
서울특별시,구로구,25세,2017,6226,3002,3224,93.1,5701,2743,2958,92.7
서울특별시,구로구,26세,2017,6359,3125,3234,96.6,5711,2777,2934,94.6
서울특별시,구로구,27세,2017,6475,3228,3247,99.4,5678,2794,2884,96.9
서울특별시,구로구,28세,2017,6406,3186,3220,98.9,5556,2736,2820,97
서울특별시,구로구,29세,2017,6523,3225,3298,97.8,5623,2738,2885,94.9
서울특별시,구로구,30~34세,2017,35596,18131,17465,103.8,31195,15720,15475,101.6
서울특별시,구로구,30세,2017,6873,3379,3494,96.7,5884,2881,3003,95.9
서울특별시,구로구,31세,2017,6813,3485,3328,104.7,5852,2953,2899,101.9
서울특별시,구로구,32세,2017,6909,3534,3375,104.7,6056,3054,3002,101.7
서울특별시,구로구,33세,2017,7250,3704,3546,104.5,6421,3239,3182,101.8
서울특별시,구로구,34세,2017,7751,4029,3722,108.2,6982,3593,3389,106
서울특별시,구로구,35~39세,2017,38727,20264,18463,109.8,35435,18253,17182,106.2
서울특별시,구로구,35세,2017,8226,4265,3961,107.7,7407,3785,3622,104.5
서울특별시,구로구,36세,2017,8015,4156,3859,107.7,7433,3793,3640,104.2
서울특별시,구로구,37세,2017,7992,4181,3811,109.7,7381,3810,3571,106.7
서울특별시,구로구,38세,2017,7682,4073,3609,112.9,7022,3647,3375,108.1
서울특별시,구로구,39세,2017,6812,3589,3223,111.4,6192,3218,2974,108.2
서울특별시,구로구,40~44세,2017,34919,18532,16387,113.1,31730,16504,15226,108.4
서울특별시,구로구,40세,2017,6880,3661,3219,113.7,6299,3280,3019,108.6
서울특별시,구로구,41세,2017,6762,3595,3167,113.5,6176,3204,2972,107.8
서울특별시,구로구,42세,2017,6570,3489,3081,113.2,6022,3145,2877,109.3
서울특별시,구로구,43세,2017,7275,3841,3434,111.9,6599,3414,3185,107.2
서울특별시,구로구,44세,2017,7432,3946,3486,113.2,6634,3461,3173,109.1
서울특별시,구로구,45~49세,2017,36693,18823,17870,105.3,31851,16081,15770,102
서울특별시,구로구,45세,2017,7241,3870,3371,114.8,6404,3367,3037,110.9
서울특별시,구로구,46세,2017,7544,3916,3628,107.9,6624,3417,3207,106.5
서울특별시,구로구,47세,2017,7398,3785,3613,104.8,6317,3184,3133,101.6
서울특별시,구로구,48세,2017,7352,3753,3599,104.3,6350,3164,3186,99.3
서울특별시,구로구,49세,2017,7158,3499,3659,95.6,6156,2949,3207,92
서울특별시,구로구,50~54세,2017,35343,17768,17575,101.1,29388,14561,14827,98.2
서울특별시,구로구,50세,2017,6763,3432,3331,103,5904,2962,2942,100.7
서울특별시,구로구,51세,2017,6776,3437,3339,102.9,5699,2820,2879,98
서울특별시,구로구,52세,2017,7267,3671,3596,102.1,6026,3007,3019,99.6
서울특별시,구로구,53세,2017,7040,3523,3517,100.2,5767,2845,2922,97.4
서울특별시,구로구,54세,2017,7497,3705,3792,97.7,5992,2927,3065,95.5
서울특별시,구로구,55~59세,2017,37716,18271,19445,94,32759,15700,17059,92
서울특별시,구로구,55세,2017,7584,3747,3837,97.7,6376,3138,3238,96.9
서울특별시,구로구,56세,2017,7523,3635,3888,93.5,6817,3293,3524,93.4
서울특별시,구로구,57세,2017,8170,3897,4273,91.2,7016,3271,3745,87.3
서울특별시,구로구,58세,2017,7249,3472,3777,91.9,6365,2989,3376,88.5
서울특별시,구로구,59세,2017,7190,3520,3670,95.9,6185,3009,3176,94.7
서울특별시,구로구,60~64세,2017,32837,15760,17077,92.3,27844,13085,14759,88.7
서울특별시,구로구,60세,2017,7412,3593,3819,94.1,6159,2909,3250,89.5
서울특별시,구로구,61세,2017,6879,3255,3624,89.8,5806,2691,3115,86.4
서울특별시,구로구,62세,2017,7060,3430,3630,94.5,6049,2875,3174,90.6
서울특별시,구로구,63세,2017,6086,2891,3195,90.5,5138,2405,2733,88
서울특별시,구로구,64세,2017,5400,2591,2809,92.2,4692,2205,2487,88.7
서울특별시,구로구,65~69세,2017,22595,11035,11560,95.5,20627,10050,10577,95
서울특별시,구로구,65세,2017,5415,2626,2789,94.2,4833,2324,2509,92.6
서울특별시,구로구,66세,2017,4118,2003,2115,94.7,3646,1767,1879,94
서울특별시,구로구,67세,2017,4545,2215,2330,95.1,4136,2001,2135,93.7
서울특별시,구로구,68세,2017,4419,2143,2276,94.2,4129,2008,2121,94.7
서울특별시,구로구,69세,2017,4098,2048,2050,99.9,3883,1950,1933,100.9
서울특별시,구로구,70~74세,2017,15958,7783,8175,95.2,15400,7561,7839,96.5
서울특별시,구로구,70세,2017,4230,2113,2117,99.8,4030,2019,2011,100.4
서울특별시,구로구,71세,2017,3109,1495,1614,92.6,2978,1440,1538,93.6
서울특별시,구로구,72세,2017,2955,1439,1516,94.9,2870,1411,1459,96.7
서울특별시,구로구,73세,2017,2832,1382,1450,95.3,2755,1351,1404,96.2
서울특별시,구로구,74세,2017,2832,1354,1478,91.6,2767,1340,1427,93.9
서울특별시,구로구,75~79세,2017,11733,5330,6403,83.2,11376,5243,6133,85.5
서울특별시,구로구,75세,2017,3190,1500,1690,88.8,3112,1482,1630,90.9
서울특별시,구로구,76세,2017,2407,1139,1268,89.8,2336,1124,1212,92.7
서울특별시,구로구,77세,2017,2186,946,1240,76.3,2107,932,1175,79.3
서울특별시,구로구,78세,2017,2073,929,1144,81.2,2008,911,1097,83
서울특별시,구로구,79세,2017,1877,816,1061,76.9,1813,794,1019,77.9
서울특별시,구로구,80~84세,2017,6007,2347,3660,64.1,5837,2314,3523,65.7
서울특별시,구로구,80세,2017,1535,659,876,75.2,1489,650,839,77.5
서울특별시,구로구,81세,2017,1351,553,798,69.3,1308,546,762,71.7
서울특별시,구로구,82세,2017,1283,476,807,59,1250,468,782,59.8
서울특별시,구로구,83세,2017,982,347,635,54.6,958,344,614,56
서울특별시,구로구,84세,2017,856,312,544,57.4,832,306,526,58.2
서울특별시,구로구,85세이상,2017,3422,912,2510,36.3,3330,895,2435,36.8
서울특별시,구로구,85~89세,2017,2441,714,1727,41.3,2368,700,1668,42
서울특별시,구로구,85세,2017,677,231,446,51.8,658,226,432,52.3
서울특별시,구로구,86세,2017,528,158,370,42.7,510,154,356,43.3
서울특별시,구로구,87세,2017,504,139,365,38.1,487,137,350,39.1
서울특별시,구로구,88세,2017,399,112,287,39,389,112,277,40.4
서울특별시,구로구,89세,2017,333,74,259,28.6,324,71,253,28.1
서울특별시,구로구,90~94세,2017,792,164,628,26.1,774,161,613,26.3
서울특별시,구로구,90세,2017,275,60,215,27.9,271,60,211,28.4
서울특별시,구로구,91세,2017,192,42,150,28,187,40,147,27.2
서울특별시,구로구,92세,2017,125,17,108,15.7,122,17,105,16.2
서울특별시,구로구,93세,2017,100,23,77,29.9,96,23,73,31.5
서울특별시,구로구,94세,2017,100,22,78,28.2,98,21,77,27.3
서울특별시,구로구,95~99세,2017,173,32,141,22.7,172,32,140,22.9
서울특별시,구로구,95세,2017,72,15,57,26.3,72,15,57,26.3
서울특별시,구로구,96세,2017,43,6,37,16.2,42,6,36,16.7
서울특별시,구로구,97세,2017,34,9,25,36,34,9,25,36
서울특별시,구로구,98세,2017,12,X,10,20,12,X,10,20
서울특별시,구로구,99세,2017,12,X,12,0,12,X,12,0
서울특별시,구로구,100세이상,2017,16,X,14,14.3,16,X,14,14.3
서울특별시,구로구,15세미만,2017,49929,25429,24500,103.8,47990,24432,23558,103.7
서울특별시,구로구,15~64세,2017,327225,165592,161633,102.4,290402,145277,145125,100.1
서울특별시,구로구,65세이상,2017,59715,27407,32308,84.8,56570,26063,30507,85.4
서울특별시,구로구,평균연령,2017,42.2,41.5,42.8,,41.8,41.1,42.5,
서울특별시,구로구,중위연령,2017,42.8,42,43.6,,42,41.3,42.9,
서울특별시,금천구,합계,2017,249930,127252,122678,103.7,224487,113579,110908,102.4
서울특별시,금천구,0~4세,2017,8449,4370,4079,107.1,7771,4015,3756,106.9
서울특별시,금천구,0세,2017,1612,859,753,114.1,1454,766,688,111.3
서울특별시,금천구,1세,2017,1780,913,867,105.3,1612,824,788,104.6
서울특별시,금천구,2세,2017,1816,937,879,106.6,1699,875,824,106.2
서울특별시,금천구,3세,2017,1670,869,801,108.5,1542,808,734,110.1
서울특별시,금천구,4세,2017,1571,792,779,101.7,1464,742,722,102.8
서울특별시,금천구,5~9세,2017,7730,3970,3760,105.6,7341,3771,3570,105.6
서울특별시,금천구,5세,2017,1811,926,885,104.6,1684,865,819,105.6
서울특별시,금천구,6세,2017,1569,789,780,101.2,1481,745,736,101.2
서울특별시,금천구,7세,2017,1496,786,710,110.7,1422,744,678,109.7
서울특별시,금천구,8세,2017,1420,722,698,103.4,1366,696,670,103.9
서울특별시,금천구,9세,2017,1434,747,687,108.7,1388,721,667,108.1
서울특별시,금천구,10~14세,2017,7414,3729,3685,101.2,7281,3654,3627,100.7
서울특별시,금천구,10세,2017,1497,745,752,99.1,1458,720,738,97.6
서울특별시,금천구,11세,2017,1422,701,721,97.2,1394,685,709,96.6
서울특별시,금천구,12세,2017,1429,738,691,106.8,1397,719,678,106
서울특별시,금천구,13세,2017,1482,745,737,101.1,1463,738,725,101.8
서울특별시,금천구,14세,2017,1584,800,784,102,1569,792,777,101.9
서울특별시,금천구,15~19세,2017,10411,5297,5114,103.6,10260,5232,5028,104.1
서울특별시,금천구,15세,2017,1711,896,815,109.9,1690,886,804,110.2
서울특별시,금천구,16세,2017,1918,937,981,95.5,1900,929,971,95.7
서울특별시,금천구,17세,2017,2212,1085,1127,96.3,2178,1070,1108,96.6
서울특별시,금천구,18세,2017,2284,1194,1090,109.5,2248,1176,1072,109.7
서울특별시,금천구,19세,2017,2286,1185,1101,107.6,2244,1171,1073,109.1
서울특별시,금천구,20~24세,2017,15321,7821,7500,104.3,14677,7534,7143,105.5
서울특별시,금천구,20세,2017,2544,1323,1221,108.4,2479,1290,1189,108.5
서울특별시,금천구,21세,2017,2819,1456,1363,106.8,2727,1413,1314,107.5
서울특별시,금천구,22세,2017,2921,1529,1392,109.8,2830,1495,1335,112
서울특별시,금천구,23세,2017,3405,1708,1697,100.6,3230,1633,1597,102.3
서울특별시,금천구,24세,2017,3632,1805,1827,98.8,3411,1703,1708,99.7
서울특별시,금천구,25~29세,2017,20347,10625,9722,109.3,18110,9487,8623,110
서울특별시,금천구,25세,2017,3959,2001,1958,102.2,3659,1842,1817,101.4
서울특별시,금천구,26세,2017,4119,2098,2021,103.8,3741,1905,1836,103.8
서울특별시,금천구,27세,2017,4203,2213,1990,111.2,3692,1956,1736,112.7
서울특별시,금천구,28세,2017,4120,2170,1950,111.3,3621,1923,1698,113.3
서울특별시,금천구,29세,2017,3946,2143,1803,118.9,3397,1861,1536,121.2
서울특별시,금천구,30~34세,2017,20375,11216,9159,122.5,17723,9752,7971,122.3
서울특별시,금천구,30세,2017,4169,2240,1929,116.1,3600,1939,1661,116.7
서울특별시,금천구,31세,2017,4127,2313,1814,127.5,3509,1969,1540,127.9
서울특별시,금천구,32세,2017,3919,2156,1763,122.3,3420,1874,1546,121.2
서울특별시,금천구,33세,2017,4086,2293,1793,127.9,3579,2003,1576,127.1
서울특별시,금천구,34세,2017,4074,2214,1860,119,3615,1967,1648,119.4
서울특별시,금천구,35~39세,2017,19608,10738,8870,121.1,17573,9504,8069,117.8
서울특별시,금천구,35세,2017,4364,2416,1948,124,3895,2134,1761,121.2
서울특별시,금천구,36세,2017,4014,2217,1797,123.4,3624,1982,1642,120.7
서울특별시,금천구,37세,2017,4008,2207,1801,122.5,3631,1979,1652,119.8
서울특별시,금천구,38세,2017,3803,2070,1733,119.4,3405,1824,1581,115.4
서울특별시,금천구,39세,2017,3419,1828,1591,114.9,3018,1585,1433,110.6
서울특별시,금천구,40~44세,2017,18218,9835,8383,117.3,16171,8551,7620,112.2
서울특별시,금천구,40세,2017,3423,1932,1491,129.6,3077,1708,1369,124.8
서울특별시,금천구,41세,2017,3378,1798,1580,113.8,2997,1549,1448,107
서울특별시,금천구,42세,2017,3500,1853,1647,112.5,3134,1635,1499,109.1
서울특별시,금천구,43세,2017,3862,2086,1776,117.5,3444,1824,1620,112.6
서울특별시,금천구,44세,2017,4055,2166,1889,114.7,3519,1835,1684,109
서울특별시,금천구,45~49세,2017,22053,11369,10684,106.4,19002,9652,9350,103.2
서울특별시,금천구,45세,2017,4051,2134,1917,111.3,3557,1844,1713,107.6
서울특별시,금천구,46세,2017,4436,2329,2107,110.5,3820,1975,1845,107
서울특별시,금천구,47세,2017,4437,2288,2149,106.5,3808,1929,1879,102.7
서울특별시,금천구,48세,2017,4488,2281,2207,103.4,3842,1944,1898,102.4
서울특별시,금천구,49세,2017,4641,2337,2304,101.4,3975,1960,2015,97.3
서울특별시,금천구,50~54세,2017,23002,11611,11391,101.9,19370,9651,9719,99.3
서울특별시,금천구,50세,2017,4166,2018,2148,93.9,3633,1727,1906,90.6
서울특별시,금천구,51세,2017,4507,2342,2165,108.2,3852,1970,1882,104.7
서울특별시,금천구,52세,2017,4734,2373,2361,100.5,3995,1956,2039,95.9
서울특별시,금천구,53세,2017,4639,2361,2278,103.6,3888,1958,1930,101.5
서울특별시,금천구,54세,2017,4956,2517,2439,103.2,4002,2040,1962,104
서울특별시,금천구,55~59세,2017,23723,11838,11885,99.6,20773,10299,10474,98.3
서울특별시,금천구,55세,2017,4881,2483,2398,103.5,4132,2074,2058,100.8
서울특별시,금천구,56세,2017,4861,2374,2487,95.5,4439,2162,2277,94.9
서울특별시,금천구,57세,2017,5098,2561,2537,100.9,4392,2195,2197,99.9
서울특별시,금천구,58세,2017,4592,2273,2319,98,4067,1984,2083,95.2
서울특별시,금천구,59세,2017,4291,2147,2144,100.1,3743,1884,1859,101.3
서울특별시,금천구,60~64세,2017,19029,9366,9663,96.9,16078,7813,8265,94.5
서울특별시,금천구,60세,2017,4248,2124,2124,100,3499,1739,1760,98.8
서울특별시,금천구,61세,2017,4080,2075,2005,103.5,3474,1742,1732,100.6
서울특별시,금천구,62세,2017,4095,1967,2128,92.4,3477,1635,1842,88.8
서울특별시,금천구,63세,2017,3610,1756,1854,94.7,3059,1459,1600,91.2
서울특별시,금천구,64세,2017,2996,1444,1552,93,2569,1238,1331,93
서울특별시,금천구,65~69세,2017,12976,6350,6626,95.8,11759,5747,6012,95.6
서울특별시,금천구,65세,2017,3201,1579,1622,97.3,2833,1386,1447,95.8
서울특별시,금천구,66세,2017,2427,1226,1201,102.1,2140,1075,1065,100.9
서울특별시,금천구,67세,2017,2636,1277,1359,94,2402,1177,1225,96.1
서울특별시,금천구,68세,2017,2468,1175,1293,90.9,2266,1073,1193,89.9
서울특별시,금천구,69세,2017,2244,1093,1151,95,2118,1036,1082,95.7
서울특별시,금천구,70~74세,2017,9087,4301,4786,89.9,8757,4177,4580,91.2
서울특별시,금천구,70세,2017,2335,1109,1226,90.5,2241,1073,1168,91.9
서울특별시,금천구,71세,2017,1741,812,929,87.4,1668,786,882,89.1
서울특별시,금천구,72세,2017,1751,836,915,91.4,1693,811,882,92
서울특별시,금천구,73세,2017,1623,738,885,83.4,1576,721,855,84.3
서울특별시,금천구,74세,2017,1637,806,831,97,1579,786,793,99.1
서울특별시,금천구,75~79세,2017,6775,3026,3749,80.7,6564,2976,3588,82.9
서울특별시,금천구,75세,2017,1824,852,972,87.7,1787,839,948,88.5
서울특별시,금천구,76세,2017,1457,656,801,81.9,1414,646,768,84.1
서울특별시,금천구,77세,2017,1253,555,698,79.5,1210,547,663,82.5
서울특별시,금천구,78세,2017,1231,538,693,77.6,1184,529,655,80.8
서울특별시,금천구,79세,2017,1010,425,585,72.6,969,415,554,74.9
서울특별시,금천구,80~84세,2017,3356,1257,2099,59.9,3254,1235,2019,61.2
서울특별시,금천구,80세,2017,833,341,492,69.3,805,337,468,72
서울특별시,금천구,81세,2017,760,296,464,63.8,742,291,451,64.5
서울특별시,금천구,82세,2017,704,248,456,54.4,684,243,441,55.1
서울특별시,금천구,83세,2017,590,211,379,55.7,567,207,360,57.5
서울특별시,금천구,84세,2017,469,161,308,52.3,456,157,299,52.5
서울특별시,금천구,85세이상,2017,2056,533,1523,35,2023,529,1494,35.4
서울특별시,금천구,85~89세,2017,1450,420,1030,40.8,1425,417,1008,41.4
서울특별시,금천구,85세,2017,436,144,292,49.3,428,143,285,50.2
서울특별시,금천구,86세,2017,324,111,213,52.1,319,109,210,51.9
서울특별시,금천구,87세,2017,278,73,205,35.6,273,73,200,36.5
서울특별시,금천구,88세,2017,206,50,156,32.1,204,50,154,32.5
서울특별시,금천구,89세,2017,206,42,164,25.6,201,42,159,26.4
서울특별시,금천구,90~94세,2017,466,88,378,23.3,461,87,374,23.3
서울특별시,금천구,90세,2017,168,29,139,20.9,167,29,138,21
서울특별시,금천구,91세,2017,89,13,76,17.1,88,13,75,17.3
서울특별시,금천구,92세,2017,93,15,78,19.2,93,15,78,19.2
서울특별시,금천구,93세,2017,58,12,46,26.1,55,11,44,25
서울특별시,금천구,94세,2017,58,19,39,48.7,58,19,39,48.7
서울특별시,금천구,95~99세,2017,124,24,100,24,122,24,98,24.5
서울특별시,금천구,95세,2017,50,11,39,28.2,48,11,37,29.7
서울특별시,금천구,96세,2017,23,X,19,21.1,23,X,19,21.1
서울특별시,금천구,97세,2017,27,5,22,22.7,27,5,22,22.7
서울특별시,금천구,98세,2017,14,X,12,16.7,14,X,12,16.7
서울특별시,금천구,99세,2017,10,X,8,25,10,X,8,25
서울특별시,금천구,100세이상,2017,16,X,15,6.7,15,X,14,7.1
서울특별시,금천구,15세미만,2017,23593,12069,11524,104.7,22393,11440,10953,104.4
서울특별시,금천구,15~64세,2017,192087,99716,92371,108,169737,87475,82262,106.3
서울특별시,금천구,65세이상,2017,34250,15467,18783,82.3,32357,14664,17693,82.9
서울특별시,금천구,평균연령,2017,43,42.2,43.9,,42.7,41.9,43.6,
서울특별시,금천구,중위연령,2017,44.3,43.1,45.6,,43.7,42.4,45,
서울특별시,영등포구,합계,2017,393560,196929,196631,100.2,346852,172220,174632,98.6
서울특별시,영등포구,0~4세,2017,15410,7961,7449,106.9,14233,7372,6861,107.4
서울특별시,영등포구,0세,2017,2954,1539,1415,108.8,2722,1434,1288,111.3
서울특별시,영등포구,1세,2017,3318,1720,1598,107.6,3032,1561,1471,106.1
서울특별시,영등포구,2세,2017,3257,1681,1576,106.7,3027,1552,1475,105.2
서울특별시,영등포구,3세,2017,3053,1546,1507,102.6,2813,1440,1373,104.9
서울특별시,영등포구,4세,2017,2828,1475,1353,109,2639,1385,1254,110.4
서울특별시,영등포구,5~9세,2017,12867,6504,6363,102.2,12205,6171,6034,102.3
서울특별시,영등포구,5세,2017,2901,1429,1472,97.1,2726,1343,1383,97.1
서울특별시,영등포구,6세,2017,2663,1312,1351,97.1,2520,1238,1282,96.6
서울특별시,영등포구,7세,2017,2441,1234,1207,102.2,2311,1169,1142,102.4
서울특별시,영등포구,8세,2017,2370,1232,1138,108.3,2260,1180,1080,109.3
서울특별시,영등포구,9세,2017,2492,1297,1195,108.5,2388,1241,1147,108.2
서울특별시,영등포구,10~14세,2017,11592,6176,5416,114,11226,5978,5248,113.9
서울특별시,영등포구,10세,2017,2490,1303,1187,109.8,2402,1264,1138,111.1
서울특별시,영등포구,11세,2017,2311,1208,1103,109.5,2225,1164,1061,109.7
서울특별시,영등포구,12세,2017,2117,1126,991,113.6,2031,1083,948,114.2
서울특별시,영등포구,13세,2017,2360,1264,1096,115.3,2294,1221,1073,113.8
서울특별시,영등포구,14세,2017,2314,1275,1039,122.7,2274,1246,1028,121.2
서울특별시,영등포구,15~19세,2017,14536,7530,7006,107.5,14209,7358,6851,107.4
서울특별시,영등포구,15세,2017,2435,1289,1146,112.5,2388,1266,1122,112.8
서울특별시,영등포구,16세,2017,2714,1407,1307,107.7,2662,1375,1287,106.8
서울특별시,영등포구,17세,2017,3024,1564,1460,107.1,2957,1523,1434,106.2
서울특별시,영등포구,18세,2017,3046,1620,1426,113.6,2981,1586,1395,113.7
서울특별시,영등포구,19세,2017,3317,1650,1667,99,3221,1608,1613,99.7
서울특별시,영등포구,20~24세,2017,22180,10710,11470,93.4,20975,10187,10788,94.4
서울특별시,영등포구,20세,2017,3616,1848,1768,104.5,3501,1796,1705,105.3
서울특별시,영등포구,21세,2017,3899,1953,1946,100.4,3740,1886,1854,101.7
서울특별시,영등포구,22세,2017,4380,2144,2236,95.9,4159,2057,2102,97.9
서울특별시,영등포구,23세,2017,4772,2271,2501,90.8,4469,2145,2324,92.3
서울특별시,영등포구,24세,2017,5513,2494,3019,82.6,5106,2303,2803,82.2
서울특별시,영등포구,25~29세,2017,33701,16352,17349,94.3,29522,14215,15307,92.9
서울특별시,영등포구,25세,2017,6245,2928,3317,88.3,5670,2636,3034,86.9
서울특별시,영등포구,26세,2017,6653,3072,3581,85.8,5911,2704,3207,84.3
서울특별시,영등포구,27세,2017,6720,3295,3425,96.2,5804,2836,2968,95.6
서울특별시,영등포구,28세,2017,7026,3554,3472,102.4,6070,3042,3028,100.5
서울특별시,영등포구,29세,2017,7057,3503,3554,98.6,6067,2997,3070,97.6
서울특별시,영등포구,30~34세,2017,36396,18803,17593,106.9,31595,16090,15505,103.8
서울특별시,영등포구,30세,2017,7335,3660,3675,99.6,6201,3047,3154,96.6
서울특별시,영등포구,31세,2017,7241,3717,3524,105.5,6172,3122,3050,102.4
서울특별시,영등포구,32세,2017,7198,3762,3436,109.5,6311,3258,3053,106.7
서울특별시,영등포구,33세,2017,7223,3824,3399,112.5,6363,3331,3032,109.9
서울특별시,영등포구,34세,2017,7399,3840,3559,107.9,6548,3332,3216,103.6
서울특별시,영등포구,35~39세,2017,34494,18285,16209,112.8,30837,16082,14755,109
서울특별시,영등포구,35세,2017,7671,4038,3633,111.1,6825,3556,3269,108.8
서울특별시,영등포구,36세,2017,7286,3924,3362,116.7,6621,3550,3071,115.6
서울특별시,영등포구,37세,2017,7086,3732,3354,111.3,6444,3333,3111,107.1
서울특별시,영등포구,38세,2017,6676,3533,3143,112.4,5874,3026,2848,106.3
서울특별시,영등포구,39세,2017,5775,3058,2717,112.6,5073,2617,2456,106.6
서울특별시,영등포구,40~44세,2017,30149,16048,14101,113.8,26659,13845,12814,108
서울특별시,영등포구,40세,2017,5993,3160,2833,111.5,5397,2778,2619,106.1
서울특별시,영등포구,41세,2017,5782,3023,2759,109.6,5149,2629,2520,104.3
서울특별시,영등포구,42세,2017,5733,3079,2654,116,5131,2704,2427,111.4
서울특별시,영등포구,43세,2017,6216,3377,2839,119,5449,2890,2559,112.9
서울특별시,영등포구,44세,2017,6425,3409,3016,113,5533,2844,2689,105.8
서울특별시,영등포구,45~49세,2017,33595,17351,16244,106.8,27977,14304,13673,104.6
서울특별시,영등포구,45세,2017,6455,3429,3026,113.3,5484,2872,2612,110
서울특별시,영등포구,46세,2017,6932,3570,3362,106.2,5854,2979,2875,103.6
서울특별시,영등포구,47세,2017,6770,3542,3228,109.7,5549,2877,2672,107.7
서울특별시,영등포구,48세,2017,6801,3415,3386,100.9,5679,2839,2840,100
서울특별시,영등포구,49세,2017,6637,3395,3242,104.7,5411,2737,2674,102.4
서울특별시,영등포구,50~54세,2017,32787,16609,16178,102.7,25894,13029,12865,101.3
서울특별시,영등포구,50세,2017,6098,3049,3049,100,5111,2506,2605,96.2
서울특별시,영등포구,51세,2017,6235,3192,3043,104.9,5027,2555,2472,103.4
서울특별시,영등포구,52세,2017,6613,3305,3308,99.9,5231,2604,2627,99.1
서울특별시,영등포구,53세,2017,6709,3369,3340,100.9,5206,2615,2591,100.9
서울특별시,영등포구,54세,2017,7132,3694,3438,107.4,5319,2749,2570,107
서울특별시,영등포구,55~59세,2017,33878,16598,17280,96.1,28248,13780,14468,95.2
서울특별시,영등포구,55세,2017,6840,3451,3389,101.8,5513,2799,2714,103.1
서울특별시,영등포구,56세,2017,6761,3235,3526,91.7,5933,2817,3116,90.4
서울특별시,영등포구,57세,2017,7313,3497,3816,91.6,6003,2852,3151,90.5
서울특별시,영등포구,58세,2017,6592,3253,3339,97.4,5525,2700,2825,95.6
서울특별시,영등포구,59세,2017,6372,3162,3210,98.5,5274,2612,2662,98.1
서울특별시,영등포구,60~64세,2017,28389,13976,14413,97,23012,11197,11815,94.8
서울특별시,영등포구,60세,2017,6556,3261,3295,99,5233,2572,2661,96.7
서울특별시,영등포구,61세,2017,6049,3012,3037,99.2,4854,2388,2466,96.8
서울특별시,영등포구,62세,2017,6169,2973,3196,93,5030,2384,2646,90.1
서울특별시,영등포구,63세,2017,5158,2558,2600,98.4,4197,2074,2123,97.7
서울특별시,영등포구,64세,2017,4457,2172,2285,95.1,3698,1779,1919,92.7
서울특별시,영등포구,65~69세,2017,19363,9369,9994,93.7,17279,8318,8961,92.8
서울특별시,영등포구,65세,2017,4724,2343,2381,98.4,4078,1992,2086,95.5
서울특별시,영등포구,66세,2017,3525,1716,1809,94.9,3005,1446,1559,92.8
서울특별시,영등포구,67세,2017,3825,1787,2038,87.7,3442,1597,1845,86.6
서울특별시,영등포구,68세,2017,3783,1825,1958,93.2,3448,1671,1777,94
서울특별시,영등포구,69세,2017,3506,1698,1808,93.9,3306,1612,1694,95.2
서울특별시,영등포구,70~74세,2017,13614,6367,7247,87.9,13092,6172,6920,89.2
서울특별시,영등포구,70세,2017,3418,1622,1796,90.3,3258,1561,1697,92
서울특별시,영등포구,71세,2017,2708,1302,1406,92.6,2585,1252,1333,93.9
서울특별시,영등포구,72세,2017,2547,1232,1315,93.7,2461,1197,1264,94.7
서울특별시,영등포구,73세,2017,2459,1102,1357,81.2,2388,1080,1308,82.6
서울특별시,영등포구,74세,2017,2482,1109,1373,80.8,2400,1082,1318,82.1
서울특별시,영등포구,75~79세,2017,10839,4786,6053,79.1,10450,4692,5758,81.5
서울특별시,영등포구,75세,2017,2892,1292,1600,80.8,2820,1273,1547,82.3
서울특별시,영등포구,76세,2017,2240,992,1248,79.5,2146,972,1174,82.8
서울특별시,영등포구,77세,2017,2020,875,1145,76.4,1947,852,1095,77.8
서울특별시,영등포구,78세,2017,1987,887,1100,80.6,1895,866,1029,84.2
서울특별시,영등포구,79세,2017,1700,740,960,77.1,1642,729,913,79.8
서울특별시,영등포구,80~84세,2017,6200,2461,3739,65.8,5972,2413,3559,67.8
서울특별시,영등포구,80세,2017,1575,657,918,71.6,1511,637,874,72.9
서울특별시,영등포구,81세,2017,1409,582,827,70.4,1358,570,788,72.3
서울특별시,영등포구,82세,2017,1296,558,738,75.6,1247,550,697,78.9
서울특별시,영등포구,83세,2017,1024,366,658,55.6,999,363,636,57.1
서울특별시,영등포구,84세,2017,896,298,598,49.8,857,293,564,52
서울특별시,영등포구,85세이상,2017,3570,1043,2527,41.3,3467,1017,2450,41.5
서울특별시,영등포구,85~89세,2017,2492,772,1720,44.9,2417,754,1663,45.3
서울특별시,영등포구,85세,2017,709,248,461,53.8,681,239,442,54.1
서울특별시,영등포구,86세,2017,542,164,378,43.4,524,162,362,44.8
서울특별시,영등포구,87세,2017,488,145,343,42.3,473,141,332,42.5
서울특별시,영등포구,88세,2017,409,114,295,38.6,401,112,289,38.8
서울특별시,영등포구,89세,2017,344,101,243,41.6,338,100,238,42
서울특별시,영등포구,90~94세,2017,863,214,649,33,839,207,632,32.8
서울특별시,영등포구,90세,2017,286,70,216,32.4,275,68,207,32.9
서울특별시,영등포구,91세,2017,177,37,140,26.4,172,36,136,26.5
서울특별시,영등포구,92세,2017,150,35,115,30.4,146,34,112,30.4
서울특별시,영등포구,93세,2017,126,36,90,40,124,35,89,39.3
서울특별시,영등포구,94세,2017,124,36,88,40.9,122,34,88,38.6
서울특별시,영등포구,95~99세,2017,195,52,143,36.4,191,51,140,36.4
서울특별시,영등포구,95세,2017,75,21,54,38.9,72,20,52,38.5
서울특별시,영등포구,96세,2017,52,15,37,40.5,52,15,37,40.5
서울특별시,영등포구,97세,2017,35,10,25,40,34,10,24,41.7
서울특별시,영등포구,98세,2017,20,X,17,17.6,20,X,17,17.6
서울특별시,영등포구,99세,2017,13,X,10,30,13,X,10,30
서울특별시,영등포구,100세이상,2017,20,5,15,33.3,20,5,15,33.3
서울특별시,영등포구,15세미만,2017,39869,20641,19228,107.3,37664,19521,18143,107.6
서울특별시,영등포구,15~64세,2017,300105,152262,147843,103,258928,130087,128841,101
서울특별시,영등포구,65세이상,2017,53586,24026,29560,81.3,50260,22612,27648,81.8
서울특별시,영등포구,평균연령,2017,42.5,41.8,43.1,,42,41.3,42.8,
서울특별시,영등포구,중위연령,2017,42.7,42,43.4,,41.6,41,42.3,
서울특별시,동작구,합계,2017,400236,195253,204983,95.3,384227,187799,196428,95.6
서울특별시,동작구,0~4세,2017,14705,7491,7214,103.8,14462,7371,7091,103.9
서울특별시,동작구,0세,2017,2747,1377,1370,100.5,2698,1343,1355,99.1
서울특별시,동작구,1세,2017,3000,1562,1438,108.6,2948,1533,1415,108.3
서울특별시,동작구,2세,2017,3153,1603,1550,103.4,3106,1585,1521,104.2
서울특별시,동작구,3세,2017,2910,1496,1414,105.8,2865,1474,1391,106
서울특별시,동작구,4세,2017,2895,1453,1442,100.8,2845,1436,1409,101.9
서울특별시,동작구,5~9세,2017,14130,7307,6823,107.1,14011,7242,6769,107
서울특별시,동작구,5세,2017,3024,1589,1435,110.7,2997,1571,1426,110.2
서울특별시,동작구,6세,2017,2931,1478,1453,101.7,2896,1458,1438,101.4
서울특별시,동작구,7세,2017,2764,1468,1296,113.3,2744,1459,1285,113.5
서울특별시,동작구,8세,2017,2707,1367,1340,102,2688,1358,1330,102.1
서울특별시,동작구,9세,2017,2704,1405,1299,108.2,2686,1396,1290,108.2
서울특별시,동작구,10~14세,2017,13293,6914,6379,108.4,13236,6891,6345,108.6
서울특별시,동작구,10세,2017,2786,1490,1296,115,2769,1484,1285,115.5
서울특별시,동작구,11세,2017,2565,1319,1246,105.9,2551,1312,1239,105.9
서울특별시,동작구,12세,2017,2534,1298,1236,105,2523,1293,1230,105.1
서울특별시,동작구,13세,2017,2688,1385,1303,106.3,2679,1382,1297,106.6
서울특별시,동작구,14세,2017,2720,1422,1298,109.6,2714,1420,1294,109.7
서울특별시,동작구,15~19세,2017,18338,9220,9118,101.1,17873,9045,8828,102.5
서울특별시,동작구,15세,2017,2742,1383,1359,101.8,2733,1377,1356,101.5
서울특별시,동작구,16세,2017,3031,1562,1469,106.3,3018,1555,1463,106.3
서울특별시,동작구,17세,2017,3254,1682,1572,107,3229,1671,1558,107.3
서울특별시,동작구,18세,2017,3831,1941,1890,102.7,3713,1900,1813,104.8
서울특별시,동작구,19세,2017,5480,2652,2828,93.8,5180,2542,2638,96.4
서울특별시,동작구,20~24세,2017,33201,16039,17162,93.5,30587,15138,15449,98
서울특별시,동작구,20세,2017,5752,2619,3133,83.6,5209,2443,2766,88.3
서울특별시,동작구,21세,2017,6032,2805,3227,86.9,5515,2615,2900,90.2
서울특별시,동작구,22세,2017,6595,3218,3377,95.3,6038,3015,3023,99.7
서울특별시,동작구,23세,2017,7325,3665,3660,100.1,6798,3487,3311,105.3
서울특별시,동작구,24세,2017,7497,3732,3765,99.1,7027,3578,3449,103.7
서울특별시,동작구,25~29세,2017,36477,18447,18030,102.3,34470,17511,16959,103.3
서울특별시,동작구,25세,2017,7728,4000,3728,107.3,7320,3816,3504,108.9
서울특별시,동작구,26세,2017,7539,3772,3767,100.1,7176,3606,3570,101
서울특별시,동작구,27세,2017,7381,3759,3622,103.8,6934,3550,3384,104.9
서울특별시,동작구,28세,2017,6938,3447,3491,98.7,6549,3263,3286,99.3
서울특별시,동작구,29세,2017,6891,3469,3422,101.4,6491,3276,3215,101.9
서울특별시,동작구,30~34세,2017,33916,16997,16919,100.5,32315,16169,16146,100.1
서울특별시,동작구,30세,2017,6793,3421,3372,101.5,6420,3235,3185,101.6
서울특별시,동작구,31세,2017,6806,3357,3449,97.3,6425,3164,3261,97
서울특별시,동작구,32세,2017,6684,3349,3335,100.4,6363,3180,3183,99.9
서울특별시,동작구,33세,2017,6553,3306,3247,101.8,6281,3164,3117,101.5
서울특별시,동작구,34세,2017,7080,3564,3516,101.4,6826,3426,3400,100.8
서울특별시,동작구,35~39세,2017,33602,17152,16450,104.3,32557,16543,16014,103.3
서울특별시,동작구,35세,2017,7190,3648,3542,103,6944,3511,3433,102.3
서울특별시,동작구,36세,2017,6973,3650,3323,109.8,6795,3541,3254,108.8
서울특별시,동작구,37세,2017,7025,3575,3450,103.6,6838,3462,3376,102.5
서울특별시,동작구,38세,2017,6581,3375,3206,105.3,6353,3249,3104,104.7
서울특별시,동작구,39세,2017,5833,2904,2929,99.1,5627,2780,2847,97.6
서울특별시,동작구,40~44세,2017,29917,15268,14649,104.2,29028,14790,14238,103.9
서울특별시,동작구,40세,2017,5865,2919,2946,99.1,5710,2834,2876,98.5
서울특별시,동작구,41세,2017,5759,2974,2785,106.8,5581,2875,2706,106.2
서울특별시,동작구,42세,2017,5856,2984,2872,103.9,5694,2890,2804,103.1
서울특별시,동작구,43세,2017,6333,3329,3004,110.8,6144,3228,2916,110.7
서울특별시,동작구,44세,2017,6104,3062,3042,100.7,5899,2963,2936,100.9
서울특별시,동작구,45~49세,2017,31354,15590,15764,98.9,29951,14872,15079,98.6
서울특별시,동작구,45세,2017,6166,3225,2941,109.7,5926,3089,2837,108.9
서울특별시,동작구,46세,2017,6533,3244,3289,98.6,6257,3108,3149,98.7
서울특별시,동작구,47세,2017,6198,3137,3061,102.5,5927,3013,2914,103.4
서울특별시,동작구,48세,2017,6348,3090,3258,94.8,6044,2931,3113,94.2
서울특별시,동작구,49세,2017,6109,2894,3215,90,5797,2731,3066,89.1
서울특별시,동작구,50~54세,2017,28774,13739,15035,91.4,27035,12921,14114,91.5
서울특별시,동작구,50세,2017,5644,2652,2992,88.6,5389,2539,2850,89.1
서울특별시,동작구,51세,2017,5513,2680,2833,94.6,5204,2546,2658,95.8
서울특별시,동작구,52세,2017,5761,2716,3045,89.2,5418,2552,2866,89
서울특별시,동작구,53세,2017,5830,2814,3016,93.3,5455,2631,2824,93.2
서울특별시,동작구,54세,2017,6026,2877,3149,91.4,5569,2653,2916,91
서울특별시,동작구,55~59세,2017,31300,14575,16725,87.1,29757,13861,15896,87.2
서울특별시,동작구,55세,2017,6139,2968,3171,93.6,5775,2779,2996,92.8
서울특별시,동작구,56세,2017,6360,2967,3393,87.4,6162,2888,3274,88.2
서울특별시,동작구,57세,2017,6788,3132,3656,85.7,6406,2951,3455,85.4
서울특별시,동작구,58세,2017,6099,2805,3294,85.2,5802,2678,3124,85.7
서울특별시,동작구,59세,2017,5914,2703,3211,84.2,5612,2565,3047,84.2
서울특별시,동작구,60~64세,2017,26019,12189,13830,88.1,24577,11472,13105,87.5
서울특별시,동작구,60세,2017,5970,2811,3159,89,5572,2617,2955,88.6
서울특별시,동작구,61세,2017,5341,2464,2877,85.6,5026,2308,2718,84.9
서울특별시,동작구,62세,2017,5683,2687,2996,89.7,5406,2551,2855,89.4
서울특별시,동작구,63세,2017,4726,2217,2509,88.4,4473,2081,2392,87
서울특별시,동작구,64세,2017,4299,2010,2289,87.8,4100,1915,2185,87.6
서울특별시,동작구,65~69세,2017,19025,8673,10352,83.8,18504,8425,10079,83.6
서울특별시,동작구,65세,2017,4464,2064,2400,86,4309,1993,2316,86.1
서울특별시,동작구,66세,2017,3416,1540,1876,82.1,3285,1476,1809,81.6
서울특별시,동작구,67세,2017,3700,1745,1955,89.3,3602,1697,1905,89.1
서울특별시,동작구,68세,2017,3761,1648,2113,78,3667,1600,2067,77.4
서울특별시,동작구,69세,2017,3684,1676,2008,83.5,3641,1659,1982,83.7
서울특별시,동작구,70~74세,2017,14768,6784,7984,85,14627,6718,7909,84.9
서울특별시,동작구,70세,2017,3680,1650,2030,81.3,3635,1630,2005,81.3
서울특별시,동작구,71세,2017,2935,1283,1652,77.7,2903,1264,1639,77.1
서울특별시,동작구,72세,2017,2770,1259,1511,83.3,2743,1244,1499,83
서울특별시,동작구,73세,2017,2691,1259,1432,87.9,2672,1255,1417,88.6
서울특별시,동작구,74세,2017,2692,1333,1359,98.1,2674,1325,1349,98.2
서울특별시,동작구,75~79세,2017,11534,5307,6227,85.2,11447,5291,6156,85.9
서울특별시,동작구,75세,2017,3106,1507,1599,94.2,3089,1506,1583,95.1
서울특별시,동작구,76세,2017,2425,1121,1304,86,2404,1117,1287,86.8
서울특별시,동작구,77세,2017,2188,999,1189,84,2173,998,1175,84.9
서울특별시,동작구,78세,2017,2057,913,1144,79.8,2040,907,1133,80.1
서울특별시,동작구,79세,2017,1758,767,991,77.4,1741,763,978,78
서울특별시,동작구,80~84세,2017,6170,2452,3718,65.9,6107,2440,3667,66.5
서울특별시,동작구,80세,2017,1592,652,940,69.4,1576,648,928,69.8
서울특별시,동작구,81세,2017,1392,560,832,67.3,1370,555,815,68.1
서울특별시,동작구,82세,2017,1252,496,756,65.6,1239,493,746,66.1
서울특별시,동작구,83세,2017,1073,422,651,64.8,1067,422,645,65.4
서울특별시,동작구,84세,2017,861,322,539,59.7,855,322,533,60.4
서울특별시,동작구,85세이상,2017,3713,1109,2604,42.6,3683,1099,2584,42.5
서울특별시,동작구,85~89세,2017,2626,838,1788,46.9,2606,830,1776,46.7
서울특별시,동작구,85세,2017,731,225,506,44.5,727,224,503,44.5
서울특별시,동작구,86세,2017,551,192,359,53.5,547,191,356,53.7
서울특별시,동작구,87세,2017,515,161,354,45.5,508,159,349,45.6
서울특별시,동작구,88세,2017,461,159,302,52.6,458,157,301,52.2
서울특별시,동작구,89세,2017,368,101,267,37.8,366,99,267,37.1
서울특별시,동작구,90~94세,2017,854,218,636,34.3,849,218,631,34.5
서울특별시,동작구,90세,2017,275,64,211,30.3,272,64,208,30.8
서울특별시,동작구,91세,2017,197,54,143,37.8,197,54,143,37.8
서울특별시,동작구,92세,2017,152,37,115,32.2,151,37,114,32.5
서울특별시,동작구,93세,2017,127,34,93,36.6,127,34,93,36.6
서울특별시,동작구,94세,2017,103,29,74,39.2,102,29,73,39.7
서울특별시,동작구,95~99세,2017,207,48,159,30.2,204,47,157,29.9
서울특별시,동작구,95세,2017,78,18,60,30,78,18,60,30
서울특별시,동작구,96세,2017,49,10,39,25.6,48,10,38,26.3
서울특별시,동작구,97세,2017,40,12,28,42.9,40,12,28,42.9
서울특별시,동작구,98세,2017,23,X,20,15,22,X,19,15.8
서울특별시,동작구,99세,2017,17,5,12,41.7,16,X,12,33.3
서울특별시,동작구,100세이상,2017,26,5,21,23.8,24,X,20,20
서울특별시,동작구,15세미만,2017,42128,21712,20416,106.3,41709,21504,20205,106.4
서울특별시,동작구,15~64세,2017,302898,149216,153682,97.1,288150,142322,145828,97.6
서울특별시,동작구,65세이상,2017,55210,24325,30885,78.8,54368,23973,30395,78.9
서울특별시,동작구,평균연령,2017,41.3,40.4,42.2,,41.3,40.3,42.2,
서울특별시,동작구,중위연령,2017,40.4,39.3,41.5,,40.5,39.3,41.6,
서울특별시,관악구,합계,2017,511222,256857,254365,101,486747,245391,241356,101.7
서울특별시,관악구,0~4세,2017,15506,7897,7609,103.8,14937,7614,7323,104
서울특별시,관악구,0세,2017,3023,1532,1491,102.7,2906,1471,1435,102.5
서울특별시,관악구,1세,2017,3212,1618,1594,101.5,3066,1548,1518,102
서울특별시,관악구,2세,2017,3227,1667,1560,106.9,3117,1615,1502,107.5
서울특별시,관악구,3세,2017,3089,1569,1520,103.2,2987,1514,1473,102.8
서울특별시,관악구,4세,2017,2955,1511,1444,104.6,2861,1466,1395,105.1
서울특별시,관악구,5~9세,2017,14264,7333,6931,105.8,13988,7192,6796,105.8
서울특별시,관악구,5세,2017,3063,1568,1495,104.9,2978,1524,1454,104.8
서울특별시,관악구,6세,2017,3019,1546,1473,105,2973,1522,1451,104.9
서울특별시,관악구,7세,2017,2733,1384,1349,102.6,2681,1355,1326,102.2
서울특별시,관악구,8세,2017,2635,1365,1270,107.5,2586,1342,1244,107.9
서울특별시,관악구,9세,2017,2814,1470,1344,109.4,2770,1449,1321,109.7
서울특별시,관악구,10~14세,2017,13817,7077,6740,105,13671,7008,6663,105.2
서울특별시,관악구,10세,2017,2839,1453,1386,104.8,2808,1438,1370,105
서울특별시,관악구,11세,2017,2678,1398,1280,109.2,2647,1386,1261,109.9
서울특별시,관악구,12세,2017,2625,1299,1326,98,2592,1284,1308,98.2
서울특별시,관악구,13세,2017,2815,1445,1370,105.5,2785,1432,1353,105.8
서울특별시,관악구,14세,2017,2860,1482,1378,107.5,2839,1468,1371,107.1
서울특별시,관악구,15~19세,2017,20537,10500,10037,104.6,20215,10369,9846,105.3
서울특별시,관악구,15세,2017,3071,1594,1477,107.9,3049,1586,1463,108.4
서울특별시,관악구,16세,2017,3437,1702,1735,98.1,3418,1686,1732,97.3
서울특별시,관악구,17세,2017,4002,2045,1957,104.5,3952,2026,1926,105.2
서울특별시,관악구,18세,2017,4305,2210,2095,105.5,4225,2180,2045,106.6
서울특별시,관악구,19세,2017,5722,2949,2773,106.3,5571,2891,2680,107.9
서울특별시,관악구,20~24세,2017,41742,19863,21879,90.8,40008,19280,20728,93
서울특별시,관악구,20세,2017,6177,3009,3168,95,5980,2937,3043,96.5
서울특별시,관악구,21세,2017,6885,3219,3666,87.8,6651,3141,3510,89.5
서울특별시,관악구,22세,2017,7678,3650,4028,90.6,7372,3549,3823,92.8
서울특별시,관악구,23세,2017,9881,4684,5197,90.1,9406,4537,4869,93.2
서울특별시,관악구,24세,2017,11121,5301,5820,91.1,10599,5116,5483,93.3
서울특별시,관악구,25~29세,2017,62595,32518,30077,108.1,59154,31073,28081,110.7
서울특별시,관악구,25세,2017,12817,6298,6519,96.6,12196,6061,6135,98.8
서울특별시,관악구,26세,2017,12922,6645,6277,105.9,12269,6400,5869,109
서울특별시,관악구,27세,2017,12759,6723,6036,111.4,12010,6392,5618,113.8
서울특별시,관악구,28세,2017,12375,6571,5804,113.2,11642,6255,5387,116.1
서울특별시,관악구,29세,2017,11722,6281,5441,115.4,11037,5965,5072,117.6
서울특별시,관악구,30~34세,2017,50792,27640,23152,119.4,47891,26191,21700,120.7
서울특별시,관악구,30세,2017,11116,5963,5153,115.7,10388,5610,4778,117.4
서울특별시,관악구,31세,2017,10579,5825,4754,122.5,9940,5514,4426,124.6
서울특별시,관악구,32세,2017,9749,5341,4408,121.2,9197,5062,4135,122.4
서울특별시,관악구,33세,2017,9661,5193,4468,116.2,9169,4953,4216,117.5
서울특별시,관악구,34세,2017,9687,5318,4369,121.7,9197,5052,4145,121.9
서울특별시,관악구,35~39세,2017,43810,23805,20005,119,41938,22761,19177,118.7
서울특별시,관악구,35세,2017,10054,5411,4643,116.5,9579,5161,4418,116.8
서울특별시,관악구,36세,2017,9370,5203,4167,124.9,9015,5006,4009,124.9
서울특별시,관악구,37세,2017,9102,4903,4199,116.8,8768,4720,4048,116.6
서울특별시,관악구,38세,2017,8087,4444,3643,122,7683,4204,3479,120.8
서울특별시,관악구,39세,2017,7197,3844,3353,114.6,6893,3670,3223,113.9
서울특별시,관악구,40~44세,2017,36460,19793,16667,118.8,34849,18901,15948,118.5
서울특별시,관악구,40세,2017,7129,3829,3300,116,6824,3649,3175,114.9
서울특별시,관악구,41세,2017,7061,3895,3166,123,6760,3735,3025,123.5
서울특별시,관악구,42세,2017,7085,3849,3236,118.9,6803,3688,3115,118.4
서울특별시,관악구,43세,2017,7606,4065,3541,114.8,7263,3884,3379,114.9
서울특별시,관악구,44세,2017,7579,4155,3424,121.3,7199,3945,3254,121.2
서울특별시,관악구,45~49세,2017,38050,19697,18353,107.3,35696,18554,17142,108.2
서울특별시,관악구,45세,2017,7665,4154,3511,118.3,7242,3928,3314,118.5
서울특별시,관악구,46세,2017,8075,4282,3793,112.9,7574,4031,3543,113.8
서울특별시,관악구,47세,2017,7572,3931,3641,108,7096,3704,3392,109.2
서울특별시,관악구,48세,2017,7381,3741,3640,102.8,6919,3525,3394,103.9
서울특별시,관악구,49세,2017,7357,3589,3768,95.2,6865,3366,3499,96.2
서울특별시,관악구,50~54세,2017,35173,17258,17915,96.3,32194,15881,16313,97.4
서울특별시,관악구,50세,2017,6802,3258,3544,91.9,6353,3054,3299,92.6
서울특별시,관악구,51세,2017,6762,3472,3290,105.5,6263,3221,3042,105.9
서울특별시,관악구,52세,2017,7293,3540,3753,94.3,6678,3276,3402,96.3
서울특별시,관악구,53세,2017,6835,3363,3472,96.9,6220,3088,3132,98.6
서울특별시,관악구,54세,2017,7481,3625,3856,94,6680,3242,3438,94.3
서울특별시,관악구,55~59세,2017,38070,17990,20080,89.6,35583,16818,18765,89.6
서울특별시,관악구,55세,2017,7531,3646,3885,93.8,6917,3355,3562,94.2
서울특별시,관악구,56세,2017,7740,3657,4083,89.6,7354,3483,3871,90
서울특별시,관악구,57세,2017,8225,3807,4418,86.2,7656,3545,4111,86.2
서울특별시,관악구,58세,2017,7440,3435,4005,85.8,7005,3227,3778,85.4
서울특별시,관악구,59세,2017,7134,3445,3689,93.4,6651,3208,3443,93.2
서울특별시,관악구,60~64세,2017,32221,14760,17461,84.5,29925,13630,16295,83.6
서울특별시,관악구,60세,2017,6999,3234,3765,85.9,6442,2950,3492,84.5
서울특별시,관악구,61세,2017,6868,3162,3706,85.3,6337,2918,3419,85.3
서울특별시,관악구,62세,2017,7006,3208,3798,84.5,6519,2956,3563,83
서울특별시,관악구,63세,2017,6030,2793,3237,86.3,5608,2580,3028,85.2
서울특별시,관악구,64세,2017,5318,2363,2955,80,5019,2226,2793,79.7
서울특별시,관악구,65~69세,2017,24910,11632,13278,87.6,24020,11208,12812,87.5
서울특별시,관악구,65세,2017,5822,2722,3100,87.8,5573,2601,2972,87.5
서울특별시,관악구,66세,2017,4479,2077,2402,86.5,4251,1962,2289,85.7
서울특별시,관악구,67세,2017,4877,2331,2546,91.6,4720,2253,2467,91.3
서울특별시,관악구,68세,2017,4982,2304,2678,86,4823,2236,2587,86.4
서울특별시,관악구,69세,2017,4750,2198,2552,86.1,4653,2156,2497,86.3
서울특별시,관악구,70~74세,2017,18806,8720,10086,86.5,18544,8624,9920,86.9
서울특별시,관악구,70세,2017,4685,2145,2540,84.4,4614,2117,2497,84.8
서울특별시,관악구,71세,2017,3644,1651,1993,82.8,3577,1622,1955,83
서울특별시,관악구,72세,2017,3497,1637,1860,88,3450,1623,1827,88.8
서울특별시,관악구,73세,2017,3489,1638,1851,88.5,3448,1625,1823,89.1
서울특별시,관악구,74세,2017,3491,1649,1842,89.5,3455,1637,1818,90
서울특별시,관악구,75~79세,2017,14137,6666,7471,89.2,13959,6619,7340,90.2
서울특별시,관악구,75세,2017,3929,1875,2054,91.3,3889,1863,2026,92
서울특별시,관악구,76세,2017,3049,1476,1573,93.8,3015,1468,1547,94.9
서울특별시,관악구,77세,2017,2547,1164,1383,84.2,2519,1159,1360,85.2
서울특별시,관악구,78세,2017,2514,1192,1322,90.2,2473,1182,1291,91.6
서울특별시,관악구,79세,2017,2098,959,1139,84.2,2063,947,1116,84.9
서울특별시,관악구,80~84세,2017,6546,2656,3890,68.3,6453,2632,3821,68.9
서울특별시,관악구,80세,2017,1755,752,1003,75,1731,743,988,75.2
서울특별시,관악구,81세,2017,1496,634,862,73.5,1475,625,850,73.5
서울특별시,관악구,82세,2017,1379,545,834,65.3,1360,543,817,66.5
서울특별시,관악구,83세,2017,1053,409,644,63.5,1038,407,631,64.5
서울특별시,관악구,84세,2017,863,316,547,57.8,849,314,535,58.7
서울특별시,관악구,85세이상,2017,3786,1052,2734,38.5,3722,1036,2686,38.6
서울특별시,관악구,85~89세,2017,2681,819,1862,44,2631,806,1825,44.2
서울특별시,관악구,85세,2017,728,269,459,58.6,717,265,452,58.6
서울특별시,관악구,86세,2017,595,185,410,45.1,583,182,401,45.4
서울특별시,관악구,87세,2017,566,162,404,40.1,554,160,394,40.6
서울특별시,관악구,88세,2017,444,115,329,35,437,114,323,35.3
서울특별시,관악구,89세,2017,348,88,260,33.8,340,85,255,33.3
서울특별시,관악구,90~94세,2017,878,190,688,27.6,865,188,677,27.8
서울특별시,관악구,90세,2017,295,73,222,32.9,292,72,220,32.7
서울특별시,관악구,91세,2017,209,36,173,20.8,206,36,170,21.2
서울특별시,관악구,92세,2017,141,32,109,29.4,139,32,107,29.9
서울특별시,관악구,93세,2017,110,25,85,29.4,106,24,82,29.3
서울특별시,관악구,94세,2017,123,24,99,24.2,122,24,98,24.5
서울특별시,관악구,95~99세,2017,196,39,157,24.8,195,38,157,24.2
서울특별시,관악구,95세,2017,80,16,64,25,80,16,64,25
서울특별시,관악구,96세,2017,48,11,37,29.7,48,11,37,29.7
서울특별시,관악구,97세,2017,32,7,25,28,32,7,25,28
서울특별시,관악구,98세,2017,19,X,16,18.8,18,X,16,12.5
서울특별시,관악구,99세,2017,17,X,15,13.3,17,X,15,13.3
서울특별시,관악구,100세이상,2017,31,X,27,14.8,31,X,27,14.8
서울특별시,관악구,15세미만,2017,43587,22307,21280,104.8,42596,21814,20782,105
서울특별시,관악구,15~64세,2017,399450,203824,195626,104.2,377453,193458,183995,105.1
서울특별시,관악구,65세이상,2017,68185,30726,37459,82,66698,30119,36579,82.3
서울특별시,관악구,평균연령,2017,41.2,40.3,42,,41.1,40.2,42,
서울특별시,관악구,중위연령,2017,39,38,40.2,,38.8,37.8,40.1,
서울특별시,서초구,합계,2017,414550,198241,216309,91.6,408012,195073,212939,91.6
서울특별시,서초구,0~4세,2017,16876,8616,8260,104.3,16698,8524,8174,104.3
서울특별시,서초구,0세,2017,2935,1493,1442,103.5,2900,1478,1422,103.9
서울특별시,서초구,1세,2017,3221,1606,1615,99.4,3190,1598,1592,100.4
서울특별시,서초구,2세,2017,3392,1731,1661,104.2,3353,1704,1649,103.3
서울특별시,서초구,3세,2017,3548,1847,1701,108.6,3512,1828,1684,108.6
서울특별시,서초구,4세,2017,3780,1939,1841,105.3,3743,1916,1827,104.9
서울특별시,서초구,5~9세,2017,20537,10510,10027,104.8,20364,10420,9944,104.8
서울특별시,서초구,5세,2017,4059,2102,1957,107.4,4016,2077,1939,107.1
서울특별시,서초구,6세,2017,4252,2211,2041,108.3,4216,2193,2023,108.4
서울특별시,서초구,7세,2017,4084,2073,2011,103.1,4060,2060,2000,103
서울특별시,서초구,8세,2017,3954,2005,1949,102.9,3912,1984,1928,102.9
서울특별시,서초구,9세,2017,4188,2119,2069,102.4,4160,2106,2054,102.5
서울특별시,서초구,10~14세,2017,20713,10569,10144,104.2,20582,10497,10085,104.1
서울특별시,서초구,10세,2017,4233,2127,2106,101,4200,2109,2091,100.9
서울특별시,서초구,11세,2017,3860,1994,1866,106.9,3832,1982,1850,107.1
서울특별시,서초구,12세,2017,3958,2074,1884,110.1,3939,2062,1877,109.9
서울특별시,서초구,13세,2017,4469,2263,2206,102.6,4439,2245,2194,102.3
서울특별시,서초구,14세,2017,4193,2111,2082,101.4,4172,2099,2073,101.3
서울특별시,서초구,15~19세,2017,22810,11488,11322,101.5,22680,11422,11258,101.5
서울특별시,서초구,15세,2017,4306,2189,2117,103.4,4285,2177,2108,103.3
서울특별시,서초구,16세,2017,4426,2247,2179,103.1,4414,2242,2172,103.2
서울특별시,서초구,17세,2017,4748,2416,2332,103.6,4724,2401,2323,103.4
서울특별시,서초구,18세,2017,4592,2307,2285,101,4574,2295,2279,100.7
서울특별시,서초구,19세,2017,4738,2329,2409,96.7,4683,2307,2376,97.1
서울특별시,서초구,20~24세,2017,24647,11953,12694,94.2,24203,11739,12464,94.2
서울특별시,서초구,20세,2017,4747,2336,2411,96.9,4645,2297,2348,97.8
서울특별시,서초구,21세,2017,4841,2428,2413,100.6,4753,2377,2376,100
서울특별시,서초구,22세,2017,4810,2363,2447,96.6,4749,2326,2423,96
서울특별시,서초구,23세,2017,4976,2409,2567,93.8,4876,2365,2511,94.2
서울특별시,서초구,24세,2017,5273,2417,2856,84.6,5180,2374,2806,84.6
서울특별시,서초구,25~29세,2017,29095,13500,15595,86.6,28354,13146,15208,86.4
서울특별시,서초구,25세,2017,5643,2613,3030,86.2,5530,2559,2971,86.1
서울특별시,서초구,26세,2017,5780,2682,3098,86.6,5657,2626,3031,86.6
서울특별시,서초구,27세,2017,5672,2659,3013,88.3,5542,2587,2955,87.5
서울특별시,서초구,28세,2017,6057,2800,3257,86,5860,2710,3150,86
서울특별시,서초구,29세,2017,5943,2746,3197,85.9,5765,2664,3101,85.9
서울특별시,서초구,30~34세,2017,31651,14576,17075,85.4,30705,14057,16648,84.4
서울특별시,서초구,30세,2017,6004,2679,3325,80.6,5812,2570,3242,79.3
서울특별시,서초구,31세,2017,6119,2819,3300,85.4,5926,2718,3208,84.7
서울특별시,서초구,32세,2017,6104,2803,3301,84.9,5917,2704,3213,84.2
서울특별시,서초구,33세,2017,6371,2982,3389,88,6182,2877,3305,87
서울특별시,서초구,34세,2017,7053,3293,3760,87.6,6868,3188,3680,86.6
서울특별시,서초구,35~39세,2017,36196,16818,19378,86.8,35362,16367,18995,86.2
서울특별시,서초구,35세,2017,7414,3484,3930,88.7,7222,3379,3843,87.9
서울특별시,서초구,36세,2017,7408,3415,3993,85.5,7220,3317,3903,85
서울특별시,서초구,37세,2017,7528,3469,4059,85.5,7388,3385,4003,84.6
서울특별시,서초구,38세,2017,7249,3403,3846,88.5,7080,3307,3773,87.6
서울특별시,서초구,39세,2017,6597,3047,3550,85.8,6452,2979,3473,85.8
서울특별시,서초구,40~44세,2017,36933,17303,19630,88.1,36283,16954,19329,87.7
서울특별시,서초구,40세,2017,7131,3287,3844,85.5,6996,3209,3787,84.7
서울특별시,서초구,41세,2017,6946,3121,3825,81.6,6812,3057,3755,81.4
서울특별시,서초구,42세,2017,7077,3431,3646,94.1,6948,3363,3585,93.8
서울특별시,서초구,43세,2017,7775,3656,4119,88.8,7648,3590,4058,88.5
서울특별시,서초구,44세,2017,8004,3808,4196,90.8,7879,3735,4144,90.1
서울특별시,서초구,45~49세,2017,39656,19427,20229,96,39035,19134,19901,96.1
서울특별시,서초구,45세,2017,8135,3935,4200,93.7,7997,3865,4132,93.5
서울특별시,서초구,46세,2017,8362,4025,4337,92.8,8224,3962,4262,93
서울특별시,서초구,47세,2017,8143,4014,4129,97.2,7999,3937,4062,96.9
서울특별시,서초구,48세,2017,7779,3890,3889,100,7674,3848,3826,100.6
서울특별시,서초구,49세,2017,7237,3563,3674,97,7141,3522,3619,97.3
서울특별시,서초구,50~54세,2017,30772,15051,15721,95.7,30214,14819,15395,96.3
서울특별시,서초구,50세,2017,6638,3223,3415,94.4,6511,3161,3350,94.4
서울특별시,서초구,51세,2017,5742,2868,2874,99.8,5648,2831,2817,100.5
서울특별시,서초구,52세,2017,6313,3106,3207,96.9,6206,3069,3137,97.8
서울특별시,서초구,53세,2017,6007,2912,3095,94.1,5898,2862,3036,94.3
서울특별시,서초구,54세,2017,6072,2942,3130,94,5951,2896,3055,94.8
서울특별시,서초구,55~59세,2017,29565,14018,15547,90.2,29112,13838,15274,90.6
서울특별시,서초구,55세,2017,5845,2842,3003,94.6,5733,2790,2943,94.8
서울특별시,서초구,56세,2017,6062,2873,3189,90.1,5982,2843,3139,90.6
서울특별시,서초구,57세,2017,6140,2899,3241,89.4,6050,2862,3188,89.8
서울특별시,서초구,58세,2017,5791,2654,3137,84.6,5711,2622,3089,84.9
서울특별시,서초구,59세,2017,5727,2750,2977,92.4,5636,2721,2915,93.3
서울특별시,서초구,60~64세,2017,25177,11572,13605,85.1,24822,11445,13377,85.6
서울특별시,서초구,60세,2017,5664,2607,3057,85.3,5566,2575,2991,86.1
서울특별시,서초구,61세,2017,5151,2421,2730,88.7,5073,2388,2685,88.9
서울특별시,서초구,62세,2017,5487,2484,3003,82.7,5410,2455,2955,83.1
서울특별시,서초구,63세,2017,4577,2128,2449,86.9,4521,2109,2412,87.4
서울특별시,서초구,64세,2017,4298,1932,2366,81.7,4252,1918,2334,82.2
서울특별시,서초구,65~69세,2017,18241,8474,9767,86.8,18074,8404,9670,86.9
서울특별시,서초구,65세,2017,4334,1974,2360,83.6,4280,1954,2326,84
서울특별시,서초구,66세,2017,3138,1500,1638,91.6,3103,1484,1619,91.7
서울특별시,서초구,67세,2017,3552,1652,1900,86.9,3516,1636,1880,87
서울특별시,서초구,68세,2017,3638,1659,1979,83.8,3616,1648,1968,83.7
서울특별시,서초구,69세,2017,3579,1689,1890,89.4,3559,1682,1877,89.6
서울특별시,서초구,70~74세,2017,13748,6614,7134,92.7,13686,6592,7094,92.9
서울특별시,서초구,70세,2017,3447,1605,1842,87.1,3432,1601,1831,87.4
서울특별시,서초구,71세,2017,2905,1375,1530,89.9,2890,1369,1521,90
서울특별시,서초구,72세,2017,2561,1234,1327,93,2548,1228,1320,93
서울특별시,서초구,73세,2017,2456,1212,1244,97.4,2443,1208,1235,97.8
서울특별시,서초구,74세,2017,2379,1188,1191,99.7,2373,1186,1187,99.9
서울특별시,서초구,75~79세,2017,9179,4543,4636,98,9133,4524,4609,98.2
서울특별시,서초구,75세,2017,2437,1262,1175,107.4,2429,1259,1170,107.6
서울특별시,서초구,76세,2017,2009,993,1016,97.7,1995,987,1008,97.9
서울특별시,서초구,77세,2017,1750,847,903,93.8,1740,840,900,93.3
서울특별시,서초구,78세,2017,1584,769,815,94.4,1576,767,809,94.8
서울특별시,서초구,79세,2017,1399,672,727,92.4,1393,671,722,92.9
서울특별시,서초구,80~84세,2017,5085,2114,2971,71.2,5063,2105,2958,71.2
서울특별시,서초구,80세,2017,1322,565,757,74.6,1315,561,754,74.4
서울특별시,서초구,81세,2017,1079,488,591,82.6,1075,487,588,82.8
서울특별시,서초구,82세,2017,1092,463,629,73.6,1086,461,625,73.8
서울특별시,서초구,83세,2017,884,333,551,60.4,881,331,550,60.2
서울특별시,서초구,84세,2017,708,265,443,59.8,706,265,441,60.1
서울특별시,서초구,85세이상,2017,3669,1095,2574,42.5,3642,1086,2556,42.5
서울특별시,서초구,85~89세,2017,2457,787,1670,47.1,2442,783,1659,47.2
서울특별시,서초구,85세,2017,677,265,412,64.3,674,264,410,64.4
서울특별시,서초구,86세,2017,479,159,320,49.7,476,158,318,49.7
서울특별시,서초구,87세,2017,469,128,341,37.5,466,127,339,37.5
서울특별시,서초구,88세,2017,441,142,299,47.5,437,141,296,47.6
서울특별시,서초구,89세,2017,391,93,298,31.2,389,93,296,31.4
서울특별시,서초구,90~94세,2017,976,257,719,35.7,969,254,715,35.5
서울특별시,서초구,90세,2017,319,87,232,37.5,316,85,231,36.8
서울특별시,서초구,91세,2017,198,56,142,39.4,198,56,142,39.4
서울특별시,서초구,92세,2017,182,43,139,30.9,181,42,139,30.2
서울특별시,서초구,93세,2017,144,35,109,32.1,142,35,107,32.7
서울특별시,서초구,94세,2017,133,36,97,37.1,132,36,96,37.5
서울특별시,서초구,95~99세,2017,202,42,160,26.3,197,40,157,25.5
서울특별시,서초구,95세,2017,79,16,63,25.4,78,16,62,25.8
서울특별시,서초구,96세,2017,47,8,39,20.5,47,8,39,20.5
서울특별시,서초구,97세,2017,31,8,23,34.8,29,7,22,31.8
서울특별시,서초구,98세,2017,29,5,24,20.8,27,X,23,17.4
서울특별시,서초구,99세,2017,16,5,11,45.5,16,5,11,45.5
서울특별시,서초구,100세이상,2017,34,9,25,36,34,9,25,36
서울특별시,서초구,15세미만,2017,58126,29695,28431,104.4,57644,29441,28203,104.4
서울특별시,서초구,15~64세,2017,306502,145706,160796,90.6,300770,142921,157849,90.5
서울특별시,서초구,65세이상,2017,49922,22840,27082,84.3,49598,22711,26887,84.5
서울특별시,서초구,평균연령,2017,40.1,39.5,40.6,,40.1,39.5,40.6,
서울특별시,서초구,중위연령,2017,40.7,40.3,41,,40.7,40.4,41,
서울특별시,강남구,합계,2017,522514,250087,272427,91.8,514859,246381,268478,91.8
서울특별시,강남구,0~4세,2017,17657,8990,8667,103.7,17547,8931,8616,103.7
서울특별시,강남구,0세,2017,3243,1645,1598,102.9,3220,1632,1588,102.8
서울특별시,강남구,1세,2017,3399,1709,1690,101.1,3371,1693,1678,100.9
서울특별시,강남구,2세,2017,3505,1792,1713,104.6,3481,1778,1703,104.4
서울특별시,강남구,3세,2017,3660,1893,1767,107.1,3639,1885,1754,107.5
서울특별시,강남구,4세,2017,3850,1951,1899,102.7,3836,1943,1893,102.6
서울특별시,강남구,5~9세,2017,21156,11011,10145,108.5,21073,10963,10110,108.4
서울특별시,강남구,5세,2017,4111,2142,1969,108.8,4088,2126,1962,108.4
서울특별시,강남구,6세,2017,4225,2227,1998,111.5,4209,2217,1992,111.3
서울특별시,강남구,7세,2017,4108,2108,2000,105.4,4100,2105,1995,105.5
서울특별시,강남구,8세,2017,4090,2109,1981,106.5,4071,2100,1971,106.5
서울특별시,강남구,9세,2017,4622,2425,2197,110.4,4605,2415,2190,110.3
서울특별시,강남구,10~14세,2017,25032,13093,11939,109.7,24947,13043,11904,109.6
서울특별시,강남구,10세,2017,4717,2396,2321,103.2,4702,2390,2312,103.4
서울특별시,강남구,11세,2017,4474,2348,2126,110.4,4461,2341,2120,110.4
서울특별시,강남구,12세,2017,4890,2579,2311,111.6,4871,2566,2305,111.3
서울특별시,강남구,13세,2017,5436,2898,2538,114.2,5416,2886,2530,114.1
서울특별시,강남구,14세,2017,5515,2872,2643,108.7,5497,2860,2637,108.5
서울특별시,강남구,15~19세,2017,31983,16774,15209,110.3,31849,16697,15152,110.2
서울특별시,강남구,15세,2017,5561,2957,2604,113.6,5534,2942,2592,113.5
서울특별시,강남구,16세,2017,6296,3268,3028,107.9,6283,3259,3024,107.8
서울특별시,강남구,17세,2017,7058,3728,3330,112,7036,3712,3324,111.7
서울특별시,강남구,18세,2017,6748,3560,3188,111.7,6718,3541,3177,111.5
서울특별시,강남구,19세,2017,6320,3261,3059,106.6,6278,3243,3035,106.9
서울특별시,강남구,20~24세,2017,32035,15890,16145,98.4,31487,15703,15784,99.5
서울특별시,강남구,20세,2017,6040,3042,2998,101.5,5973,3017,2956,102.1
서울특별시,강남구,21세,2017,6126,3183,2943,108.2,6061,3164,2897,109.2
서울특별시,강남구,22세,2017,6282,3170,3112,101.9,6176,3124,3052,102.4
서울특별시,강남구,23세,2017,6622,3223,3399,94.8,6492,3186,3306,96.4
서울특별시,강남구,24세,2017,6965,3272,3693,88.6,6785,3212,3573,89.9
서울특별시,강남구,25~29세,2017,39203,17969,21234,84.6,38008,17423,20585,84.6
서울특별시,강남구,25세,2017,7533,3380,4153,81.4,7343,3299,4044,81.6
서울특별시,강남구,26세,2017,7510,3437,4073,84.4,7298,3348,3950,84.8
서울특별시,강남구,27세,2017,7904,3641,4263,85.4,7658,3535,4123,85.7
서울특별시,강남구,28세,2017,8179,3831,4348,88.1,7920,3707,4213,88
서울특별시,강남구,29세,2017,8077,3680,4397,83.7,7789,3534,4255,83.1
서울특별시,강남구,30~34세,2017,41971,19435,22536,86.2,40628,18680,21948,85.1
서울특별시,강남구,30세,2017,8043,3660,4383,83.5,7758,3515,4243,82.8
서울특별시,강남구,31세,2017,8140,3792,4348,87.2,7857,3630,4227,85.9
서울특별시,강남구,32세,2017,8272,3907,4365,89.5,7996,3738,4258,87.8
서울특별시,강남구,33세,2017,8554,3922,4632,84.7,8293,3775,4518,83.6
서울특별시,강남구,34세,2017,8962,4154,4808,86.4,8724,4022,4702,85.5
서울특별시,강남구,35~39세,2017,45288,21051,24237,86.9,44344,20533,23811,86.2
서울특별시,강남구,35세,2017,9485,4326,5159,83.9,9258,4214,5044,83.5
서울특별시,강남구,36세,2017,9434,4376,5058,86.5,9248,4281,4967,86.2
서울특별시,강남구,37세,2017,9174,4317,4857,88.9,8976,4210,4766,88.3
서울특별시,강남구,38세,2017,9109,4149,4960,83.6,8908,4032,4876,82.7
서울특별시,강남구,39세,2017,8086,3883,4203,92.4,7954,3796,4158,91.3
서울특별시,강남구,40~44세,2017,43898,20100,23798,84.5,43226,19732,23494,84
서울특별시,강남구,40세,2017,8364,3817,4547,83.9,8229,3759,4470,84.1
서울특별시,강남구,41세,2017,8167,3767,4400,85.6,8027,3690,4337,85.1
서울특별시,강남구,42세,2017,8576,3911,4665,83.8,8453,3840,4613,83.2
서울특별시,강남구,43세,2017,9329,4272,5057,84.5,9177,4181,4996,83.7
서울특별시,강남구,44세,2017,9462,4333,5129,84.5,9340,4262,5078,83.9
서울특별시,강남구,45~49세,2017,52081,24902,27179,91.6,51430,24567,26863,91.5
서울특별시,강남구,45세,2017,10077,4652,5425,85.8,9930,4581,5349,85.6
서울특별시,강남구,46세,2017,10830,5172,5658,91.4,10693,5095,5598,91
서울특별시,강남구,47세,2017,10743,5095,5648,90.2,10607,5025,5582,90
서울특별시,강남구,48세,2017,10576,5151,5425,94.9,10445,5084,5361,94.8
서울특별시,강남구,49세,2017,9855,4832,5023,96.2,9755,4782,4973,96.2
서울특별시,강남구,50~54세,2017,41390,20511,20879,98.2,40837,20282,20555,98.7
서울특별시,강남구,50세,2017,8907,4290,4617,92.9,8794,4237,4557,93
서울특별시,강남구,51세,2017,8005,4109,3896,105.5,7894,4066,3828,106.2
서울특별시,강남구,52세,2017,8502,4245,4257,99.7,8395,4197,4198,100
서울특별시,강남구,53세,2017,7911,3899,4012,97.2,7815,3860,3955,97.6
서울특별시,강남구,54세,2017,8065,3968,4097,96.9,7939,3922,4017,97.6
서울특별시,강남구,55~59세,2017,37315,17772,19543,90.9,36801,17569,19232,91.4
서울특별시,강남구,55세,2017,7455,3739,3716,100.6,7339,3680,3659,100.6
서울특별시,강남구,56세,2017,7837,3714,4123,90.1,7746,3678,4068,90.4
서울특별시,강남구,57세,2017,7811,3665,4146,88.4,7691,3624,4067,89.1
서울특별시,강남구,58세,2017,7143,3369,3774,89.3,7049,3338,3711,89.9
서울특별시,강남구,59세,2017,7069,3285,3784,86.8,6976,3249,3727,87.2
서울특별시,강남구,60~64세,2017,31799,14496,17303,83.8,31386,14348,17038,84.2
서울특별시,강남구,60세,2017,7099,3316,3783,87.7,6992,3276,3716,88.2
서울특별시,강남구,61세,2017,6559,3026,3533,85.6,6465,2993,3472,86.2
서울특별시,강남구,62세,2017,6880,3039,3841,79.1,6802,3010,3792,79.4
서울특별시,강남구,63세,2017,5841,2682,3159,84.9,5760,2661,3099,85.9
서울특별시,강남구,64세,2017,5420,2433,2987,81.5,5367,2408,2959,81.4
서울특별시,강남구,65~69세,2017,23045,10828,12217,88.6,22851,10749,12102,88.8
서울특별시,강남구,65세,2017,5656,2600,3056,85.1,5589,2571,3018,85.2
서울특별시,강남구,66세,2017,3859,1835,2024,90.7,3821,1820,2001,91
서울특별시,강남구,67세,2017,4486,2072,2414,85.8,4459,2058,2401,85.7
서울특별시,강남구,68세,2017,4578,2167,2411,89.9,4541,2157,2384,90.5
서울특별시,강남구,69세,2017,4466,2154,2312,93.2,4441,2143,2298,93.3
서울특별시,강남구,70~74세,2017,16823,8121,8702,93.3,16739,8084,8655,93.4
서울특별시,강남구,70세,2017,4305,1958,2347,83.4,4276,1945,2331,83.4
서울특별시,강남구,71세,2017,3543,1707,1836,93,3527,1698,1829,92.8
서울특별시,강남구,72세,2017,3134,1558,1576,98.9,3116,1548,1568,98.7
서울특별시,강남구,73세,2017,3024,1511,1513,99.9,3012,1507,1505,100.1
서울특별시,강남구,74세,2017,2817,1387,1430,97,2808,1386,1422,97.5
서울특별시,강남구,75~79세,2017,11151,5397,5754,93.8,11085,5363,5722,93.7
서울특별시,강남구,75세,2017,2968,1513,1455,104,2950,1506,1444,104.3
서울특별시,강남구,76세,2017,2450,1171,1279,91.6,2438,1166,1272,91.7
서울특별시,강남구,77세,2017,2133,1019,1114,91.5,2124,1013,1111,91.2
서울특별시,강남구,78세,2017,1892,922,970,95.1,1875,911,964,94.5
서울특별시,강남구,79세,2017,1708,772,936,82.5,1698,767,931,82.4
서울특별시,강남구,80~84세,2017,6057,2444,3613,67.6,6018,2427,3591,67.6
서울특별시,강남구,80세,2017,1570,719,851,84.5,1559,714,845,84.5
서울특별시,강남구,81세,2017,1320,573,747,76.7,1313,570,743,76.7
서울특별시,강남구,82세,2017,1241,482,759,63.5,1233,476,757,62.9
서울특별시,강남구,83세,2017,1050,383,667,57.4,1044,381,663,57.5
서울특별시,강남구,84세,2017,876,287,589,48.7,869,286,583,49.1
서울특별시,강남구,85세이상,2017,4630,1303,3327,39.2,4603,1287,3316,38.8
서울특별시,강남구,85~89세,2017,3083,918,2165,42.4,3066,905,2161,41.9
서울특별시,강남구,85세,2017,848,298,550,54.2,844,295,549,53.7
서울특별시,강남구,86세,2017,638,186,452,41.2,636,185,451,41
서울특별시,강남구,87세,2017,606,156,450,34.7,602,153,449,34.1
서울특별시,강남구,88세,2017,558,161,397,40.6,555,159,396,40.2
서울특별시,강남구,89세,2017,433,117,316,37,429,113,316,35.8
서울특별시,강남구,90~94세,2017,1209,302,907,33.3,1204,300,904,33.2
서울특별시,강남구,90세,2017,377,91,286,31.8,376,91,285,31.9
서울특별시,강남구,91세,2017,257,59,198,29.8,256,58,198,29.3
서울특별시,강남구,92세,2017,251,75,176,42.6,249,75,174,43.1
서울특별시,강남구,93세,2017,173,39,134,29.1,172,38,134,28.4
서울특별시,강남구,94세,2017,151,38,113,33.6,151,38,113,33.6
서울특별시,강남구,95~99세,2017,301,75,226,33.2,298,74,224,33
서울특별시,강남구,95세,2017,102,24,78,30.8,100,23,77,29.9
서울특별시,강남구,96세,2017,78,26,52,50,78,26,52,50
서울특별시,강남구,97세,2017,72,17,55,30.9,72,17,55,30.9
서울특별시,강남구,98세,2017,25,5,20,25,25,5,20,25
서울특별시,강남구,99세,2017,24,X,21,14.3,23,X,20,15
서울특별시,강남구,100세이상,2017,37,8,29,27.6,35,8,27,29.6
서울특별시,강남구,15세미만,2017,63845,33094,30751,107.6,63567,32937,30630,107.5
서울특별시,강남구,15~64세,2017,396963,188900,208063,90.8,389996,185534,204462,90.7
서울특별시,강남구,65세이상,2017,61706,28093,33613,83.6,61296,27910,33386,83.6
서울특별시,강남구,평균연령,2017,40.4,39.7,41.1,,40.5,39.7,41.1,
서울특별시,강남구,중위연령,2017,40.8,40.2,41.4,,40.9,40.3,41.4,
서울특별시,송파구,합계,2017,633953,307723,326230,94.3,624535,303247,321288,94.4
서울특별시,송파구,0~4세,2017,25911,13451,12460,108,25714,13347,12367,107.9
서울특별시,송파구,0세,2017,4874,2538,2336,108.6,4837,2520,2317,108.8
서울특별시,송파구,1세,2017,5391,2851,2540,112.2,5345,2822,2523,111.9
서울특별시,송파구,2세,2017,5401,2818,2583,109.1,5355,2795,2560,109.2
서울특별시,송파구,3세,2017,5103,2609,2494,104.6,5067,2594,2473,104.9
서울특별시,송파구,4세,2017,5142,2635,2507,105.1,5110,2616,2494,104.9
서울특별시,송파구,5~9세,2017,27314,14010,13304,105.3,27176,13946,13230,105.4
서울특별시,송파구,5세,2017,5719,2899,2820,102.8,5682,2878,2804,102.6
서울특별시,송파구,6세,2017,5434,2831,2603,108.8,5403,2814,2589,108.7
서울특별시,송파구,7세,2017,5464,2793,2671,104.6,5435,2784,2651,105
서울특별시,송파구,8세,2017,5202,2645,2557,103.4,5183,2638,2545,103.7
서울특별시,송파구,9세,2017,5495,2842,2653,107.1,5473,2832,2641,107.2
서울특별시,송파구,10~14세,2017,27706,14228,13478,105.6,27651,14198,13453,105.5
서울특별시,송파구,10세,2017,5575,2882,2693,107,5560,2873,2687,106.9
서울특별시,송파구,11세,2017,5312,2692,2620,102.7,5302,2686,2616,102.7
서울특별시,송파구,12세,2017,5288,2732,2556,106.9,5277,2727,2550,106.9
서울특별시,송파구,13세,2017,5711,2924,2787,104.9,5700,2918,2782,104.9
서울특별시,송파구,14세,2017,5820,2998,2822,106.2,5812,2994,2818,106.2
서울특별시,송파구,15~19세,2017,33486,17148,16338,105,33353,17078,16275,104.9
서울특별시,송파구,15세,2017,5947,3080,2867,107.4,5934,3077,2857,107.7
서울특별시,송파구,16세,2017,6628,3405,3223,105.6,6619,3401,3218,105.7
서울특별시,송파구,17세,2017,7301,3712,3589,103.4,7287,3705,3582,103.4
서울특별시,송파구,18세,2017,6867,3536,3331,106.2,6841,3517,3324,105.8
서울특별시,송파구,19세,2017,6743,3415,3328,102.6,6672,3378,3294,102.6
서울특별시,송파구,20~24세,2017,39619,19918,19701,101.1,39152,19720,19432,101.5
서울특별시,송파구,20세,2017,7247,3782,3465,109.1,7174,3744,3430,109.2
서울특별시,송파구,21세,2017,7533,3964,3569,111.1,7471,3933,3538,111.2
서울특별시,송파구,22세,2017,7871,4084,3787,107.8,7800,4056,3744,108.3
서울특별시,송파구,23세,2017,8359,4055,4304,94.2,8217,3994,4223,94.6
서울특별시,송파구,24세,2017,8609,4033,4576,88.1,8490,3993,4497,88.8
서울특별시,송파구,25~29세,2017,47355,22427,24928,90,46295,21927,24368,90
서울특별시,송파구,25세,2017,9266,4319,4947,87.3,9119,4255,4864,87.5
서울특별시,송파구,26세,2017,9262,4377,4885,89.6,9071,4280,4791,89.3
서울특별시,송파구,27세,2017,9505,4499,5006,89.9,9272,4391,4881,90
서울특별시,송파구,28세,2017,9528,4559,4969,91.7,9299,4456,4843,92
서울특별시,송파구,29세,2017,9794,4673,5121,91.3,9534,4545,4989,91.1
서울특별시,송파구,30~34세,2017,52977,25358,27619,91.8,51666,24691,26975,91.5
서울특별시,송파구,30세,2017,10012,4708,5304,88.8,9725,4564,5161,88.4
서울특별시,송파구,31세,2017,10328,4910,5418,90.6,10049,4770,5279,90.4
서울특별시,송파구,32세,2017,10377,4948,5429,91.1,10115,4818,5297,91
서울특별시,송파구,33세,2017,10621,5214,5407,96.4,10368,5090,5278,96.4
서울특별시,송파구,34세,2017,11639,5578,6061,92,11409,5449,5960,91.4
서울특별시,송파구,35~39세,2017,56234,27246,28988,94,55324,26756,28568,93.7
서울특별시,송파구,35세,2017,11934,5860,6074,96.5,11719,5745,5974,96.2
서울특별시,송파구,36세,2017,11907,5852,6055,96.6,11700,5736,5964,96.2
서울특별시,송파구,37세,2017,11729,5616,6113,91.9,11582,5541,6041,91.7
서울특별시,송파구,38세,2017,11046,5212,5834,89.3,10859,5113,5746,89
서울특별시,송파구,39세,2017,9618,4706,4912,95.8,9464,4621,4843,95.4
서울특별시,송파구,40~44세,2017,51053,24841,26212,94.8,50317,24457,25860,94.6
서울특별시,송파구,40세,2017,9949,4827,5122,94.2,9814,4757,5057,94.1
서울특별시,송파구,41세,2017,9652,4859,4793,101.4,9511,4778,4733,101
서울특별시,송파구,42세,2017,10016,4826,5190,93,9883,4764,5119,93.1
서울특별시,송파구,43세,2017,10690,5229,5461,95.8,10519,5142,5377,95.6
서울특별시,송파구,44세,2017,10746,5100,5646,90.3,10590,5016,5574,90
서울특별시,송파구,45~49세,2017,56199,27146,29053,93.4,55202,26676,28526,93.5
서울특별시,송파구,45세,2017,11160,5406,5754,94,10965,5296,5669,93.4
서울특별시,송파구,46세,2017,11872,5707,6165,92.6,11691,5617,6074,92.5
서울특별시,송파구,47세,2017,11093,5473,5620,97.4,10901,5377,5524,97.3
서울특별시,송파구,48세,2017,11268,5452,5816,93.7,11076,5368,5708,94
서울특별시,송파구,49세,2017,10806,5108,5698,89.6,10569,5018,5551,90.4
서울특별시,송파구,50~54세,2017,49206,23884,25322,94.3,48105,23378,24727,94.5
서울특별시,송파구,50세,2017,9872,4802,5070,94.7,9695,4715,4980,94.7
서울특별시,송파구,51세,2017,9589,4763,4826,98.7,9371,4671,4700,99.4
서울특별시,송파구,52세,2017,10003,4796,5207,92.1,9776,4684,5092,92
서울특별시,송파구,53세,2017,9629,4657,4972,93.7,9409,4559,4850,94
서울특별시,송파구,54세,2017,10113,4866,5247,92.7,9854,4749,5105,93
서울특별시,송파구,55~59세,2017,51300,24198,27102,89.3,50417,23833,26584,89.7
서울특별시,송파구,55세,2017,9981,4806,5175,92.9,9782,4722,5060,93.3
서울특별시,송파구,56세,2017,10754,5016,5738,87.4,10608,4962,5646,87.9
서울특별시,송파구,57세,2017,10894,4998,5896,84.8,10678,4911,5767,85.2
서울특별시,송파구,58세,2017,10014,4788,5226,91.6,9850,4719,5131,92
서울특별시,송파구,59세,2017,9657,4590,5067,90.6,9499,4519,4980,90.7
서울특별시,송파구,60~64세,2017,42261,19954,22307,89.5,41458,19574,21884,89.4
서울특별시,송파구,60세,2017,9648,4525,5123,88.3,9454,4420,5034,87.8
서울특별시,송파구,61세,2017,8653,4074,4579,89,8469,3997,4472,89.4
서울특별시,송파구,62세,2017,9345,4380,4965,88.2,9171,4301,4870,88.3
서울특별시,송파구,63세,2017,7672,3653,4019,90.9,7534,3589,3945,91
서울특별시,송파구,64세,2017,6943,3322,3621,91.7,6830,3267,3563,91.7
서울특별시,송파구,65~69세,2017,28422,14125,14297,98.8,28064,13967,14097,99.1
서울특별시,송파구,65세,2017,7295,3633,3662,99.2,7208,3589,3619,99.2
서울특별시,송파구,66세,2017,5063,2501,2562,97.6,4979,2466,2513,98.1
서울특별시,송파구,67세,2017,5490,2744,2746,99.9,5422,2706,2716,99.6
서울특별시,송파구,68세,2017,5487,2724,2763,98.6,5417,2697,2720,99.2
서울특별시,송파구,69세,2017,5087,2523,2564,98.4,5038,2509,2529,99.2
서울특별시,송파구,70~74세,2017,19301,9577,9724,98.5,19171,9527,9644,98.8
서울특별시,송파구,70세,2017,5231,2608,2623,99.4,5188,2594,2594,100
서울특별시,송파구,71세,2017,3875,1913,1962,97.5,3841,1900,1941,97.9
서울특별시,송파구,72세,2017,3552,1775,1777,99.9,3525,1765,1760,100.3
서울특별시,송파구,73세,2017,3403,1686,1717,98.2,3392,1680,1712,98.1
서울특별시,송파구,74세,2017,3240,1595,1645,97,3225,1588,1637,97
서울특별시,송파구,75~79세,2017,12918,6001,6917,86.8,12837,5976,6861,87.1
서울특별시,송파구,75세,2017,3564,1719,1845,93.2,3540,1710,1830,93.4
서울특별시,송파구,76세,2017,2757,1291,1466,88.1,2739,1286,1453,88.5
서울특별시,송파구,77세,2017,2397,1123,1274,88.1,2380,1117,1263,88.4
서울특별시,송파구,78세,2017,2244,1015,1229,82.6,2238,1014,1224,82.8
서울특별시,송파구,79세,2017,1956,853,1103,77.3,1940,849,1091,77.8
서울특별시,송파구,80~84세,2017,7405,2804,4601,60.9,7363,2794,4569,61.2
서울특별시,송파구,80세,2017,1852,785,1067,73.6,1845,784,1061,73.9
서울특별시,송파구,81세,2017,1617,625,992,63,1605,621,984,63.1
서울특별시,송파구,82세,2017,1526,580,946,61.3,1521,578,943,61.3
서울특별시,송파구,83세,2017,1264,473,791,59.8,1256,473,783,60.4
서울특별시,송파구,84세,2017,1146,341,805,42.4,1136,338,798,42.4
서울특별시,송파구,85세이상,2017,5286,1407,3879,36.3,5270,1402,3868,36.2
서울특별시,송파구,85~89세,2017,3641,1034,2607,39.7,3629,1030,2599,39.6
서울특별시,송파구,85세,2017,1008,311,697,44.6,1005,311,694,44.8
서울특별시,송파구,86세,2017,773,237,536,44.2,770,235,535,43.9
서울특별시,송파구,87세,2017,687,180,507,35.5,684,179,505,35.4
서울특별시,송파구,88세,2017,647,163,484,33.7,645,162,483,33.5
서울특별시,송파구,89세,2017,526,143,383,37.3,525,143,382,37.4
서울특별시,송파구,90~94세,2017,1331,303,1028,29.5,1328,302,1026,29.4
서울특별시,송파구,90세,2017,425,98,327,30,424,97,327,29.7
서울특별시,송파구,91세,2017,308,63,245,25.7,308,63,245,25.7
서울특별시,송파구,92세,2017,252,55,197,27.9,251,55,196,28.1
서울특별시,송파구,93세,2017,173,48,125,38.4,173,48,125,38.4
서울특별시,송파구,94세,2017,173,39,134,29.1,172,39,133,29.3
서울특별시,송파구,95~99세,2017,279,64,215,29.8,278,64,214,29.9
서울특별시,송파구,95세,2017,101,22,79,27.8,101,22,79,27.8
서울특별시,송파구,96세,2017,76,20,56,35.7,76,20,56,35.7
서울특별시,송파구,97세,2017,52,10,42,23.8,51,10,41,24.4
서울특별시,송파구,98세,2017,32,10,22,45.5,32,10,22,45.5
서울특별시,송파구,99세,2017,18,X,16,12.5,18,X,16,12.5
서울특별시,송파구,100세이상,2017,35,6,29,20.7,35,6,29,20.7
서울특별시,송파구,15세미만,2017,80931,41689,39242,106.2,80541,41491,39050,106.3
서울특별시,송파구,15~64세,2017,479690,232120,247570,93.8,471289,228090,243199,93.8
서울특별시,송파구,65세이상,2017,73332,33914,39418,86,72705,33666,39039,86.2
서울특별시,송파구,평균연령,2017,40.4,39.7,41.1,,40.4,39.7,41,
서울특별시,송파구,중위연령,2017,40.6,40,41.2,,40.6,40,41.2,
서울특별시,강동구,합계,2017,423978,209931,214047,98.1,418091,207140,210951,98.2
서울특별시,강동구,0~4세,2017,16226,8295,7931,104.6,16117,8245,7872,104.7
서울특별시,강동구,0세,2017,2977,1516,1461,103.8,2952,1505,1447,104
서울특별시,강동구,1세,2017,3282,1705,1577,108.1,3257,1694,1563,108.4
서울특별시,강동구,2세,2017,3352,1717,1635,105,3330,1705,1625,104.9
서울특별시,강동구,3세,2017,3438,1743,1695,102.8,3415,1735,1680,103.3
서울특별시,강동구,4세,2017,3177,1614,1563,103.3,3163,1606,1557,103.1
서울특별시,강동구,5~9세,2017,17204,8987,8217,109.4,17133,8953,8180,109.4
서울특별시,강동구,5세,2017,3574,1854,1720,107.8,3557,1846,1711,107.9
서울특별시,강동구,6세,2017,3393,1767,1626,108.7,3377,1759,1618,108.7
서울특별시,강동구,7세,2017,3485,1843,1642,112.2,3465,1834,1631,112.4
서울특별시,강동구,8세,2017,3230,1636,1594,102.6,3222,1631,1591,102.5
서울특별시,강동구,9세,2017,3522,1887,1635,115.4,3512,1883,1629,115.6
서울특별시,강동구,10~14세,2017,17339,9143,8196,111.6,17308,9130,8178,111.6
서울특별시,강동구,10세,2017,3588,1922,1666,115.4,3581,1920,1661,115.6
서울특별시,강동구,11세,2017,3278,1730,1548,111.8,3273,1727,1546,111.7
서울특별시,강동구,12세,2017,3129,1659,1470,112.9,3119,1654,1465,112.9
서울특별시,강동구,13세,2017,3630,1895,1735,109.2,3623,1892,1731,109.3
서울특별시,강동구,14세,2017,3714,1937,1777,109,3712,1937,1775,109.1
서울특별시,강동구,15~19세,2017,21942,11603,10339,112.2,21886,11576,10310,112.3
서울특별시,강동구,15세,2017,3840,2091,1749,119.6,3834,2089,1745,119.7
서울특별시,강동구,16세,2017,4326,2342,1984,118,4319,2339,1980,118.1
서울특별시,강동구,17세,2017,4774,2505,2269,110.4,4765,2501,2264,110.5
서울특별시,강동구,18세,2017,4635,2432,2203,110.4,4619,2421,2198,110.1
서울특별시,강동구,19세,2017,4367,2233,2134,104.6,4349,2226,2123,104.9
서울특별시,강동구,20~24세,2017,26236,13723,12513,109.7,25985,13607,12378,109.9
서울특별시,강동구,20세,2017,4671,2537,2134,118.9,4644,2527,2117,119.4
서울특별시,강동구,21세,2017,5061,2741,2320,118.1,5026,2725,2301,118.4
서울특별시,강동구,22세,2017,5328,2862,2466,116.1,5271,2835,2436,116.4
서울특별시,강동구,23세,2017,5392,2712,2680,101.2,5339,2687,2652,101.3
서울특별시,강동구,24세,2017,5784,2871,2913,98.6,5705,2833,2872,98.6
서울특별시,강동구,25~29세,2017,30251,15194,15057,100.9,29638,14904,14734,101.2
서울특별시,강동구,25세,2017,6184,3078,3106,99.1,6071,3024,3047,99.2
서울특별시,강동구,26세,2017,6019,3014,3005,100.3,5905,2957,2948,100.3
서울특별시,강동구,27세,2017,6013,3027,2986,101.4,5888,2977,2911,102.3
서울특별시,강동구,28세,2017,5943,2995,2948,101.6,5823,2936,2887,101.7
서울특별시,강동구,29세,2017,6092,3080,3012,102.3,5951,3010,2941,102.3
서울특별시,강동구,30~34세,2017,32098,16139,15959,101.1,31382,15785,15597,101.2
서울특별시,강동구,30세,2017,6036,2980,3056,97.5,5872,2897,2975,97.4
서울특별시,강동구,31세,2017,6098,3061,3037,100.8,5924,2970,2954,100.5
서울특별시,강동구,32세,2017,6341,3186,3155,101,6195,3115,3080,101.1
서울특별시,강동구,33세,2017,6622,3394,3228,105.1,6498,3331,3167,105.2
서울특별시,강동구,34세,2017,7001,3518,3483,101,6893,3472,3421,101.5
서울특별시,강동구,35~39세,2017,36089,18243,17846,102.2,35538,17968,17570,102.3
서울특별시,강동구,35세,2017,7515,3795,3720,102,7387,3735,3652,102.3
서울특별시,강동구,36세,2017,7536,3822,3714,102.9,7432,3770,3662,102.9
서울특별시,강동구,37세,2017,7515,3853,3662,105.2,7408,3798,3610,105.2
서울특별시,강동구,38세,2017,7164,3578,3586,99.8,7055,3523,3532,99.7
서울특별시,강동구,39세,2017,6359,3195,3164,101,6256,3142,3114,100.9
서울특별시,강동구,40~44세,2017,32763,16455,16308,100.9,32284,16217,16067,100.9
서울특별시,강동구,40세,2017,6430,3225,3205,100.6,6335,3176,3159,100.5
서울특별시,강동구,41세,2017,6207,3187,3020,105.5,6105,3140,2965,105.9
서울특별시,강동구,42세,2017,6325,3170,3155,100.5,6247,3133,3114,100.6
서울특별시,강동구,43세,2017,6790,3404,3386,100.5,6697,3360,3337,100.7
서울특별시,강동구,44세,2017,7011,3469,3542,97.9,6900,3408,3492,97.6
서울특별시,강동구,45~49세,2017,36613,18103,18510,97.8,35966,17789,18177,97.9
서울특별시,강동구,45세,2017,7138,3576,3562,100.4,7016,3512,3504,100.2
서울특별시,강동구,46세,2017,7416,3734,3682,101.4,7284,3670,3614,101.5
서울특별시,강동구,47세,2017,7298,3572,3726,95.9,7173,3514,3659,96
서울특별시,강동구,48세,2017,7318,3560,3758,94.7,7184,3495,3689,94.7
서울특별시,강동구,49세,2017,7443,3661,3782,96.8,7309,3598,3711,97
서울특별시,강동구,50~54세,2017,33842,16370,17472,93.7,33132,16051,17081,94
서울특별시,강동구,50세,2017,6639,3171,3468,91.4,6530,3125,3405,91.8
서울특별시,강동구,51세,2017,6529,3276,3253,100.7,6406,3226,3180,101.4
서울특별시,강동구,52세,2017,6809,3227,3582,90.1,6663,3153,3510,89.8
서울특별시,강동구,53세,2017,6805,3265,3540,92.2,6654,3198,3456,92.5
서울특별시,강동구,54세,2017,7060,3431,3629,94.5,6879,3349,3530,94.9
서울특별시,강동구,55~59세,2017,37956,18026,19930,90.4,37302,17741,19561,90.7
서울특별시,강동구,55세,2017,7435,3651,3784,96.5,7300,3588,3712,96.7
서울특별시,강동구,56세,2017,7906,3703,4203,88.1,7810,3671,4139,88.7
서울특별시,강동구,57세,2017,8086,3760,4326,86.9,7941,3693,4248,86.9
서울특별시,강동구,58세,2017,7440,3496,3944,88.6,7305,3436,3869,88.8
서울특별시,강동구,59세,2017,7089,3416,3673,93,6946,3353,3593,93.3
서울특별시,강동구,60~64세,2017,30940,14762,16178,91.2,30352,14463,15889,91
서울특별시,강동구,60세,2017,7027,3402,3625,93.8,6899,3331,3568,93.4
서울특별시,강동구,61세,2017,6592,3077,3515,87.5,6452,3016,3436,87.8
서울특별시,강동구,62세,2017,6702,3157,3545,89.1,6575,3097,3478,89
서울특별시,강동구,63세,2017,5650,2701,2949,91.6,5556,2649,2907,91.1
서울특별시,강동구,64세,2017,4969,2425,2544,95.3,4870,2370,2500,94.8
서울특별시,강동구,65~69세,2017,21057,10420,10637,98,20802,10297,10505,98
서울특별시,강동구,65세,2017,5334,2595,2739,94.7,5254,2556,2698,94.7
서울특별시,강동구,66세,2017,3649,1804,1845,97.8,3583,1766,1817,97.2
서울특별시,강동구,67세,2017,4010,1986,2024,98.1,3964,1965,1999,98.3
서울특별시,강동구,68세,2017,4111,2021,2090,96.7,4078,2009,2069,97.1
서울특별시,강동구,69세,2017,3953,2014,1939,103.9,3923,2001,1922,104.1
서울특별시,강동구,70~74세,2017,14241,7008,7233,96.9,14165,6980,7185,97.1
서울특별시,강동구,70세,2017,3751,1793,1958,91.6,3723,1783,1940,91.9
서울특별시,강동구,71세,2017,2813,1411,1402,100.6,2794,1403,1391,100.9
서울특별시,강동구,72세,2017,2645,1336,1309,102.1,2639,1335,1304,102.4
서울특별시,강동구,73세,2017,2568,1261,1307,96.5,2558,1257,1301,96.6
서울특별시,강동구,74세,2017,2464,1207,1257,96,2451,1202,1249,96.2
서울특별시,강동구,75~79세,2017,9779,4563,5216,87.5,9737,4550,5187,87.7
서울특별시,강동구,75세,2017,2670,1312,1358,96.6,2660,1309,1351,96.9
서울특별시,강동구,76세,2017,2134,1026,1108,92.6,2128,1024,1104,92.8
서울특별시,강동구,77세,2017,1767,817,950,86,1760,816,944,86.4
서울특별시,강동구,78세,2017,1715,758,957,79.2,1707,755,952,79.3
서울특별시,강동구,79세,2017,1493,650,843,77.1,1482,646,836,77.3
서울특별시,강동구,80~84세,2017,5420,1926,3494,55.1,5394,1918,3476,55.2
서울특별시,강동구,80세,2017,1359,525,834,62.9,1351,522,829,63
서울특별시,강동구,81세,2017,1191,461,730,63.2,1189,460,729,63.1
서울특별시,강동구,82세,2017,1156,381,775,49.2,1150,380,770,49.4
서울특별시,강동구,83세,2017,944,305,639,47.7,940,304,636,47.8
서울특별시,강동구,84세,2017,770,254,516,49.2,764,252,512,49.2
서울특별시,강동구,85세이상,2017,3982,971,3011,32.2,3970,966,3004,32.2
서울특별시,강동구,85~89세,2017,2741,718,2023,35.5,2733,715,2018,35.4
서울특별시,강동구,85세,2017,712,205,507,40.4,709,205,504,40.7
서울특별시,강동구,86세,2017,578,159,419,37.9,576,158,418,37.8
서울특별시,강동구,87세,2017,560,145,415,34.9,558,144,414,34.8
서울특별시,강동구,88세,2017,486,123,363,33.9,485,122,363,33.6
서울특별시,강동구,89세,2017,405,86,319,27,405,86,319,27
서울특별시,강동구,90~94세,2017,992,196,796,24.6,989,194,795,24.4
서울특별시,강동구,90세,2017,312,63,249,25.3,312,63,249,25.3
서울특별시,강동구,91세,2017,235,45,190,23.7,235,45,190,23.7
서울특별시,강동구,92세,2017,180,25,155,16.1,178,24,154,15.6
서울특별시,강동구,93세,2017,124,32,92,34.8,124,32,92,34.8
서울특별시,강동구,94세,2017,141,31,110,28.2,140,30,110,27.3
서울특별시,강동구,95~99세,2017,214,51,163,31.3,214,51,163,31.3
서울특별시,강동구,95세,2017,73,18,55,32.7,73,18,55,32.7
서울특별시,강동구,96세,2017,56,17,39,43.6,56,17,39,43.6
서울특별시,강동구,97세,2017,41,9,32,28.1,41,9,32,28.1
서울특별시,강동구,98세,2017,30,5,25,20,30,5,25,20
서울특별시,강동구,99세,2017,14,X,12,16.7,14,X,12,16.7
서울특별시,강동구,100세이상,2017,35,6,29,20.7,34,6,28,21.4
서울특별시,강동구,15세미만,2017,50769,26425,24344,108.5,50558,26328,24230,108.7
서울특별시,강동구,15~64세,2017,318730,158618,160112,99.1,313465,156101,157364,99.2
서울특별시,강동구,65세이상,2017,54479,24888,29591,84.1,54068,24711,29357,84.2
서울특별시,강동구,평균연령,2017,41.6,40.6,42.5,,41.5,40.6,42.5,
서울특별시,강동구,중위연령,2017,42.3,41.1,43.5,,42.3,41.1,43.4,
경기도,수원시장안구,합계,2017,295436,149660,145776,102.7,287001,145193,141808,102.4
경기도,수원시장안구,0~4세,2017,11315,5905,5410,109.1,11055,5765,5290,109
경기도,수원시장안구,0세,2017,1877,986,891,110.7,1811,953,858,111.1
경기도,수원시장안구,1세,2017,2155,1101,1054,104.5,2106,1072,1034,103.7
경기도,수원시장안구,2세,2017,2436,1278,1158,110.4,2390,1253,1137,110.2
경기도,수원시장안구,3세,2017,2379,1246,1133,110,2322,1216,1106,109.9
경기도,수원시장안구,4세,2017,2468,1294,1174,110.2,2426,1271,1155,110
경기도,수원시장안구,5~9세,2017,13540,6948,6592,105.4,13437,6895,6542,105.4
경기도,수원시장안구,5세,2017,2644,1331,1313,101.4,2615,1321,1294,102.1
경기도,수원시장안구,6세,2017,2731,1434,1297,110.6,2714,1425,1289,110.6
경기도,수원시장안구,7세,2017,2591,1332,1259,105.8,2569,1318,1251,105.4
경기도,수원시장안구,8세,2017,2663,1353,1310,103.3,2641,1338,1303,102.7
경기도,수원시장안구,9세,2017,2911,1498,1413,106,2898,1493,1405,106.3
경기도,수원시장안구,10~14세,2017,14385,7395,6990,105.8,14353,7384,6969,106
경기도,수원시장안구,10세,2017,2942,1518,1424,106.6,2935,1515,1420,106.7
경기도,수원시장안구,11세,2017,2708,1386,1322,104.8,2701,1385,1316,105.2
경기도,수원시장안구,12세,2017,2680,1339,1341,99.9,2674,1337,1337,100
경기도,수원시장안구,13세,2017,2927,1549,1378,112.4,2920,1546,1374,112.5
경기도,수원시장안구,14세,2017,3128,1603,1525,105.1,3123,1601,1522,105.2
경기도,수원시장안구,15~19세,2017,19890,10750,9140,117.6,19611,10598,9013,117.6
경기도,수원시장안구,15세,2017,3164,1660,1504,110.4,3152,1655,1497,110.6
경기도,수원시장안구,16세,2017,3851,2121,1730,122.6,3844,2117,1727,122.6
경기도,수원시장안구,17세,2017,4183,2205,1978,111.5,4165,2197,1968,111.6
경기도,수원시장안구,18세,2017,4018,2199,1819,120.9,3939,2159,1780,121.3
경기도,수원시장안구,19세,2017,4674,2565,2109,121.6,4511,2470,2041,121
경기도,수원시장안구,20~24세,2017,25088,14076,11012,127.8,24120,13541,10579,128
경기도,수원시장안구,20세,2017,4866,2727,2139,127.5,4671,2622,2049,128
경기도,수원시장안구,21세,2017,4783,2627,2156,121.8,4631,2534,2097,120.8
경기도,수원시장안구,22세,2017,4959,2828,2131,132.7,4778,2728,2050,133.1
경기도,수원시장안구,23세,2017,5182,2932,2250,130.3,4964,2816,2148,131.1
경기도,수원시장안구,24세,2017,5298,2962,2336,126.8,5076,2841,2235,127.1
경기도,수원시장안구,25~29세,2017,21606,11892,9714,122.4,20424,11236,9188,122.3
경기도,수원시장안구,25세,2017,5106,2837,2269,125,4890,2701,2189,123.4
경기도,수원시장안구,26세,2017,4672,2579,2093,123.2,4449,2457,1992,123.3
경기도,수원시장안구,27세,2017,4307,2390,1917,124.7,4036,2239,1797,124.6
경기도,수원시장안구,28세,2017,3927,2152,1775,121.2,3685,2026,1659,122.1
경기도,수원시장안구,29세,2017,3594,1934,1660,116.5,3364,1813,1551,116.9
경기도,수원시장안구,30~34세,2017,18355,9595,8760,109.5,17309,9020,8289,108.8
경기도,수원시장안구,30세,2017,3554,1928,1626,118.6,3323,1792,1531,117
경기도,수원시장안구,31세,2017,3542,1849,1693,109.2,3293,1716,1577,108.8
경기도,수원시장안구,32세,2017,3591,1904,1687,112.9,3391,1793,1598,112.2
경기도,수원시장안구,33세,2017,3615,1825,1790,102,3427,1729,1698,101.8
경기도,수원시장안구,34세,2017,4053,2089,1964,106.4,3875,1990,1885,105.6
경기도,수원시장안구,35~39세,2017,22293,11188,11105,100.7,21598,10786,10812,99.8
경기도,수원시장안구,35세,2017,4328,2179,2149,101.4,4164,2076,2088,99.4
경기도,수원시장안구,36세,2017,4534,2262,2272,99.6,4398,2187,2211,98.9
경기도,수원시장안구,37세,2017,4587,2323,2264,102.6,4470,2254,2216,101.7
경기도,수원시장안구,38세,2017,4621,2266,2355,96.2,4472,2178,2294,94.9
경기도,수원시장안구,39세,2017,4223,2158,2065,104.5,4094,2091,2003,104.4
경기도,수원시장안구,40~44세,2017,24149,11986,12163,98.5,23593,11673,11920,97.9
경기도,수원시장안구,40세,2017,4471,2213,2258,98,4353,2151,2202,97.7
경기도,수원시장안구,41세,2017,4484,2279,2205,103.4,4378,2217,2161,102.6
경기도,수원시장안구,42세,2017,4675,2333,2342,99.6,4589,2279,2310,98.7
경기도,수원시장안구,43세,2017,5220,2607,2613,99.8,5103,2534,2569,98.6
경기도,수원시장안구,44세,2017,5299,2554,2745,93,5170,2492,2678,93.1
경기도,수원시장안구,45~49세,2017,28573,14041,14532,96.6,27820,13645,14175,96.3
경기도,수원시장안구,45세,2017,5348,2697,2651,101.7,5218,2618,2600,100.7
경기도,수원시장안구,46세,2017,5694,2808,2886,97.3,5551,2742,2809,97.6
경기도,수원시장안구,47세,2017,5703,2869,2834,101.2,5547,2777,2770,100.3
경기도,수원시장안구,48세,2017,5970,2853,3117,91.5,5817,2782,3035,91.7
경기도,수원시장안구,49세,2017,5858,2814,3044,92.4,5687,2726,2961,92.1
경기도,수원시장안구,50~54세,2017,25776,12960,12816,101.1,24908,12530,12378,101.2
경기도,수원시장안구,50세,2017,5405,2608,2797,93.2,5270,2540,2730,93
경기도,수원시장안구,51세,2017,5229,2635,2594,101.6,5074,2562,2512,102
경기도,수원시장안구,52세,2017,5224,2641,2583,102.2,5053,2547,2506,101.6
경기도,수원시장안구,53세,2017,4775,2400,2375,101.1,4593,2310,2283,101.2
경기도,수원시장안구,54세,2017,5143,2676,2467,108.5,4918,2571,2347,109.5
경기도,수원시장안구,55~59세,2017,23452,11876,11576,102.6,22795,11557,11238,102.8
경기도,수원시장안구,55세,2017,4988,2547,2441,104.3,4820,2471,2349,105.2
경기도,수원시장안구,56세,2017,5238,2603,2635,98.8,5150,2559,2591,98.8
경기도,수원시장안구,57세,2017,4961,2517,2444,103,4797,2443,2354,103.8
경기도,수원시장안구,58세,2017,4293,2185,2108,103.7,4176,2127,2049,103.8
경기도,수원시장안구,59세,2017,3972,2024,1948,103.9,3852,1957,1895,103.3
경기도,수원시장안구,60~64세,2017,15208,7548,7660,98.5,14615,7258,7357,98.7
경기도,수원시장안구,60세,2017,3562,1837,1725,106.5,3440,1773,1667,106.4
경기도,수원시장안구,61세,2017,3268,1659,1609,103.1,3141,1600,1541,103.8
경기도,수원시장안구,62세,2017,3266,1572,1694,92.8,3129,1502,1627,92.3
경기도,수원시장안구,63세,2017,2717,1333,1384,96.3,2605,1286,1319,97.5
경기도,수원시장안구,64세,2017,2395,1147,1248,91.9,2300,1097,1203,91.2
경기도,수원시장안구,65~69세,2017,10136,4891,5245,93.3,9879,4753,5126,92.7
경기도,수원시장안구,65세,2017,2562,1264,1298,97.4,2488,1224,1264,96.8
경기도,수원시장안구,66세,2017,1752,836,916,91.3,1687,802,885,90.6
경기도,수원시장안구,67세,2017,1982,931,1051,88.6,1933,905,1028,88
경기도,수원시장안구,68세,2017,1935,937,998,93.9,1894,916,978,93.7
경기도,수원시장안구,69세,2017,1905,923,982,94,1877,906,971,93.3
경기도,수원시장안구,70~74세,2017,7951,3556,4395,80.9,7864,3524,4340,81.2
경기도,수원시장안구,70세,2017,1935,886,1049,84.5,1912,874,1038,84.2
경기도,수원시장안구,71세,2017,1511,712,799,89.1,1491,703,788,89.2
경기도,수원시장안구,72세,2017,1511,653,858,76.1,1493,645,848,76.1
경기도,수원시장안구,73세,2017,1502,666,836,79.7,1483,663,820,80.9
경기도,수원시장안구,74세,2017,1492,639,853,74.9,1485,639,846,75.5
경기도,수원시장안구,75~79세,2017,6565,2762,3803,72.6,6517,2750,3767,73
경기도,수원시장안구,75세,2017,1659,700,959,73,1646,697,949,73.4
경기도,수원시장안구,76세,2017,1363,595,768,77.5,1353,593,760,78
경기도,수원시장안구,77세,2017,1238,502,736,68.2,1227,499,728,68.5
경기도,수원시장안구,78세,2017,1194,499,695,71.8,1188,497,691,71.9
경기도,수원시장안구,79세,2017,1111,466,645,72.2,1103,464,639,72.6
경기도,수원시장안구,80~84세,2017,4182,1463,2719,53.8,4144,1453,2691,54
경기도,수원시장안구,80세,2017,1047,404,643,62.8,1036,400,636,62.9
경기도,수원시장안구,81세,2017,954,315,639,49.3,946,313,633,49.4
경기도,수원시장안구,82세,2017,862,292,570,51.2,854,291,563,51.7
경기도,수원시장안구,83세,2017,695,254,441,57.6,689,253,436,58
경기도,수원시장안구,84세,2017,624,198,426,46.5,619,196,423,46.3
경기도,수원시장안구,85세이상,2017,2972,828,2144,38.6,2959,825,2134,38.7
경기도,수원시장안구,85~89세,2017,2063,608,1455,41.8,2054,605,1449,41.8
경기도,수원시장안구,85세,2017,577,181,396,45.7,575,181,394,45.9
경기도,수원시장안구,86세,2017,419,131,288,45.5,416,130,286,45.5
경기도,수원시장안구,87세,2017,418,107,311,34.4,418,107,311,34.4
경기도,수원시장안구,88세,2017,359,107,252,42.5,358,107,251,42.6
경기도,수원시장안구,89세,2017,290,82,208,39.4,287,80,207,38.6
경기도,수원시장안구,90~94세,2017,711,186,525,35.4,708,186,522,35.6
경기도,수원시장안구,90세,2017,234,54,180,30,232,54,178,30.3
경기도,수원시장안구,91세,2017,156,39,117,33.3,156,39,117,33.3
경기도,수원시장안구,92세,2017,143,36,107,33.6,143,36,107,33.6
경기도,수원시장안구,93세,2017,94,30,64,46.9,94,30,64,46.9
경기도,수원시장안구,94세,2017,84,27,57,47.4,83,27,56,48.2
경기도,수원시장안구,95~99세,2017,180,31,149,20.8,179,31,148,20.9
경기도,수원시장안구,95세,2017,77,13,64,20.3,77,13,64,20.3
경기도,수원시장안구,96세,2017,44,9,35,25.7,44,9,35,25.7
경기도,수원시장안구,97세,2017,29,X,27,7.4,29,X,27,7.4
경기도,수원시장안구,98세,2017,20,6,14,42.9,20,6,14,42.9
경기도,수원시장안구,99세,2017,10,X,9,11.1,9,X,8,12.5
경기도,수원시장안구,100세이상,2017,18,X,15,20,18,X,15,20
경기도,수원시장안구,15세미만,2017,39240,20248,18992,106.6,38845,20044,18801,106.6
경기도,수원시장안구,15~64세,2017,224390,115912,108478,106.9,216793,111844,104949,106.6
경기도,수원시장안구,65세이상,2017,31806,13500,18306,73.7,31363,13305,18058,73.7
경기도,수원시장안구,평균연령,2017,39.5,38.3,40.7,,39.5,38.3,40.7,
경기도,수원시장안구,중위연령,2017,40.3,38.7,41.9,,40.4,38.8,41.9,
경기도,수원시권선구,합계,2017,364650,183913,180737,101.8,351909,177344,174565,101.6
경기도,수원시권선구,0~4세,2017,18672,9516,9156,103.9,18232,9297,8935,104.1
경기도,수원시권선구,0세,2017,3320,1682,1638,102.7,3220,1626,1594,102
경기도,수원시권선구,1세,2017,3845,2007,1838,109.2,3733,1947,1786,109
경기도,수원시권선구,2세,2017,3906,1987,1919,103.5,3822,1941,1881,103.2
경기도,수원시권선구,3세,2017,3822,1916,1906,100.5,3744,1886,1858,101.5
경기도,수원시권선구,4세,2017,3779,1924,1855,103.7,3713,1897,1816,104.5
경기도,수원시권선구,5~9세,2017,17706,9107,8599,105.9,17547,9025,8522,105.9
경기도,수원시권선구,5세,2017,3961,2042,1919,106.4,3918,2018,1900,106.2
경기도,수원시권선구,6세,2017,3758,1930,1828,105.6,3720,1911,1809,105.6
경기도,수원시권선구,7세,2017,3397,1721,1676,102.7,3368,1704,1664,102.4
경기도,수원시권선구,8세,2017,3239,1658,1581,104.9,3212,1647,1565,105.2
경기도,수원시권선구,9세,2017,3351,1756,1595,110.1,3329,1745,1584,110.2
경기도,수원시권선구,10~14세,2017,15912,8336,7576,110,15833,8306,7527,110.3
경기도,수원시권선구,10세,2017,3430,1772,1658,106.9,3403,1760,1643,107.1
경기도,수원시권선구,11세,2017,3027,1587,1440,110.2,3014,1580,1434,110.2
경기도,수원시권선구,12세,2017,2886,1487,1399,106.3,2873,1484,1389,106.8
경기도,수원시권선구,13세,2017,3259,1733,1526,113.6,3248,1729,1519,113.8
경기도,수원시권선구,14세,2017,3310,1757,1553,113.1,3295,1753,1542,113.7
경기도,수원시권선구,15~19세,2017,19213,10052,9161,109.7,19113,10010,9103,110
경기도,수원시권선구,15세,2017,3367,1758,1609,109.3,3352,1755,1597,109.9
경기도,수원시권선구,16세,2017,3775,2016,1759,114.6,3755,2006,1749,114.7
경기도,수원시권선구,17세,2017,4096,2125,1971,107.8,4084,2119,1965,107.8
경기도,수원시권선구,18세,2017,3984,2038,1946,104.7,3964,2031,1933,105.1
경기도,수원시권선구,19세,2017,3991,2115,1876,112.7,3958,2099,1859,112.9
경기도,수원시권선구,20~24세,2017,24979,12942,12037,107.5,24483,12667,11816,107.2
경기도,수원시권선구,20세,2017,4507,2311,2196,105.2,4471,2295,2176,105.5
경기도,수원시권선구,21세,2017,4861,2603,2258,115.3,4807,2579,2228,115.8
경기도,수원시권선구,22세,2017,4966,2548,2418,105.4,4875,2499,2376,105.2
경기도,수원시권선구,23세,2017,5150,2633,2517,104.6,5028,2553,2475,103.2
경기도,수원시권선구,24세,2017,5495,2847,2648,107.5,5302,2741,2561,107
경기도,수원시권선구,25~29세,2017,27816,14321,13495,106.1,26405,13637,12768,106.8
경기도,수원시권선구,25세,2017,5788,2962,2826,104.8,5593,2860,2733,104.6
경기도,수원시권선구,26세,2017,5736,2932,2804,104.6,5486,2817,2669,105.5
경기도,수원시권선구,27세,2017,5321,2751,2570,107,5060,2638,2422,108.9
경기도,수원시권선구,28세,2017,5516,2826,2690,105.1,5184,2665,2519,105.8
경기도,수원시권선구,29세,2017,5455,2850,2605,109.4,5082,2657,2425,109.6
경기도,수원시권선구,30~34세,2017,30051,15505,14546,106.6,28203,14503,13700,105.9
경기도,수원시권선구,30세,2017,5740,2978,2762,107.8,5304,2726,2578,105.7
경기도,수원시권선구,31세,2017,5626,2830,2796,101.2,5247,2638,2609,101.1
경기도,수원시권선구,32세,2017,5887,3018,2869,105.2,5502,2815,2687,104.8
경기도,수원시권선구,33세,2017,6156,3230,2926,110.4,5811,3035,2776,109.3
경기도,수원시권선구,34세,2017,6642,3449,3193,108,6339,3289,3050,107.8
경기도,수원시권선구,35~39세,2017,34545,18038,16507,109.3,33313,17336,15977,108.5
경기도,수원시권선구,35세,2017,7263,3758,3505,107.2,6980,3592,3388,106
경기도,수원시권선구,36세,2017,7355,3791,3564,106.4,7137,3670,3467,105.9
경기도,수원시권선구,37세,2017,7216,3817,3399,112.3,6967,3671,3296,111.4
경기도,수원시권선구,38세,2017,6673,3501,3172,110.4,6421,3361,3060,109.8
경기도,수원시권선구,39세,2017,6038,3171,2867,110.6,5808,3042,2766,110
경기도,수원시권선구,40~44세,2017,30201,15727,14474,108.7,29134,15130,14004,108
경기도,수원시권선구,40세,2017,6058,3200,2858,112,5854,3085,2769,111.4
경기도,수원시권선구,41세,2017,5764,3062,2702,113.3,5555,2934,2621,111.9
경기도,수원시권선구,42세,2017,5889,3051,2838,107.5,5662,2921,2741,106.6
경기도,수원시권선구,43세,2017,6182,3202,2980,107.4,5973,3081,2892,106.5
경기도,수원시권선구,44세,2017,6308,3212,3096,103.7,6090,3109,2981,104.3
경기도,수원시권선구,45~49세,2017,32730,16114,16616,97,31336,15398,15938,96.6
경기도,수원시권선구,45세,2017,6207,3198,3009,106.3,5953,3053,2900,105.3
경기도,수원시권선구,46세,2017,6654,3387,3267,103.7,6372,3228,3144,102.7
경기도,수원시권선구,47세,2017,6227,3061,3166,96.7,5951,2924,3027,96.6
경기도,수원시권선구,48세,2017,6841,3242,3599,90.1,6555,3110,3445,90.3
경기도,수원시권선구,49세,2017,6801,3226,3575,90.2,6505,3083,3422,90.1
경기도,수원시권선구,50~54세,2017,30950,15393,15557,98.9,29457,14647,14810,98.9
경기도,수원시권선구,50세,2017,6277,3046,3231,94.3,6046,2921,3125,93.5
경기도,수원시권선구,51세,2017,6155,3053,3102,98.4,5904,2927,2977,98.3
경기도,수원시권선구,52세,2017,6426,3165,3261,97.1,6121,3014,3107,97
경기도,수원시권선구,53세,2017,5938,2996,2942,101.8,5634,2839,2795,101.6
경기도,수원시권선구,54세,2017,6154,3133,3021,103.7,5752,2946,2806,105
경기도,수원시권선구,55~59세,2017,29462,14888,14574,102.2,28261,14281,13980,102.2
경기도,수원시권선구,55세,2017,6104,3108,2996,103.7,5809,2967,2842,104.4
경기도,수원시권선구,56세,2017,6633,3292,3341,98.5,6440,3193,3247,98.3
경기도,수원시권선구,57세,2017,6289,3219,3070,104.9,6009,3072,2937,104.6
경기도,수원시권선구,58세,2017,5520,2773,2747,100.9,5321,2672,2649,100.9
경기도,수원시권선구,59세,2017,4916,2496,2420,103.1,4682,2377,2305,103.1
경기도,수원시권선구,60~64세,2017,19160,9526,9634,98.9,18072,8954,9118,98.2
경기도,수원시권선구,60세,2017,4580,2298,2282,100.7,4290,2141,2149,99.6
경기도,수원시권선구,61세,2017,4150,2070,2080,99.5,3912,1950,1962,99.4
경기도,수원시권선구,62세,2017,4136,2070,2066,100.2,3918,1962,1956,100.3
경기도,수원시권선구,63세,2017,3342,1644,1698,96.8,3160,1544,1616,95.5
경기도,수원시권선구,64세,2017,2952,1444,1508,95.8,2792,1357,1435,94.6
경기도,수원시권선구,65~69세,2017,11868,5825,6043,96.4,11405,5613,5792,96.9
경기도,수원시권선구,65세,2017,3151,1590,1561,101.9,3013,1533,1480,103.6
경기도,수원시권선구,66세,2017,2091,1011,1080,93.6,1982,963,1019,94.5
경기도,수원시권선구,67세,2017,2265,1097,1168,93.9,2170,1050,1120,93.8
경기도,수원시권선구,68세,2017,2202,1086,1116,97.3,2132,1049,1083,96.9
경기도,수원시권선구,69세,2017,2159,1041,1118,93.1,2108,1018,1090,93.4
경기도,수원시권선구,70~74세,2017,8420,3948,4472,88.3,8286,3896,4390,88.7
경기도,수원시권선구,70세,2017,2192,1056,1136,93,2148,1040,1108,93.9
경기도,수원시권선구,71세,2017,1617,759,858,88.5,1591,748,843,88.7
경기도,수원시권선구,72세,2017,1578,759,819,92.7,1555,750,805,93.2
경기도,수원시권선구,73세,2017,1573,730,843,86.6,1550,721,829,87
경기도,수원시권선구,74세,2017,1460,644,816,78.9,1442,637,805,79.1
경기도,수원시권선구,75~79세,2017,6503,2666,3837,69.5,6427,2649,3778,70.1
경기도,수원시권선구,75세,2017,1625,746,879,84.9,1605,737,868,84.9
경기도,수원시권선구,76세,2017,1384,563,821,68.6,1363,560,803,69.7
경기도,수원시권선구,77세,2017,1168,446,722,61.8,1154,444,710,62.5
경기도,수원시권선구,78세,2017,1239,490,749,65.4,1230,489,741,66
경기도,수원시권선구,79세,2017,1087,421,666,63.2,1075,419,656,63.9
경기도,수원시권선구,80~84세,2017,3913,1359,2554,53.2,3863,1348,2515,53.6
경기도,수원시권선구,80세,2017,971,354,617,57.4,954,349,605,57.7
경기도,수원시권선구,81세,2017,853,309,544,56.8,846,307,539,57
경기도,수원시권선구,82세,2017,798,265,533,49.7,792,264,528,50
경기도,수원시권선구,83세,2017,707,251,456,55,696,250,446,56.1
경기도,수원시권선구,84세,2017,584,180,404,44.6,575,178,397,44.8
경기도,수원시권선구,85세이상,2017,2549,650,1899,34.2,2539,647,1892,34.2
경기도,수원시권선구,85~89세,2017,1815,493,1322,37.3,1808,491,1317,37.3
경기도,수원시권선구,85세,2017,492,150,342,43.9,491,149,342,43.6
경기도,수원시권선구,86세,2017,380,110,270,40.7,378,110,268,41
경기도,수원시권선구,87세,2017,368,86,282,30.5,367,85,282,30.1
경기도,수원시권선구,88세,2017,320,86,234,36.8,318,86,232,37.1
경기도,수원시권선구,89세,2017,255,61,194,31.4,254,61,193,31.6
경기도,수원시권선구,90~94세,2017,588,133,455,29.2,585,132,453,29.1
경기도,수원시권선구,90세,2017,196,52,144,36.1,196,52,144,36.1
경기도,수원시권선구,91세,2017,132,32,100,32,130,31,99,31.3
경기도,수원시권선구,92세,2017,107,15,92,16.3,107,15,92,16.3
경기도,수원시권선구,93세,2017,70,19,51,37.3,69,19,50,38
경기도,수원시권선구,94세,2017,83,15,68,22.1,83,15,68,22.1
경기도,수원시권선구,95~99세,2017,134,23,111,20.7,134,23,111,20.7
경기도,수원시권선구,95세,2017,48,11,37,29.7,48,11,37,29.7
경기도,수원시권선구,96세,2017,45,X,42,7.1,45,X,42,7.1
경기도,수원시권선구,97세,2017,22,5,17,29.4,22,5,17,29.4
경기도,수원시권선구,98세,2017,13,X,10,30,13,X,10,30
경기도,수원시권선구,99세,2017,6,X,5,20,6,X,5,20
경기도,수원시권선구,100세이상,2017,12,X,11,9.1,12,X,11,9.1
경기도,수원시권선구,15세미만,2017,52290,26959,25331,106.4,51612,26628,24984,106.6
경기도,수원시권선구,15~64세,2017,279107,142506,136601,104.3,267777,136563,131214,104.1
경기도,수원시권선구,65세이상,2017,33253,14448,18805,76.8,32520,14153,18367,77.1
경기도,수원시권선구,평균연령,2017,38.7,38,39.5,,38.6,37.8,39.4,
경기도,수원시권선구,중위연령,2017,38.9,38.2,39.8,,38.8,38.1,39.6,
경기도,수원시팔달구,합계,2017,206092,104339,101753,102.5,187184,94215,92969,101.3
경기도,수원시팔달구,0~4세,2017,7154,3679,3475,105.9,6577,3393,3184,106.6
경기도,수원시팔달구,0세,2017,1334,675,659,102.4,1223,619,604,102.5
경기도,수원시팔달구,1세,2017,1492,759,733,103.5,1342,688,654,105.2
경기도,수원시팔달구,2세,2017,1492,765,727,105.2,1375,702,673,104.3
경기도,수원시팔달구,3세,2017,1455,761,694,109.7,1344,713,631,113
경기도,수원시팔달구,4세,2017,1381,719,662,108.6,1293,671,622,107.9
경기도,수원시팔달구,5~9세,2017,7125,3729,3396,109.8,6857,3592,3265,110
경기도,수원시팔달구,5세,2017,1499,766,733,104.5,1420,723,697,103.7
경기도,수원시팔달구,6세,2017,1412,742,670,110.7,1357,718,639,112.4
경기도,수원시팔달구,7세,2017,1381,722,659,109.6,1340,700,640,109.4
경기도,수원시팔달구,8세,2017,1328,715,613,116.6,1276,690,586,117.7
경기도,수원시팔달구,9세,2017,1505,784,721,108.7,1464,761,703,108.3
경기도,수원시팔달구,10~14세,2017,7319,3730,3589,103.9,7198,3678,3520,104.5
경기도,수원시팔달구,10세,2017,1465,744,721,103.2,1438,733,705,104
경기도,수원시팔달구,11세,2017,1361,683,678,100.7,1326,674,652,103.4
경기도,수원시팔달구,12세,2017,1356,670,686,97.7,1337,663,674,98.4
경기도,수원시팔달구,13세,2017,1566,795,771,103.1,1542,779,763,102.1
경기도,수원시팔달구,14세,2017,1571,838,733,114.3,1555,829,726,114.2
경기도,수원시팔달구,15~19세,2017,9905,5168,4737,109.1,9772,5096,4676,109
경기도,수원시팔달구,15세,2017,1661,861,800,107.6,1643,852,791,107.7
경기도,수원시팔달구,16세,2017,1956,1028,928,110.8,1935,1015,920,110.3
경기도,수원시팔달구,17세,2017,2130,1119,1011,110.7,2100,1104,996,110.8
경기도,수원시팔달구,18세,2017,2081,1104,977,113,2051,1086,965,112.5
경기도,수원시팔달구,19세,2017,2077,1056,1021,103.4,2043,1039,1004,103.5
경기도,수원시팔달구,20~24세,2017,13514,7020,6494,108.1,12978,6764,6214,108.9
경기도,수원시팔달구,20세,2017,2301,1232,1069,115.2,2237,1197,1040,115.1
경기도,수원시팔달구,21세,2017,2505,1334,1171,113.9,2430,1295,1135,114.1
경기도,수원시팔달구,22세,2017,2666,1371,1295,105.9,2566,1332,1234,107.9
경기도,수원시팔달구,23세,2017,2899,1437,1462,98.3,2795,1390,1405,98.9
경기도,수원시팔달구,24세,2017,3143,1646,1497,110,2950,1550,1400,110.7
경기도,수원시팔달구,25~29세,2017,16914,8896,8018,111,15039,7888,7151,110.3
경기도,수원시팔달구,25세,2017,3382,1761,1621,108.6,3156,1641,1515,108.3
경기도,수원시팔달구,26세,2017,3353,1752,1601,109.4,3084,1611,1473,109.4
경기도,수원시팔달구,27세,2017,3373,1765,1608,109.8,2919,1518,1401,108.4
경기도,수원시팔달구,28세,2017,3455,1844,1611,114.5,2984,1586,1398,113.4
경기도,수원시팔달구,29세,2017,3351,1774,1577,112.5,2896,1532,1364,112.3
경기도,수원시팔달구,30~34세,2017,16219,8807,7412,118.8,14020,7558,6462,117
경기도,수원시팔달구,30세,2017,3269,1783,1486,120,2823,1520,1303,116.7
경기도,수원시팔달구,31세,2017,3291,1802,1489,121,2764,1515,1249,121.3
경기도,수원시팔달구,32세,2017,3136,1650,1486,111,2706,1419,1287,110.3
경기도,수원시팔달구,33세,2017,3184,1765,1419,124.4,2783,1522,1261,120.7
경기도,수원시팔달구,34세,2017,3339,1807,1532,118,2944,1582,1362,116.2
경기도,수원시팔달구,35~39세,2017,16678,8888,7790,114.1,14949,7850,7099,110.6
경기도,수원시팔달구,35세,2017,3555,1872,1683,111.2,3152,1641,1511,108.6
경기도,수원시팔달구,36세,2017,3457,1821,1636,111.3,3150,1634,1516,107.8
경기도,수원시팔달구,37세,2017,3413,1848,1565,118.1,3085,1650,1435,115
경기도,수원시팔달구,38세,2017,3281,1763,1518,116.1,2924,1542,1382,111.6
경기도,수원시팔달구,39세,2017,2972,1584,1388,114.1,2638,1383,1255,110.2
경기도,수원시팔달구,40~44세,2017,16213,8445,7768,108.7,14699,7582,7117,106.5
경기도,수원시팔달구,40세,2017,3055,1574,1481,106.3,2746,1402,1344,104.3
경기도,수원시팔달구,41세,2017,3013,1582,1431,110.6,2735,1421,1314,108.1
경기도,수원시팔달구,42세,2017,3206,1674,1532,109.3,2922,1501,1421,105.6
경기도,수원시팔달구,43세,2017,3446,1805,1641,110,3154,1642,1512,108.6
경기도,수원시팔달구,44세,2017,3493,1810,1683,107.5,3142,1616,1526,105.9
경기도,수원시팔달구,45~49세,2017,18799,9596,9203,104.3,16565,8361,8204,101.9
경기도,수원시팔달구,45세,2017,3459,1832,1627,112.6,3017,1580,1437,110
경기도,수원시팔달구,46세,2017,3878,1997,1881,106.2,3406,1730,1676,103.2
경기도,수원시팔달구,47세,2017,3778,1966,1812,108.5,3317,1727,1590,108.6
경기도,수원시팔달구,48세,2017,3796,1917,1879,102,3350,1668,1682,99.2
경기도,수원시팔달구,49세,2017,3888,1884,2004,94,3475,1656,1819,91
경기도,수원시팔달구,50~54세,2017,18400,9328,9072,102.8,15744,7935,7809,101.6
경기도,수원시팔달구,50세,2017,3478,1757,1721,102.1,3104,1549,1555,99.6
경기도,수원시팔달구,51세,2017,3582,1817,1765,102.9,3061,1553,1508,103
경기도,수원시팔달구,52세,2017,3699,1899,1800,105.5,3148,1622,1526,106.3
경기도,수원시팔달구,53세,2017,3702,1901,1801,105.6,3156,1608,1548,103.9
경기도,수원시팔달구,54세,2017,3939,1954,1985,98.4,3275,1603,1672,95.9
경기도,수원시팔달구,55~59세,2017,18446,9338,9108,102.5,16455,8300,8155,101.8
경기도,수원시팔달구,55세,2017,3750,1898,1852,102.5,3245,1645,1600,102.8
경기도,수원시팔달구,56세,2017,3994,2001,1993,100.4,3716,1863,1853,100.5
경기도,수원시팔달구,57세,2017,3922,1959,1963,99.8,3480,1722,1758,98
경기도,수원시팔달구,58세,2017,3484,1783,1701,104.8,3128,1590,1538,103.4
경기도,수원시팔달구,59세,2017,3296,1697,1599,106.1,2886,1480,1406,105.3
경기도,수원시팔달구,60~64세,2017,13690,6625,7065,93.8,11850,5692,6158,92.4
경기도,수원시팔달구,60세,2017,3193,1578,1615,97.7,2713,1349,1364,98.9
경기도,수원시팔달구,61세,2017,2919,1446,1473,98.2,2521,1231,1290,95.4
경기도,수원시팔달구,62세,2017,2946,1399,1547,90.4,2559,1195,1364,87.6
경기도,수원시팔달구,63세,2017,2557,1229,1328,92.5,2225,1059,1166,90.8
경기도,수원시팔달구,64세,2017,2075,973,1102,88.3,1832,858,974,88.1
경기도,수원시팔달구,65~69세,2017,9092,4399,4693,93.7,8312,3992,4320,92.4
경기도,수원시팔달구,65세,2017,2321,1127,1194,94.4,2103,1009,1094,92.2
경기도,수원시팔달구,66세,2017,1580,772,808,95.5,1386,675,711,94.9
경기도,수원시팔달구,67세,2017,1764,871,893,97.5,1609,783,826,94.8
경기도,수원시팔달구,68세,2017,1704,823,881,93.4,1575,763,812,94
경기도,수원시팔달구,69세,2017,1723,806,917,87.9,1639,762,877,86.9
경기도,수원시팔달구,70~74세,2017,6579,2943,3636,80.9,6350,2849,3501,81.4
경기도,수원시팔달구,70세,2017,1655,715,940,76.1,1571,678,893,75.9
경기도,수원시팔달구,71세,2017,1276,608,668,91,1233,590,643,91.8
경기도,수원시팔달구,72세,2017,1212,565,647,87.3,1173,548,625,87.7
경기도,수원시팔달구,73세,2017,1222,532,690,77.1,1188,520,668,77.8
경기도,수원시팔달구,74세,2017,1214,523,691,75.7,1185,513,672,76.3
경기도,수원시팔달구,75~79세,2017,5200,2214,2986,74.1,5077,2180,2897,75.3
경기도,수원시팔달구,75세,2017,1378,618,760,81.3,1353,613,740,82.8
경기도,수원시팔달구,76세,2017,1112,472,640,73.8,1087,464,623,74.5
경기도,수원시팔달구,77세,2017,959,398,561,70.9,936,390,546,71.4
경기도,수원시팔달구,78세,2017,939,382,557,68.6,909,374,535,69.9
경기도,수원시팔달구,79세,2017,812,344,468,73.5,792,339,453,74.8
경기도,수원시팔달구,80~84세,2017,2954,1056,1898,55.6,2881,1034,1847,56
경기도,수원시팔달구,80세,2017,731,278,453,61.4,711,270,441,61.2
경기도,수원시팔달구,81세,2017,693,242,451,53.7,671,237,434,54.6
경기도,수원시팔달구,82세,2017,602,222,380,58.4,586,218,368,59.2
경기도,수원시팔달구,83세,2017,510,178,332,53.6,501,174,327,53.2
경기도,수원시팔달구,84세,2017,418,136,282,48.2,412,135,277,48.7
경기도,수원시팔달구,85세이상,2017,1891,478,1413,33.8,1861,471,1390,33.9
경기도,수원시팔달구,85~89세,2017,1326,345,981,35.2,1300,339,961,35.3
경기도,수원시팔달구,85세,2017,384,114,270,42.2,378,113,265,42.6
경기도,수원시팔달구,86세,2017,281,69,212,32.5,273,65,208,31.3
경기도,수원시팔달구,87세,2017,241,68,173,39.3,235,68,167,40.7
경기도,수원시팔달구,88세,2017,240,56,184,30.4,235,56,179,31.3
경기도,수원시팔달구,89세,2017,180,38,142,26.8,179,37,142,26.1
경기도,수원시팔달구,90~94세,2017,452,110,342,32.2,449,109,340,32.1
경기도,수원시팔달구,90세,2017,142,37,105,35.2,140,36,104,34.6
경기도,수원시팔달구,91세,2017,104,22,82,26.8,103,22,81,27.2
경기도,수원시팔달구,92세,2017,78,10,68,14.7,78,10,68,14.7
경기도,수원시팔달구,93세,2017,62,18,44,40.9,62,18,44,40.9
경기도,수원시팔달구,94세,2017,66,23,43,53.5,66,23,43,53.5
경기도,수원시팔달구,95~99세,2017,104,23,81,28.4,104,23,81,28.4
경기도,수원시팔달구,95세,2017,52,12,40,30,52,12,40,30
경기도,수원시팔달구,96세,2017,28,8,20,40,28,8,20,40
경기도,수원시팔달구,97세,2017,15,X,14,7.1,15,X,14,7.1
경기도,수원시팔달구,98세,2017,5,X,X,66.7,5,X,X,66.7
경기도,수원시팔달구,99세,2017,X,X,X,0,X,X,X,0
경기도,수원시팔달구,100세이상,2017,9,X,9,0,8,X,8,0
경기도,수원시팔달구,15세미만,2017,21598,11138,10460,106.5,20632,10663,9969,107
경기도,수원시팔달구,15~64세,2017,158778,82111,76667,107.1,142071,73026,69045,105.8
경기도,수원시팔달구,65세이상,2017,25716,11090,14626,75.8,24481,10526,13955,75.4
경기도,수원시팔달구,평균연령,2017,41.8,40.8,42.9,,41.6,40.5,42.7,
경기도,수원시팔달구,중위연령,2017,42.7,41.4,43.9,,42.2,40.9,43.6,
경기도,수원시영통구,합계,2017,350818,177778,173040,102.7,342310,173130,169180,102.3
경기도,수원시영통구,0~4세,2017,19449,10049,9400,106.9,19094,9868,9226,107
경기도,수원시영통구,0세,2017,3434,1806,1628,110.9,3363,1771,1592,111.2
경기도,수원시영통구,1세,2017,3957,2045,1912,107,3877,1998,1879,106.3
경기도,수원시영통구,2세,2017,4192,2128,2064,103.1,4126,2097,2029,103.4
경기도,수원시영통구,3세,2017,3915,2004,1911,104.9,3849,1968,1881,104.6
경기도,수원시영통구,4세,2017,3951,2066,1885,109.6,3879,2034,1845,110.2
경기도,수원시영통구,5~9세,2017,20454,10500,9954,105.5,20234,10377,9857,105.3
경기도,수원시영통구,5세,2017,4302,2198,2104,104.5,4241,2168,2073,104.6
경기도,수원시영통구,6세,2017,4151,2142,2009,106.6,4097,2112,1985,106.4
경기도,수원시영통구,7세,2017,3963,2081,1882,110.6,3929,2060,1869,110.2
경기도,수원시영통구,8세,2017,3907,1988,1919,103.6,3866,1965,1901,103.4
경기도,수원시영통구,9세,2017,4131,2091,2040,102.5,4101,2072,2029,102.1
경기도,수원시영통구,10~14세,2017,19849,10150,9699,104.6,19766,10101,9665,104.5
경기도,수원시영통구,10세,2017,4201,2173,2028,107.1,4182,2161,2021,106.9
경기도,수원시영통구,11세,2017,3742,1932,1810,106.7,3720,1920,1800,106.7
경기도,수원시영통구,12세,2017,3722,1885,1837,102.6,3706,1875,1831,102.4
경기도,수원시영통구,13세,2017,4080,2078,2002,103.8,4065,2070,1995,103.8
경기도,수원시영통구,14세,2017,4104,2082,2022,103,4093,2075,2018,102.8
경기도,수원시영통구,15~19세,2017,23837,12317,11520,106.9,23536,12209,11327,107.8
경기도,수원시영통구,15세,2017,4004,2019,1985,101.7,3990,2013,1977,101.8
경기도,수원시영통구,16세,2017,4601,2420,2181,111,4589,2414,2175,111
경기도,수원시영통구,17세,2017,5143,2641,2502,105.6,5125,2638,2487,106.1
경기도,수원시영통구,18세,2017,4848,2533,2315,109.4,4791,2511,2280,110.1
경기도,수원시영통구,19세,2017,5241,2704,2537,106.6,5041,2633,2408,109.3
경기도,수원시영통구,20~24세,2017,27459,14188,13271,106.9,26356,13620,12736,106.9
경기도,수원시영통구,20세,2017,4977,2582,2395,107.8,4779,2479,2300,107.8
경기도,수원시영통구,21세,2017,5192,2657,2535,104.8,4986,2558,2428,105.4
경기도,수원시영통구,22세,2017,5537,2946,2591,113.7,5309,2843,2466,115.3
경기도,수원시영통구,23세,2017,5755,2941,2814,104.5,5525,2807,2718,103.3
경기도,수원시영통구,24세,2017,5998,3062,2936,104.3,5757,2933,2824,103.9
경기도,수원시영통구,25~29세,2017,29734,16142,13592,118.8,28401,15399,13002,118.4
경기도,수원시영통구,25세,2017,6265,3365,2900,116,5995,3211,2784,115.3
경기도,수원시영통구,26세,2017,6059,3338,2721,122.7,5804,3197,2607,122.6
경기도,수원시영통구,27세,2017,5886,3247,2639,123,5593,3082,2511,122.7
경기도,수원시영통구,28세,2017,5782,3144,2638,119.2,5544,3014,2530,119.1
경기도,수원시영통구,29세,2017,5742,3048,2694,113.1,5465,2895,2570,112.6
경기도,수원시영통구,30~34세,2017,30031,15693,14338,109.5,28719,14947,13772,108.5
경기도,수원시영통구,30세,2017,5792,3072,2720,112.9,5490,2898,2592,111.8
경기도,수원시영통구,31세,2017,5804,3079,2725,113,5532,2928,2604,112.4
경기도,수원시영통구,32세,2017,5967,3070,2897,106,5702,2924,2778,105.3
경기도,수원시영통구,33세,2017,5871,3014,2857,105.5,5611,2860,2751,104
경기도,수원시영통구,34세,2017,6597,3458,3139,110.2,6384,3337,3047,109.5
경기도,수원시영통구,35~39세,2017,34274,17212,17062,100.9,33335,16624,16711,99.5
경기도,수원시영통구,35세,2017,7162,3617,3545,102,6930,3472,3458,100.4
경기도,수원시영통구,36세,2017,7101,3566,3535,100.9,6925,3451,3474,99.3
경기도,수원시영통구,37세,2017,7087,3503,3584,97.7,6891,3390,3501,96.8
경기도,수원시영통구,38세,2017,6767,3376,3391,99.6,6584,3255,3329,97.8
경기도,수원시영통구,39세,2017,6157,3150,3007,104.8,6005,3056,2949,103.6
경기도,수원시영통구,40~44세,2017,32633,16016,16617,96.4,31978,15588,16390,95.1
경기도,수원시영통구,40세,2017,6447,3226,3221,100.2,6293,3124,3169,98.6
경기도,수원시영통구,41세,2017,6296,3136,3160,99.2,6170,3054,3116,98
경기도,수원시영통구,42세,2017,6329,3135,3194,98.2,6212,3064,3148,97.3
경기도,수원시영통구,43세,2017,6706,3209,3497,91.8,6576,3116,3460,90.1
경기도,수원시영통구,44세,2017,6855,3310,3545,93.4,6727,3230,3497,92.4
경기도,수원시영통구,45~49세,2017,33547,16745,16802,99.7,32896,16369,16527,99
경기도,수원시영통구,45세,2017,6785,3403,3382,100.6,6640,3314,3326,99.6
경기도,수원시영통구,46세,2017,7091,3592,3499,102.7,6958,3516,3442,102.1
경기도,수원시영통구,47세,2017,6689,3365,3324,101.2,6544,3279,3265,100.4
경기도,수원시영통구,48세,2017,6685,3307,3378,97.9,6569,3241,3328,97.4
경기도,수원시영통구,49세,2017,6297,3078,3219,95.6,6185,3019,3166,95.4
경기도,수원시영통구,50~54세,2017,25953,13128,12825,102.4,25380,12830,12550,102.2
경기도,수원시영통구,50세,2017,5578,2755,2823,97.6,5487,2701,2786,96.9
경기도,수원시영통구,51세,2017,5192,2608,2584,100.9,5080,2549,2531,100.7
경기도,수원시영통구,52세,2017,5321,2688,2633,102.1,5192,2620,2572,101.9
경기도,수원시영통구,53세,2017,4815,2442,2373,102.9,4711,2391,2320,103.1
경기도,수원시영통구,54세,2017,5047,2635,2412,109.2,4910,2569,2341,109.7
경기도,수원시영통구,55~59세,2017,21083,11046,10037,110.1,20703,10859,9844,110.3
경기도,수원시영통구,55세,2017,4755,2444,2311,105.8,4653,2405,2248,107
경기도,수원시영통구,56세,2017,4793,2482,2311,107.4,4723,2445,2278,107.3
경기도,수원시영통구,57세,2017,4461,2355,2106,111.8,4383,2307,2076,111.1
경기도,수원시영통구,58세,2017,3669,1971,1698,116.1,3598,1937,1661,116.6
경기도,수원시영통구,59세,2017,3405,1794,1611,111.4,3346,1765,1581,111.6
경기도,수원시영통구,60~64세,2017,11858,5931,5927,100.1,11521,5777,5744,100.6
경기도,수원시영통구,60세,2017,2987,1527,1460,104.6,2896,1481,1415,104.7
경기도,수원시영통구,61세,2017,2636,1359,1277,106.4,2554,1319,1235,106.8
경기도,수원시영통구,62세,2017,2529,1253,1276,98.2,2465,1226,1239,99
경기도,수원시영통구,63세,2017,1970,966,1004,96.2,1919,944,975,96.8
경기도,수원시영통구,64세,2017,1736,826,910,90.8,1687,807,880,91.7
경기도,수원시영통구,65~69세,2017,7240,3489,3751,93,7075,3424,3651,93.8
경기도,수원시영통구,65세,2017,1882,930,952,97.7,1840,911,929,98.1
경기도,수원시영통구,66세,2017,1227,597,630,94.8,1179,579,600,96.5
경기도,수원시영통구,67세,2017,1426,682,744,91.7,1393,670,723,92.7
경기도,수원시영통구,68세,2017,1383,661,722,91.6,1357,651,706,92.2
경기도,수원시영통구,69세,2017,1322,619,703,88.1,1306,613,693,88.5
경기도,수원시영통구,70~74세,2017,5108,2283,2825,80.8,5053,2261,2792,81
경기도,수원시영통구,70세,2017,1266,594,672,88.4,1248,586,662,88.5
경기도,수원시영통구,71세,2017,1011,471,540,87.2,997,467,530,88.1
경기도,수원시영통구,72세,2017,973,440,533,82.6,963,437,526,83.1
경기도,수원시영통구,73세,2017,916,385,531,72.5,909,380,529,71.8
경기도,수원시영통구,74세,2017,942,393,549,71.6,936,391,545,71.7
경기도,수원시영통구,75~79세,2017,4067,1610,2457,65.5,4050,1605,2445,65.6
경기도,수원시영통구,75세,2017,1047,429,618,69.4,1043,427,616,69.3
경기도,수원시영통구,76세,2017,860,346,514,67.3,854,346,508,68.1
경기도,수원시영통구,77세,2017,764,320,444,72.1,762,319,443,72
경기도,수원시영통구,78세,2017,709,265,444,59.7,706,265,441,60.1
경기도,수원시영통구,79세,2017,687,250,437,57.2,685,248,437,56.8
경기도,수원시영통구,80~84세,2017,2543,836,1707,49,2522,831,1691,49.1
경기도,수원시영통구,80세,2017,626,218,408,53.4,619,216,403,53.6
경기도,수원시영통구,81세,2017,557,187,370,50.5,555,187,368,50.8
경기도,수원시영통구,82세,2017,530,172,358,48,526,170,356,47.8
경기도,수원시영통구,83세,2017,447,143,304,47,443,143,300,47.7
경기도,수원시영통구,84세,2017,383,116,267,43.4,379,115,264,43.6
경기도,수원시영통구,85세이상,2017,1699,443,1256,35.3,1691,441,1250,35.3
경기도,수원시영통구,85~89세,2017,1219,332,887,37.4,1213,331,882,37.5
경기도,수원시영통구,85세,2017,348,117,231,50.6,345,116,229,50.7
경기도,수원시영통구,86세,2017,247,64,183,35,246,64,182,35.2
경기도,수원시영통구,87세,2017,265,62,203,30.5,263,62,201,30.8
경기도,수원시영통구,88세,2017,197,54,143,37.8,197,54,143,37.8
경기도,수원시영통구,89세,2017,162,35,127,27.6,162,35,127,27.6
경기도,수원시영통구,90~94세,2017,378,91,287,31.7,376,90,286,31.5
경기도,수원시영통구,90세,2017,120,36,84,42.9,120,36,84,42.9
경기도,수원시영통구,91세,2017,93,17,76,22.4,92,17,75,22.7
경기도,수원시영통구,92세,2017,66,16,50,32,66,16,50,32
경기도,수원시영통구,93세,2017,60,12,48,25,60,12,48,25
경기도,수원시영통구,94세,2017,39,10,29,34.5,38,9,29,31
경기도,수원시영통구,95~99세,2017,91,17,74,23,91,17,74,23
경기도,수원시영통구,95세,2017,36,8,28,28.6,36,8,28,28.6
경기도,수원시영통구,96세,2017,22,X,18,22.2,22,X,18,22.2
경기도,수원시영통구,97세,2017,14,X,12,16.7,14,X,12,16.7
경기도,수원시영통구,98세,2017,14,X,12,16.7,14,X,12,16.7
경기도,수원시영통구,99세,2017,5,X,X,25,5,X,X,25
경기도,수원시영통구,100세이상,2017,11,X,8,37.5,11,X,8,37.5
경기도,수원시영통구,15세미만,2017,59752,30699,29053,105.7,59094,30346,28748,105.6
경기도,수원시영통구,15~64세,2017,270409,138418,131991,104.9,262825,134222,128603,104.4
경기도,수원시영통구,65세이상,2017,20657,8661,11996,72.2,20391,8562,11829,72.4
경기도,수원시영통구,평균연령,2017,35.3,34.7,36,,35.3,34.7,36,
경기도,수원시영통구,중위연령,2017,35.6,35,36.3,,35.7,35,36.4,
경상남도,진주시,합계,2017,353209,176672,176537,100.1,347571,173208,174363,99.3
경상남도,진주시,0~4세,2017,14156,7383,6773,109,14106,7357,6749,109
경상남도,진주시,0세,2017,2390,1215,1175,103.4,2379,1210,1169,103.5
경상남도,진주시,1세,2017,2710,1435,1275,112.5,2697,1428,1269,112.5
경상남도,진주시,2세,2017,2956,1513,1443,104.9,2944,1506,1438,104.7
경상남도,진주시,3세,2017,3098,1605,1493,107.5,3086,1598,1488,107.4
경상남도,진주시,4세,2017,3002,1615,1387,116.4,3000,1615,1385,116.6
경상남도,진주시,5~9세,2017,16598,8710,7888,110.4,16577,8700,7877,110.4
경상남도,진주시,5세,2017,3321,1705,1616,105.5,3313,1702,1611,105.6
경상남도,진주시,6세,2017,3399,1810,1589,113.9,3395,1808,1587,113.9
경상남도,진주시,7세,2017,3289,1756,1533,114.5,3286,1754,1532,114.5
경상남도,진주시,8세,2017,3172,1669,1503,111,3170,1668,1502,111.1
경상남도,진주시,9세,2017,3417,1770,1647,107.5,3413,1768,1645,107.5
경상남도,진주시,10~14세,2017,16899,8858,8041,110.2,16889,8852,8037,110.1
경상남도,진주시,10세,2017,3492,1761,1731,101.7,3490,1759,1731,101.6
경상남도,진주시,11세,2017,3182,1678,1504,111.6,3179,1677,1502,111.7
경상남도,진주시,12세,2017,3120,1642,1478,111.1,3119,1642,1477,111.2
경상남도,진주시,13세,2017,3568,1934,1634,118.4,3565,1931,1634,118.2
경상남도,진주시,14세,2017,3537,1843,1694,108.8,3536,1843,1693,108.9
경상남도,진주시,15~19세,2017,23458,12473,10985,113.5,23232,12365,10867,113.8
경상남도,진주시,15세,2017,3722,2036,1686,120.8,3716,2032,1684,120.7
경상남도,진주시,16세,2017,4291,2318,1973,117.5,4283,2314,1969,117.5
경상남도,진주시,17세,2017,4581,2473,2108,117.3,4575,2469,2106,117.2
경상남도,진주시,18세,2017,4842,2566,2276,112.7,4791,2541,2250,112.9
경상남도,진주시,19세,2017,6022,3080,2942,104.7,5867,3009,2858,105.3
경상남도,진주시,20~24세,2017,28521,15970,12551,127.2,27607,15454,12153,127.2
경상남도,진주시,20세,2017,5577,2752,2825,97.4,5442,2686,2756,97.5
경상남도,진주시,21세,2017,5887,3146,2741,114.8,5742,3062,2680,114.3
경상남도,진주시,22세,2017,6085,3506,2579,135.9,5913,3404,2509,135.7
경상남도,진주시,23세,2017,5734,3445,2289,150.5,5506,3315,2191,151.3
경상남도,진주시,24세,2017,5238,3121,2117,147.4,5004,2987,2017,148.1
경상남도,진주시,25~29세,2017,20942,11738,9204,127.5,19675,10949,8726,125.5
경상남도,진주시,25세,2017,4780,2783,1997,139.4,4540,2635,1905,138.3
경상남도,진주시,26세,2017,4265,2402,1863,128.9,4016,2256,1760,128.2
경상남도,진주시,27세,2017,4088,2267,1821,124.5,3786,2082,1704,122.2
경상남도,진주시,28세,2017,4050,2252,1798,125.3,3798,2080,1718,121.1
경상남도,진주시,29세,2017,3759,2034,1725,117.9,3535,1896,1639,115.7
경상남도,진주시,30~34세,2017,20661,10733,9928,108.1,19609,9976,9633,103.6
경상남도,진주시,30세,2017,3992,2081,1911,108.9,3746,1915,1831,104.6
경상남도,진주시,31세,2017,4009,2152,1857,115.9,3784,1984,1800,110.2
경상남도,진주시,32세,2017,3847,2056,1791,114.8,3632,1899,1733,109.6
경상남도,진주시,33세,2017,4184,2114,2070,102.1,4002,1989,2013,98.8
경상남도,진주시,34세,2017,4629,2330,2299,101.3,4445,2189,2256,97
경상남도,진주시,35~39세,2017,25375,12855,12520,102.7,24715,12391,12324,100.5
경상남도,진주시,35세,2017,5037,2552,2485,102.7,4872,2431,2441,99.6
경상남도,진주시,36세,2017,5027,2538,2489,102,4876,2435,2441,99.8
경상남도,진주시,37세,2017,5330,2706,2624,103.1,5197,2614,2583,101.2
경상남도,진주시,38세,2017,5149,2638,2511,105.1,5029,2560,2469,103.7
경상남도,진주시,39세,2017,4832,2421,2411,100.4,4741,2351,2390,98.4
경상남도,진주시,40~44세,2017,26784,13366,13418,99.6,26421,13138,13283,98.9
경상남도,진주시,40세,2017,4826,2409,2417,99.7,4750,2350,2400,97.9
경상남도,진주시,41세,2017,5036,2524,2512,100.5,4934,2463,2471,99.7
경상남도,진주시,42세,2017,5210,2612,2598,100.5,5142,2569,2573,99.8
경상남도,진주시,43세,2017,5703,2798,2905,96.3,5646,2764,2882,95.9
경상남도,진주시,44세,2017,6009,3023,2986,101.2,5949,2992,2957,101.2
경상남도,진주시,45~49세,2017,30698,15392,15306,100.6,30347,15190,15157,100.2
경상남도,진주시,45세,2017,5696,2908,2788,104.3,5612,2859,2753,103.9
경상남도,진주시,46세,2017,6120,3053,3067,99.5,6060,3016,3044,99.1
경상남도,진주시,47세,2017,6346,3160,3186,99.2,6279,3116,3163,98.5
경상남도,진주시,48세,2017,6349,3170,3179,99.7,6280,3135,3145,99.7
경상남도,진주시,49세,2017,6187,3101,3086,100.5,6116,3064,3052,100.4
경상남도,진주시,50~54세,2017,26909,13444,13465,99.8,26604,13295,13309,99.9
경상남도,진주시,50세,2017,5697,2773,2924,94.8,5629,2740,2889,94.8
경상남도,진주시,51세,2017,5516,2870,2646,108.5,5457,2838,2619,108.4
경상남도,진주시,52세,2017,5509,2720,2789,97.5,5460,2694,2766,97.4
경상남도,진주시,53세,2017,4744,2330,2414,96.5,4676,2297,2379,96.6
경상남도,진주시,54세,2017,5443,2751,2692,102.2,5382,2726,2656,102.6
경상남도,진주시,55~59세,2017,29334,14336,14998,95.6,29138,14236,14902,95.5
경상남도,진주시,55세,2017,5881,2945,2936,100.3,5826,2918,2908,100.3
경상남도,진주시,56세,2017,6748,3286,3462,94.9,6715,3269,3446,94.9
경상남도,진주시,57세,2017,6226,2950,3276,90,6185,2931,3254,90.1
경상남도,진주시,58세,2017,5218,2572,2646,97.2,5188,2553,2635,96.9
경상남도,진주시,59세,2017,5261,2583,2678,96.5,5224,2565,2659,96.5
경상남도,진주시,60~64세,2017,22202,10890,11312,96.3,22084,10833,11251,96.3
경상남도,진주시,60세,2017,5057,2540,2517,100.9,5024,2525,2499,101
경상남도,진주시,61세,2017,4658,2351,2307,101.9,4629,2335,2294,101.8
경상남도,진주시,62세,2017,4826,2242,2584,86.8,4806,2231,2575,86.6
경상남도,진주시,63세,2017,4183,2119,2064,102.7,4162,2113,2049,103.1
경상남도,진주시,64세,2017,3478,1638,1840,89,3463,1629,1834,88.8
경상남도,진주시,65~69세,2017,16268,7630,8638,88.3,16207,7598,8609,88.3
경상남도,진주시,65세,2017,3761,1777,1984,89.6,3742,1765,1977,89.3
경상남도,진주시,66세,2017,2970,1416,1554,91.1,2956,1407,1549,90.8
경상남도,진주시,67세,2017,3230,1521,1709,89,3215,1515,1700,89.1
경상남도,진주시,68세,2017,3171,1453,1718,84.6,3163,1449,1714,84.5
경상남도,진주시,69세,2017,3136,1463,1673,87.4,3131,1462,1669,87.6
경상남도,진주시,70~74세,2017,12272,5538,6734,82.2,12247,5526,6721,82.2
경상남도,진주시,70세,2017,2931,1380,1551,89,2922,1376,1546,89
경상남도,진주시,71세,2017,2266,1045,1221,85.6,2262,1043,1219,85.6
경상남도,진주시,72세,2017,2280,1043,1237,84.3,2275,1041,1234,84.4
경상남도,진주시,73세,2017,2399,1051,1348,78,2393,1047,1346,77.8
경상남도,진주시,74세,2017,2396,1019,1377,74,2395,1019,1376,74.1
경상남도,진주시,75~79세,2017,10869,4243,6626,64,10857,4237,6620,64
경상남도,진주시,75세,2017,2609,1076,1533,70.2,2605,1074,1531,70.2
경상남도,진주시,76세,2017,2279,941,1338,70.3,2277,940,1337,70.3
경상남도,진주시,77세,2017,2164,833,1331,62.6,2163,832,1331,62.5
경상남도,진주시,78세,2017,2056,770,1286,59.9,2052,768,1284,59.8
경상남도,진주시,79세,2017,1761,623,1138,54.7,1760,623,1137,54.8
경상남도,진주시,80~84세,2017,6768,2119,4649,45.6,6763,2118,4645,45.6
경상남도,진주시,80세,2017,1642,588,1054,55.8,1640,588,1052,55.9
경상남도,진주시,81세,2017,1550,498,1052,47.3,1548,497,1051,47.3
경상남도,진주시,82세,2017,1406,431,975,44.2,1406,431,975,44.2
경상남도,진주시,83세,2017,1201,354,847,41.8,1201,354,847,41.8
경상남도,진주시,84세,2017,969,248,721,34.4,968,248,720,34.4
경상남도,진주시,85세이상,2017,4495,994,3501,28.4,4493,993,3500,28.4
경상남도,진주시,85~89세,2017,3269,762,2507,30.4,3268,761,2507,30.4
경상남도,진주시,85세,2017,946,244,702,34.8,946,244,702,34.8
경상남도,진주시,86세,2017,729,181,548,33,729,181,548,33
경상남도,진주시,87세,2017,632,122,510,23.9,632,122,510,23.9
경상남도,진주시,88세,2017,536,123,413,29.8,536,123,413,29.8
경상남도,진주시,89세,2017,426,92,334,27.5,425,91,334,27.2
경상남도,진주시,90~94세,2017,996,192,804,23.9,996,192,804,23.9
경상남도,진주시,90세,2017,322,62,260,23.8,322,62,260,23.8
경상남도,진주시,91세,2017,233,47,186,25.3,233,47,186,25.3
경상남도,진주시,92세,2017,214,38,176,21.6,214,38,176,21.6
경상남도,진주시,93세,2017,124,29,95,30.5,124,29,95,30.5
경상남도,진주시,94세,2017,103,16,87,18.4,103,16,87,18.4
경상남도,진주시,95~99세,2017,205,35,170,20.6,204,35,169,20.7
경상남도,진주시,95세,2017,86,13,73,17.8,86,13,73,17.8
경상남도,진주시,96세,2017,55,10,45,22.2,55,10,45,22.2
경상남도,진주시,97세,2017,34,X,30,13.3,33,X,29,13.8
경상남도,진주시,98세,2017,17,6,11,54.5,17,6,11,54.5
경상남도,진주시,99세,2017,13,X,11,18.2,13,X,11,18.2
경상남도,진주시,100세이상,2017,25,5,20,25,25,5,20,25
경상남도,진주시,15세미만,2017,47653,24951,22702,109.9,47572,24909,22663,109.9
경상남도,진주시,15~64세,2017,254884,131197,123687,106.1,249432,127827,121605,105.1
경상남도,진주시,65세이상,2017,50672,20524,30148,68.1,50567,20472,30095,68
경상남도,진주시,평균연령,2017,41,39.3,42.8,,41.1,39.4,42.9,
경상남도,진주시,중위연령,2017,42,39.8,44,,42.3,40.2,44.2,
경상남도,창원시의창구,합계,2017,250560,128181,122379,104.7,245726,125171,120555,103.8
경상남도,창원시의창구,0~4세,2017,10379,5354,5025,106.5,10327,5325,5002,106.5
경상남도,창원시의창구,0세,2017,1875,992,883,112.3,1866,987,879,112.3
경상남도,창원시의창구,1세,2017,1998,1013,985,102.8,1983,1004,979,102.6
경상남도,창원시의창구,2세,2017,2203,1129,1074,105.1,2195,1126,1069,105.3
경상남도,창원시의창구,3세,2017,2152,1137,1015,112,2142,1131,1011,111.9
경상남도,창원시의창구,4세,2017,2151,1083,1068,101.4,2141,1077,1064,101.2
경상남도,창원시의창구,5~9세,2017,10934,5642,5292,106.6,10902,5622,5280,106.5
경상남도,창원시의창구,5세,2017,2334,1188,1146,103.7,2326,1184,1142,103.7
경상남도,창원시의창구,6세,2017,2236,1180,1056,111.7,2229,1174,1055,111.3
경상남도,창원시의창구,7세,2017,2153,1121,1032,108.6,2144,1116,1028,108.6
경상남도,창원시의창구,8세,2017,2094,1053,1041,101.2,2091,1052,1039,101.3
경상남도,창원시의창구,9세,2017,2117,1100,1017,108.2,2112,1096,1016,107.9
경상남도,창원시의창구,10~14세,2017,10341,5462,4879,111.9,10329,5460,4869,112.1
경상남도,창원시의창구,10세,2017,2092,1094,998,109.6,2091,1093,998,109.5
경상남도,창원시의창구,11세,2017,1937,997,940,106.1,1934,997,937,106.4
경상남도,창원시의창구,12세,2017,1932,1054,878,120,1929,1053,876,120.2
경상남도,창원시의창구,13세,2017,2180,1150,1030,111.7,2177,1150,1027,112
경상남도,창원시의창구,14세,2017,2200,1167,1033,113,2198,1167,1031,113.2
경상남도,창원시의창구,15~19세,2017,14942,8120,6822,119,14897,8101,6796,119.2
경상남도,창원시의창구,15세,2017,2384,1337,1047,127.7,2377,1333,1044,127.7
경상남도,창원시의창구,16세,2017,2800,1468,1332,110.2,2796,1466,1330,110.2
경상남도,창원시의창구,17세,2017,3250,1766,1484,119,3247,1765,1482,119.1
경상남도,창원시의창구,18세,2017,3174,1706,1468,116.2,3167,1703,1464,116.3
경상남도,창원시의창구,19세,2017,3334,1843,1491,123.6,3310,1834,1476,124.3
경상남도,창원시의창구,20~24세,2017,19112,10752,8360,128.6,18653,10491,8162,128.5
경상남도,창원시의창구,20세,2017,3662,2022,1640,123.3,3601,2004,1597,125.5
경상남도,창원시의창구,21세,2017,3862,2201,1661,132.5,3802,2171,1631,133.1
경상남도,창원시의창구,22세,2017,3897,2262,1635,138.3,3814,2207,1607,137.3
경상남도,창원시의창구,23세,2017,3893,2176,1717,126.7,3793,2117,1676,126.3
경상남도,창원시의창구,24세,2017,3798,2091,1707,122.5,3643,1992,1651,120.7
경상남도,창원시의창구,25~29세,2017,17132,9504,7628,124.6,16159,8829,7330,120.5
경상남도,창원시의창구,25세,2017,3814,2116,1698,124.6,3646,2004,1642,122
경상남도,창원시의창구,26세,2017,3622,1996,1626,122.8,3424,1857,1567,118.5
경상남도,창원시의창구,27세,2017,3407,1910,1497,127.6,3193,1760,1433,122.8
경상남도,창원시의창구,28세,2017,3191,1812,1379,131.4,2977,1667,1310,127.3
경상남도,창원시의창구,29세,2017,3098,1670,1428,116.9,2919,1541,1378,111.8
경상남도,창원시의창구,30~34세,2017,16488,8981,7507,119.6,15584,8348,7236,115.4
경상남도,창원시의창구,30세,2017,3038,1708,1330,128.4,2812,1555,1257,123.7
경상남도,창원시의창구,31세,2017,3158,1783,1375,129.7,2957,1646,1311,125.6
경상남도,창원시의창구,32세,2017,3313,1806,1507,119.8,3113,1666,1447,115.1
경상남도,창원시의창구,33세,2017,3285,1720,1565,109.9,3146,1619,1527,106
경상남도,창원시의창구,34세,2017,3694,1964,1730,113.5,3556,1862,1694,109.9
경상남도,창원시의창구,35~39세,2017,19409,10269,9140,112.4,18794,9858,8936,110.3
경상남도,창원시의창구,35세,2017,4073,2162,1911,113.1,3912,2054,1858,110.5
경상남도,창원시의창구,36세,2017,4047,2121,1926,110.1,3935,2037,1898,107.3
경상남도,창원시의창구,37세,2017,4157,2179,1978,110.2,4034,2099,1935,108.5
경상남도,창원시의창구,38세,2017,3574,1897,1677,113.1,3465,1828,1637,111.7
경상남도,창원시의창구,39세,2017,3558,1910,1648,115.9,3448,1840,1608,114.4
경상남도,창원시의창구,40~44세,2017,18675,9571,9104,105.1,18230,9295,8935,104
경상남도,창원시의창구,40세,2017,3376,1789,1587,112.7,3290,1735,1555,111.6
경상남도,창원시의창구,41세,2017,3483,1829,1654,110.6,3388,1764,1624,108.6
경상남도,창원시의창구,42세,2017,3586,1844,1742,105.9,3494,1783,1711,104.2
경상남도,창원시의창구,43세,2017,3971,2007,1964,102.2,3888,1955,1933,101.1
경상남도,창원시의창구,44세,2017,4259,2102,2157,97.5,4170,2058,2112,97.4
경상남도,창원시의창구,45~49세,2017,23661,11357,12304,92.3,23229,11117,12112,91.8
경상남도,창원시의창구,45세,2017,4199,2129,2070,102.9,4121,2084,2037,102.3
경상남도,창원시의창구,46세,2017,4609,2184,2425,90.1,4527,2138,2389,89.5
경상남도,창원시의창구,47세,2017,4779,2297,2482,92.5,4686,2235,2451,91.2
경상남도,창원시의창구,48세,2017,4973,2382,2591,91.9,4886,2340,2546,91.9
경상남도,창원시의창구,49세,2017,5101,2365,2736,86.4,5009,2320,2689,86.3
경상남도,창원시의창구,50~54세,2017,23522,11611,11911,97.5,23126,11386,11740,97
경상남도,창원시의창구,50세,2017,4757,2233,2524,88.5,4681,2191,2490,88
경상남도,창원시의창구,51세,2017,4776,2357,2419,97.4,4695,2303,2392,96.3
경상남도,창원시의창구,52세,2017,5001,2476,2525,98.1,4914,2429,2485,97.7
경상남도,창원시의창구,53세,2017,4249,2097,2152,97.4,4171,2055,2116,97.1
경상남도,창원시의창구,54세,2017,4739,2448,2291,106.9,4665,2408,2257,106.7
경상남도,창원시의창구,55~59세,2017,23591,12145,11446,106.1,23381,12045,11336,106.3
경상남도,창원시의창구,55세,2017,5018,2595,2423,107.1,4961,2569,2392,107.4
경상남도,창원시의창구,56세,2017,5255,2702,2553,105.8,5214,2685,2529,106.2
경상남도,창원시의창구,57세,2017,5065,2568,2497,102.8,5018,2547,2471,103.1
경상남도,창원시의창구,58세,2017,4291,2216,2075,106.8,4257,2197,2060,106.7
경상남도,창원시의창구,59세,2017,3962,2064,1898,108.7,3931,2047,1884,108.7
경상남도,창원시의창구,60~64세,2017,15957,8004,7953,100.6,15831,7940,7891,100.6
경상남도,창원시의창구,60세,2017,3765,1871,1894,98.8,3731,1850,1881,98.4
경상남도,창원시의창구,61세,2017,3522,1747,1775,98.4,3497,1736,1761,98.6
경상남도,창원시의창구,62세,2017,3375,1676,1699,98.6,3349,1664,1685,98.8
경상남도,창원시의창구,63세,2017,2825,1446,1379,104.9,2808,1439,1369,105.1
경상남도,창원시의창구,64세,2017,2470,1264,1206,104.8,2446,1251,1195,104.7
경상남도,창원시의창구,65~69세,2017,9861,5080,4781,106.3,9775,5038,4737,106.4
경상남도,창원시의창구,65세,2017,2539,1318,1221,107.9,2517,1308,1209,108.2
경상남도,창원시의창구,66세,2017,1926,972,954,101.9,1906,963,943,102.1
경상남도,창원시의창구,67세,2017,1842,961,881,109.1,1822,949,873,108.7
경상남도,창원시의창구,68세,2017,1821,942,879,107.2,1806,938,868,108.1
경상남도,창원시의창구,69세,2017,1733,887,846,104.8,1724,880,844,104.3
경상남도,창원시의창구,70~74세,2017,6075,2908,3167,91.8,6053,2903,3150,92.2
경상남도,창원시의창구,70세,2017,1577,784,793,98.9,1568,782,786,99.5
경상남도,창원시의창구,71세,2017,1100,559,541,103.3,1095,558,537,103.9
경상남도,창원시의창구,72세,2017,1074,511,563,90.8,1073,510,563,90.6
경상남도,창원시의창구,73세,2017,1125,522,603,86.6,1121,521,600,86.8
경상남도,창원시의창구,74세,2017,1199,532,667,79.8,1196,532,664,80.1
경상남도,창원시의창구,75~79세,2017,4967,1936,3031,63.9,4952,1931,3021,63.9
경상남도,창원시의창구,75세,2017,1247,531,716,74.2,1245,530,715,74.1
경상남도,창원시의창구,76세,2017,1031,422,609,69.3,1026,420,606,69.3
경상남도,창원시의창구,77세,2017,996,380,616,61.7,994,380,614,61.9
경상남도,창원시의창구,78세,2017,902,322,580,55.5,900,321,579,55.4
경상남도,창원시의창구,79세,2017,791,281,510,55.1,787,280,507,55.2
경상남도,창원시의창구,80~84세,2017,3321,1028,2293,44.8,3315,1026,2289,44.8
경상남도,창원시의창구,80세,2017,783,257,526,48.9,782,257,525,49
경상남도,창원시의창구,81세,2017,695,241,454,53.1,692,240,452,53.1
경상남도,창원시의창구,82세,2017,766,260,506,51.4,765,260,505,51.5
경상남도,창원시의창구,83세,2017,597,141,456,30.9,597,141,456,30.9
경상남도,창원시의창구,84세,2017,480,129,351,36.8,479,128,351,36.5
경상남도,창원시의창구,85세이상,2017,2193,457,1736,26.3,2189,456,1733,26.3
경상남도,창원시의창구,85~89세,2017,1614,353,1261,28,1612,353,1259,28
경상남도,창원시의창구,85세,2017,486,110,376,29.3,485,110,375,29.3
경상남도,창원시의창구,86세,2017,351,83,268,31,351,83,268,31
경상남도,창원시의창구,87세,2017,311,63,248,25.4,310,63,247,25.5
경상남도,창원시의창구,88세,2017,265,58,207,28,265,58,207,28
경상남도,창원시의창구,89세,2017,201,39,162,24.1,201,39,162,24.1
경상남도,창원시의창구,90~94세,2017,478,92,386,23.8,476,91,385,23.6
경상남도,창원시의창구,90세,2017,164,27,137,19.7,164,27,137,19.7
경상남도,창원시의창구,91세,2017,110,22,88,25,109,21,88,23.9
경상남도,창원시의창구,92세,2017,104,26,78,33.3,104,26,78,33.3
경상남도,창원시의창구,93세,2017,46,8,38,21.1,45,8,37,21.6
경상남도,창원시의창구,94세,2017,54,9,45,20,54,9,45,20
경상남도,창원시의창구,95~99세,2017,88,11,77,14.3,88,11,77,14.3
경상남도,창원시의창구,95세,2017,42,6,36,16.7,42,6,36,16.7
경상남도,창원시의창구,96세,2017,15,X,14,7.1,15,X,14,7.1
경상남도,창원시의창구,97세,2017,18,X,17,5.9,18,X,17,5.9
경상남도,창원시의창구,98세,2017,5,X,X,25,5,X,X,25
경상남도,창원시의창구,99세,2017,8,X,6,33.3,8,X,6,33.3
경상남도,창원시의창구,100세이상,2017,13,X,12,8.3,13,X,12,8.3
경상남도,창원시의창구,15세미만,2017,31654,16458,15196,108.3,31558,16407,15151,108.3
경상남도,창원시의창구,15~64세,2017,192489,100314,92175,108.8,187884,97410,90474,107.7
경상남도,창원시의창구,65세이상,2017,26417,11409,15008,76,26284,11354,14930,76
경상남도,창원시의창구,평균연령,2017,40.4,39.2,41.7,,40.5,39.3,41.7,
경상남도,창원시의창구,중위연령,2017,41.9,40,43.8,,42.2,40.3,43.9,
경상남도,창원시성산구,합계,2017,226726,118239,108487,109,221789,114631,107158,107
경상남도,창원시성산구,0~4세,2017,9178,4684,4494,104.2,9136,4664,4472,104.3
경상남도,창원시성산구,0세,2017,1589,823,766,107.4,1579,820,759,108
경상남도,창원시성산구,1세,2017,1834,928,906,102.4,1826,923,903,102.2
경상남도,창원시성산구,2세,2017,1925,993,932,106.5,1918,991,927,106.9
경상남도,창원시성산구,3세,2017,1892,958,934,102.6,1881,953,928,102.7
경상남도,창원시성산구,4세,2017,1938,982,956,102.7,1932,977,955,102.3
경상남도,창원시성산구,5~9세,2017,10643,5497,5146,106.8,10626,5489,5137,106.9
경상남도,창원시성산구,5세,2017,2190,1120,1070,104.7,2186,1118,1068,104.7
경상남도,창원시성산구,6세,2017,2126,1091,1035,105.4,2124,1090,1034,105.4
경상남도,창원시성산구,7세,2017,2043,1055,988,106.8,2039,1052,987,106.6
경상남도,창원시성산구,8세,2017,2055,1095,960,114.1,2050,1094,956,114.4
경상남도,창원시성산구,9세,2017,2229,1136,1093,103.9,2227,1135,1092,103.9
경상남도,창원시성산구,10~14세,2017,11780,6294,5486,114.7,11763,6285,5478,114.7
경상남도,창원시성산구,10세,2017,2346,1267,1079,117.4,2343,1264,1079,117.1
경상남도,창원시성산구,11세,2017,2168,1159,1009,114.9,2166,1158,1008,114.9
경상남도,창원시성산구,12세,2017,2220,1174,1046,112.2,2218,1173,1045,112.2
경상남도,창원시성산구,13세,2017,2420,1274,1146,111.2,2415,1273,1142,111.5
경상남도,창원시성산구,14세,2017,2626,1420,1206,117.7,2621,1417,1204,117.7
경상남도,창원시성산구,15~19세,2017,15125,8427,6698,125.8,15090,8411,6679,125.9
경상남도,창원시성산구,15세,2017,2741,1422,1319,107.8,2738,1422,1316,108.1
경상남도,창원시성산구,16세,2017,3175,1728,1447,119.4,3171,1725,1446,119.3
경상남도,창원시성산구,17세,2017,3632,2091,1541,135.7,3628,2088,1540,135.6
경상남도,창원시성산구,18세,2017,3167,1772,1395,127,3161,1769,1392,127.1
경상남도,창원시성산구,19세,2017,2410,1414,996,142,2392,1407,985,142.8
경상남도,창원시성산구,20~24세,2017,16182,9464,6718,140.9,15828,9207,6621,139.1
경상남도,창원시성산구,20세,2017,2913,1818,1095,166,2893,1805,1088,165.9
경상남도,창원시성산구,21세,2017,3373,2096,1277,164.1,3328,2068,1260,164.1
경상남도,창원시성산구,22세,2017,3172,1850,1322,139.9,3105,1799,1306,137.7
경상남도,창원시성산구,23세,2017,3324,1835,1489,123.2,3240,1774,1466,121
경상남도,창원시성산구,24세,2017,3400,1865,1535,121.5,3262,1761,1501,117.3
경상남도,창원시성산구,25~29세,2017,17875,10230,7645,133.8,16724,9300,7424,125.3
경상남도,창원시성산구,25세,2017,3624,1989,1635,121.7,3453,1864,1589,117.3
경상남도,창원시성산구,26세,2017,3644,2017,1627,124,3416,1833,1583,115.8
경상남도,창원시성산구,27세,2017,3572,2096,1476,142,3352,1915,1437,133.3
경상남도,창원시성산구,28세,2017,3550,2081,1469,141.7,3292,1871,1421,131.7
경상남도,창원시성산구,29세,2017,3485,2047,1438,142.4,3211,1817,1394,130.3
경상남도,창원시성산구,30~34세,2017,17052,9894,7158,138.2,15830,8904,6926,128.6
경상남도,창원시성산구,30세,2017,3560,2117,1443,146.7,3286,1898,1388,136.7
경상남도,창원시성산구,31세,2017,3395,2007,1388,144.6,3119,1787,1332,134.2
경상남도,창원시성산구,32세,2017,3351,1996,1355,147.3,3090,1781,1309,136.1
경상남도,창원시성산구,33세,2017,3254,1843,1411,130.6,3043,1669,1374,121.5
경상남도,창원시성산구,34세,2017,3492,1931,1561,123.7,3292,1769,1523,116.2
경상남도,창원시성산구,35~39세,2017,17264,8866,8398,105.6,16571,8331,8240,101.1
경상남도,창원시성산구,35세,2017,3479,1808,1671,108.2,3307,1674,1633,102.5
경상남도,창원시성산구,36세,2017,3519,1850,1669,110.8,3358,1730,1628,106.3
경상남도,창원시성산구,37세,2017,3573,1802,1771,101.8,3450,1711,1739,98.4
경상남도,창원시성산구,38세,2017,3468,1763,1705,103.4,3335,1655,1680,98.5
경상남도,창원시성산구,39세,2017,3225,1643,1582,103.9,3121,1561,1560,100.1
경상남도,창원시성산구,40~44세,2017,18373,8701,9672,90,17977,8429,9548,88.3
경상남도,창원시성산구,40세,2017,3358,1653,1705,97,3262,1584,1678,94.4
경상남도,창원시성산구,41세,2017,3307,1605,1702,94.3,3245,1562,1683,92.8
경상남도,창원시성산구,42세,2017,3482,1614,1868,86.4,3399,1560,1839,84.8
경상남도,창원시성산구,43세,2017,3989,1869,2120,88.2,3909,1817,2092,86.9
경상남도,창원시성산구,44세,2017,4237,1960,2277,86.1,4162,1906,2256,84.5
경상남도,창원시성산구,45~49세,2017,24227,11438,12789,89.4,23848,11195,12653,88.5
경상남도,창원시성산구,45세,2017,4359,2101,2258,93,4281,2044,2237,91.4
경상남도,창원시성산구,46세,2017,4857,2310,2547,90.7,4778,2259,2519,89.7
경상남도,창원시성산구,47세,2017,4955,2345,2610,89.8,4871,2296,2575,89.2
경상남도,창원시성산구,48세,2017,4981,2321,2660,87.3,4900,2265,2635,86
경상남도,창원시성산구,49세,2017,5075,2361,2714,87,5018,2331,2687,86.8
경상남도,창원시성산구,50~54세,2017,22831,11287,11544,97.8,22547,11128,11419,97.5
경상남도,창원시성산구,50세,2017,4608,2165,2443,88.6,4555,2133,2422,88.1
경상남도,창원시성산구,51세,2017,4612,2316,2296,100.9,4561,2289,2272,100.7
경상남도,창원시성산구,52세,2017,4822,2363,2459,96.1,4764,2331,2433,95.8
경상남도,창원시성산구,53세,2017,4169,2061,2108,97.8,4112,2028,2084,97.3
경상남도,창원시성산구,54세,2017,4620,2382,2238,106.4,4555,2347,2208,106.3
경상남도,창원시성산구,55~59세,2017,20985,11290,9695,116.5,20813,11206,9607,116.6
경상남도,창원시성산구,55세,2017,4642,2389,2253,106,4596,2366,2230,106.1
경상남도,창원시성산구,56세,2017,4832,2472,2360,104.7,4801,2457,2344,104.8
경상남도,창원시성산구,57세,2017,4603,2492,2111,118,4566,2476,2090,118.5
경상남도,창원시성산구,58세,2017,3657,2085,1572,132.6,3627,2072,1555,133.2
경상남도,창원시성산구,59세,2017,3251,1852,1399,132.4,3223,1835,1388,132.2
경상남도,창원시성산구,60~64세,2017,11110,5932,5178,114.6,11009,5882,5127,114.7
경상남도,창원시성산구,60세,2017,2827,1539,1288,119.5,2801,1522,1279,119
경상남도,창원시성산구,61세,2017,2463,1261,1202,104.9,2437,1249,1188,105.1
경상남도,창원시성산구,62세,2017,2370,1229,1141,107.7,2350,1221,1129,108.1
경상남도,창원시성산구,63세,2017,1800,997,803,124.2,1787,992,795,124.8
경상남도,창원시성산구,64세,2017,1650,906,744,121.8,1634,898,736,122
경상남도,창원시성산구,65~69세,2017,5800,3085,2715,113.6,5767,3070,2697,113.8
경상남도,창원시성산구,65세,2017,1530,850,680,125,1522,846,676,125.1
경상남도,창원시성산구,66세,2017,1216,646,570,113.3,1205,639,566,112.9
경상남도,창원시성산구,67세,2017,1050,590,460,128.3,1043,588,455,129.2
경상남도,창원시성산구,68세,2017,1044,518,526,98.5,1040,516,524,98.5
경상남도,창원시성산구,69세,2017,960,481,479,100.4,957,481,476,101.1
경상남도,창원시성산구,70~74세,2017,3193,1523,1670,91.2,3170,1511,1659,91.1
경상남도,창원시성산구,70세,2017,905,475,430,110.5,899,471,428,110
경상남도,창원시성산구,71세,2017,613,303,310,97.7,608,300,308,97.4
경상남도,창원시성산구,72세,2017,543,265,278,95.3,540,264,276,95.7
경상남도,창원시성산구,73세,2017,563,237,326,72.7,558,233,325,71.7
경상남도,창원시성산구,74세,2017,569,243,326,74.5,565,243,322,75.5
경상남도,창원시성산구,75~79세,2017,2508,954,1554,61.4,2499,950,1549,61.3
경상남도,창원시성산구,75세,2017,614,262,352,74.4,613,262,351,74.6
경상남도,창원시성산구,76세,2017,512,202,310,65.2,511,201,310,64.8
경상남도,창원시성산구,77세,2017,495,172,323,53.3,491,170,321,53
경상남도,창원시성산구,78세,2017,476,161,315,51.1,476,161,315,51.1
경상남도,창원시성산구,79세,2017,411,157,254,61.8,408,156,252,61.9
경상남도,창원시성산구,80~84세,2017,1614,473,1141,41.5,1609,470,1139,41.3
경상남도,창원시성산구,80세,2017,377,122,255,47.8,376,122,254,48
경상남도,창원시성산구,81세,2017,353,104,249,41.8,353,104,249,41.8
경상남도,창원시성산구,82세,2017,354,100,254,39.4,353,99,254,39
경상남도,창원시성산구,83세,2017,288,75,213,35.2,287,74,213,34.7
경상남도,창원시성산구,84세,2017,242,72,170,42.4,240,71,169,42
경상남도,창원시성산구,85세이상,2017,986,200,786,25.4,982,199,783,25.4
경상남도,창원시성산구,85~89세,2017,733,148,585,25.3,730,147,583,25.2
경상남도,창원시성산구,85세,2017,203,36,167,21.6,203,36,167,21.6
경상남도,창원시성산구,86세,2017,156,35,121,28.9,156,35,121,28.9
경상남도,창원시성산구,87세,2017,149,25,124,20.2,148,25,123,20.3
경상남도,창원시성산구,88세,2017,133,33,100,33,132,32,100,32
경상남도,창원시성산구,89세,2017,92,19,73,26,91,19,72,26.4
경상남도,창원시성산구,90~94세,2017,220,48,172,27.9,219,48,171,28.1
경상남도,창원시성산구,90세,2017,69,19,50,38,69,19,50,38
경상남도,창원시성산구,91세,2017,46,6,40,15,46,6,40,15
경상남도,창원시성산구,92세,2017,46,12,34,35.3,45,12,33,36.4
경상남도,창원시성산구,93세,2017,34,7,27,25.9,34,7,27,25.9
경상남도,창원시성산구,94세,2017,25,X,21,19,25,X,21,19
경상남도,창원시성산구,95~99세,2017,31,X,27,14.8,31,X,27,14.8
경상남도,창원시성산구,95세,2017,16,X,15,6.7,16,X,15,6.7
경상남도,창원시성산구,96세,2017,X,X,X,33.3,X,X,X,33.3
경상남도,창원시성산구,97세,2017,X,X,X,0,X,X,X,0
경상남도,창원시성산구,98세,2017,6,X,5,20,6,X,5,20
경상남도,창원시성산구,99세,2017,X,X,X,50,X,X,X,50
경상남도,창원시성산구,100세이상,2017,X,X,X,0,X,X,X,0
경상남도,창원시성산구,15세미만,2017,31601,16475,15126,108.9,31525,16438,15087,109
경상남도,창원시성산구,15~64세,2017,181024,95529,85495,111.7,176237,91993,84244,109.2
경상남도,창원시성산구,65세이상,2017,14101,6235,7866,79.3,14027,6200,7827,79.2
경상남도,창원시성산구,평균연령,2017,38.1,37.2,39.1,,38.1,37.3,39.1,
경상남도,창원시성산구,중위연령,2017,39.5,37.5,41.5,,39.8,38,41.5,
경상남도,창원시마산합포구,합계,2017,178751,89417,89334,100.1,176168,87852,88316,99.5
경상남도,창원시마산합포구,0~4세,2017,6874,3593,3281,109.5,6857,3587,3270,109.7
경상남도,창원시마산합포구,0세,2017,1176,618,558,110.8,1172,617,555,111.2
경상남도,창원시마산합포구,1세,2017,1357,721,636,113.4,1355,721,634,113.7
경상남도,창원시마산합포구,2세,2017,1409,719,690,104.2,1403,717,686,104.5
경상남도,창원시마산합포구,3세,2017,1444,764,680,112.4,1440,761,679,112.1
경상남도,창원시마산합포구,4세,2017,1488,771,717,107.5,1487,771,716,107.7
경상남도,창원시마산합포구,5~9세,2017,7141,3664,3477,105.4,7135,3663,3472,105.5
경상남도,창원시마산합포구,5세,2017,1591,833,758,109.9,1589,833,756,110.2
경상남도,창원시마산합포구,6세,2017,1520,757,763,99.2,1520,757,763,99.2
경상남도,창원시마산합포구,7세,2017,1345,682,663,102.9,1345,682,663,102.9
경상남도,창원시마산합포구,8세,2017,1354,711,643,110.6,1351,710,641,110.8
경상남도,창원시마산합포구,9세,2017,1331,681,650,104.8,1330,681,649,104.9
경상남도,창원시마산합포구,10~14세,2017,6586,3412,3174,107.5,6577,3408,3169,107.5
경상남도,창원시마산합포구,10세,2017,1401,714,687,103.9,1399,713,686,103.9
경상남도,창원시마산합포구,11세,2017,1257,637,620,102.7,1254,635,619,102.6
경상남도,창원시마산합포구,12세,2017,1206,636,570,111.6,1205,636,569,111.8
경상남도,창원시마산합포구,13세,2017,1350,690,660,104.5,1349,690,659,104.7
경상남도,창원시마산합포구,14세,2017,1372,735,637,115.4,1370,734,636,115.4
경상남도,창원시마산합포구,15~19세,2017,9379,4917,4462,110.2,9315,4883,4432,110.2
경상남도,창원시마산합포구,15세,2017,1471,722,749,96.4,1467,722,745,96.9
경상남도,창원시마산합포구,16세,2017,1695,878,817,107.5,1693,877,816,107.5
경상남도,창원시마산합포구,17세,2017,1921,978,943,103.7,1913,975,938,103.9
경상남도,창원시마산합포구,18세,2017,2003,1045,958,109.1,1983,1031,952,108.3
경상남도,창원시마산합포구,19세,2017,2289,1294,995,130.1,2259,1278,981,130.3
경상남도,창원시마산합포구,20~24세,2017,11234,6316,4918,128.4,10862,6145,4717,130.3
경상남도,창원시마산합포구,20세,2017,2155,1182,973,121.5,2099,1166,933,125
경상남도,창원시마산합포구,21세,2017,2271,1280,991,129.2,2203,1257,946,132.9
경상남도,창원시마산합포구,22세,2017,2406,1342,1064,126.1,2306,1298,1008,128.8
경상남도,창원시마산합포구,23세,2017,2253,1269,984,129,2190,1233,957,128.8
경상남도,창원시마산합포구,24세,2017,2149,1243,906,137.2,2064,1191,873,136.4
경상남도,창원시마산합포구,25~29세,2017,9779,5492,4287,128.1,9288,5180,4108,126.1
경상남도,창원시마산합포구,25세,2017,2138,1204,934,128.9,2058,1153,905,127.4
경상남도,창원시마산합포구,26세,2017,1977,1129,848,133.1,1877,1062,815,130.3
경상남도,창원시마산합포구,27세,2017,1924,1061,863,122.9,1823,1004,819,122.6
경상남도,창원시마산합포구,28세,2017,1924,1086,838,129.6,1818,1015,803,126.4
경상남도,창원시마산합포구,29세,2017,1816,1012,804,125.9,1712,946,766,123.5
경상남도,창원시마산합포구,30~34세,2017,10773,5830,4943,117.9,10309,5494,4815,114.1
경상남도,창원시마산합포구,30세,2017,1921,1019,902,113,1835,959,876,109.5
경상남도,창원시마산합포구,31세,2017,1995,1102,893,123.4,1892,1031,861,119.7
경상남도,창원시마산합포구,32세,2017,2170,1186,984,120.5,2066,1107,959,115.4
경상남도,창원시마산합포구,33세,2017,2207,1202,1005,119.6,2121,1139,982,116
경상남도,창원시마산합포구,34세,2017,2480,1321,1159,114,2395,1258,1137,110.6
경상남도,창원시마산합포구,35~39세,2017,13650,7299,6351,114.9,13354,7093,6261,113.3
경상남도,창원시마산합포구,35세,2017,2795,1465,1330,110.2,2727,1418,1309,108.3
경상남도,창원시마산합포구,36세,2017,2855,1595,1260,126.6,2785,1548,1237,125.1
경상남도,창원시마산합포구,37세,2017,2928,1511,1417,106.6,2860,1461,1399,104.4
경상남도,창원시마산합포구,38세,2017,2699,1430,1269,112.7,2662,1408,1254,112.3
경상남도,창원시마산합포구,39세,2017,2373,1298,1075,120.7,2320,1258,1062,118.5
경상남도,창원시마산합포구,40~44세,2017,12282,6587,5695,115.7,12029,6414,5615,114.2
경상남도,창원시마산합포구,40세,2017,2351,1302,1049,124.1,2284,1253,1031,121.5
경상남도,창원시마산합포구,41세,2017,2228,1201,1027,116.9,2177,1161,1016,114.3
경상남도,창원시마산합포구,42세,2017,2471,1330,1141,116.6,2420,1292,1128,114.5
경상남도,창원시마산합포구,43세,2017,2545,1343,1202,111.7,2499,1319,1180,111.8
경상남도,창원시마산합포구,44세,2017,2687,1411,1276,110.6,2649,1389,1260,110.2
경상남도,창원시마산합포구,45~49세,2017,14066,7100,6966,101.9,13858,6978,6880,101.4
경상남도,창원시마산합포구,45세,2017,2529,1335,1194,111.8,2477,1298,1179,110.1
경상남도,창원시마산합포구,46세,2017,2811,1405,1406,99.9,2764,1373,1391,98.7
경상남도,창원시마산합포구,47세,2017,2832,1452,1380,105.2,2795,1440,1355,106.3
경상남도,창원시마산합포구,48세,2017,2918,1454,1464,99.3,2891,1441,1450,99.4
경상남도,창원시마산합포구,49세,2017,2976,1454,1522,95.5,2931,1426,1505,94.8
경상남도,창원시마산합포구,50~54세,2017,13701,6806,6895,98.7,13529,6721,6808,98.7
경상남도,창원시마산합포구,50세,2017,2716,1360,1356,100.3,2687,1343,1344,99.9
경상남도,창원시마산합포구,51세,2017,2714,1397,1317,106.1,2679,1378,1301,105.9
경상남도,창원시마산합포구,52세,2017,2842,1395,1447,96.4,2813,1381,1432,96.4
경상남도,창원시마산합포구,53세,2017,2553,1266,1287,98.4,2511,1248,1263,98.8
경상남도,창원시마산합포구,54세,2017,2876,1388,1488,93.3,2839,1371,1468,93.4
경상남도,창원시마산합포구,55~59세,2017,16922,8002,8920,89.7,16827,7951,8876,89.6
경상남도,창원시마산합포구,55세,2017,3213,1557,1656,94,3188,1544,1644,93.9
경상남도,창원시마산합포구,56세,2017,3541,1650,1891,87.3,3527,1642,1885,87.1
경상남도,창원시마산합포구,57세,2017,3549,1657,1892,87.6,3522,1643,1879,87.4
경상남도,창원시마산합포구,58세,2017,3421,1602,1819,88.1,3403,1594,1809,88.1
경상남도,창원시마산합포구,59세,2017,3198,1536,1662,92.4,3187,1528,1659,92.1
경상남도,창원시마산합포구,60~64세,2017,14840,7117,7723,92.2,14758,7077,7681,92.1
경상남도,창원시마산합포구,60세,2017,3197,1544,1653,93.4,3172,1532,1640,93.4
경상남도,창원시마산합포구,61세,2017,3155,1471,1684,87.4,3139,1463,1676,87.3
경상남도,창원시마산합포구,62세,2017,3330,1573,1757,89.5,3315,1565,1750,89.4
경상남도,창원시마산합포구,63세,2017,2782,1397,1385,100.9,2767,1389,1378,100.8
경상남도,창원시마산합포구,64세,2017,2376,1132,1244,91,2365,1128,1237,91.2
경상남도,창원시마산합포구,65~69세,2017,10929,5281,5648,93.5,10903,5268,5635,93.5
경상남도,창원시마산합포구,65세,2017,2603,1242,1361,91.3,2594,1238,1356,91.3
경상남도,창원시마산합포구,66세,2017,2005,962,1043,92.2,2000,960,1040,92.3
경상남도,창원시마산합포구,67세,2017,2122,1016,1106,91.9,2116,1012,1104,91.7
경상남도,창원시마산합포구,68세,2017,2167,1072,1095,97.9,2162,1069,1093,97.8
경상남도,창원시마산합포구,69세,2017,2032,989,1043,94.8,2031,989,1042,94.9
경상남도,창원시마산합포구,70~74세,2017,7738,3453,4285,80.6,7721,3446,4275,80.6
경상남도,창원시마산합포구,70세,2017,1923,870,1053,82.6,1916,868,1048,82.8
경상남도,창원시마산합포구,71세,2017,1402,644,758,85,1401,644,757,85.1
경상남도,창원시마산합포구,72세,2017,1446,646,800,80.8,1441,643,798,80.6
경상남도,창원시마산합포구,73세,2017,1503,675,828,81.5,1500,673,827,81.4
경상남도,창원시마산합포구,74세,2017,1464,618,846,73,1463,618,845,73.1
경상남도,창원시마산합포구,75~79세,2017,6390,2639,3751,70.4,6385,2636,3749,70.3
경상남도,창원시마산합포구,75세,2017,1575,705,870,81,1575,705,870,81
경상남도,창원시마산합포구,76세,2017,1444,609,835,72.9,1444,609,835,72.9
경상남도,창원시마산합포구,77세,2017,1227,502,725,69.2,1224,499,725,68.8
경상남도,창원시마산합포구,78세,2017,1151,437,714,61.2,1151,437,714,61.2
경상남도,창원시마산합포구,79세,2017,993,386,607,63.6,991,386,605,63.8
경상남도,창원시마산합포구,80~84세,2017,3907,1301,2606,49.9,3904,1301,2603,50
경상남도,창원시마산합포구,80세,2017,1010,362,648,55.9,1008,362,646,56
경상남도,창원시마산합포구,81세,2017,900,303,597,50.8,900,303,597,50.8
경상남도,창원시마산합포구,82세,2017,741,257,484,53.1,741,257,484,53.1
경상남도,창원시마산합포구,83세,2017,695,225,470,47.9,694,225,469,48
경상남도,창원시마산합포구,84세,2017,561,154,407,37.8,561,154,407,37.8
경상남도,창원시마산합포구,85세이상,2017,2560,608,1952,31.1,2557,607,1950,31.1
경상남도,창원시마산합포구,85~89세,2017,1901,482,1419,34,1901,482,1419,34
경상남도,창원시마산합포구,85세,2017,545,165,380,43.4,545,165,380,43.4
경상남도,창원시마산합포구,86세,2017,423,100,323,31,423,100,323,31
경상남도,창원시마산합포구,87세,2017,400,86,314,27.4,400,86,314,27.4
경상남도,창원시마산합포구,88세,2017,314,86,228,37.7,314,86,228,37.7
경상남도,창원시마산합포구,89세,2017,219,45,174,25.9,219,45,174,25.9
경상남도,창원시마산합포구,90~94세,2017,550,107,443,24.2,548,107,441,24.3
경상남도,창원시마산합포구,90세,2017,170,41,129,31.8,170,41,129,31.8
경상남도,창원시마산합포구,91세,2017,132,29,103,28.2,132,29,103,28.2
경상남도,창원시마산합포구,92세,2017,113,13,100,13,111,13,98,13.3
경상남도,창원시마산합포구,93세,2017,68,14,54,25.9,68,14,54,25.9
경상남도,창원시마산합포구,94세,2017,67,10,57,17.5,67,10,57,17.5
경상남도,창원시마산합포구,95~99세,2017,96,19,77,24.7,95,18,77,23.4
경상남도,창원시마산합포구,95세,2017,40,9,31,29,40,9,31,29
경상남도,창원시마산합포구,96세,2017,27,X,24,12.5,26,X,24,8.3
경상남도,창원시마산합포구,97세,2017,13,X,12,8.3,13,X,12,8.3
경상남도,창원시마산합포구,98세,2017,10,5,5,100,10,5,5,100
경상남도,창원시마산합포구,99세,2017,6,X,5,20,6,X,5,20
경상남도,창원시마산합포구,100세이상,2017,13,X,13,0,13,X,13,0
경상남도,창원시마산합포구,15세미만,2017,20601,10669,9932,107.4,20569,10658,9911,107.5
경상남도,창원시마산합포구,15~64세,2017,126626,65466,61160,107,124129,63936,60193,106.2
경상남도,창원시마산합포구,65세이상,2017,31524,13282,18242,72.8,31470,13258,18212,72.8
경상남도,창원시마산합포구,평균연령,2017,43.9,42.2,45.7,,44,42.3,45.8,
경상남도,창원시마산합포구,중위연령,2017,45.7,43.3,48.1,,46,43.6,48.3,
경상남도,창원시마산회원구,합계,2017,202864,101910,100954,100.9,200094,100275,99819,100.5
경상남도,창원시마산회원구,0~4세,2017,7391,3806,3585,106.2,7372,3796,3576,106.2
경상남도,창원시마산회원구,0세,2017,1187,605,582,104,1182,603,579,104.1
경상남도,창원시마산회원구,1세,2017,1401,703,698,100.7,1395,701,694,101
경상남도,창원시마산회원구,2세,2017,1581,814,767,106.1,1577,811,766,105.9
경상남도,창원시마산회원구,3세,2017,1581,842,739,113.9,1578,840,738,113.8
경상남도,창원시마산회원구,4세,2017,1641,842,799,105.4,1640,841,799,105.3
경상남도,창원시마산회원구,5~9세,2017,9117,4787,4330,110.6,9103,4780,4323,110.6
경상남도,창원시마산회원구,5세,2017,1861,971,890,109.1,1854,967,887,109
경상남도,창원시마산회원구,6세,2017,1844,998,846,118,1844,998,846,118
경상남도,창원시마산회원구,7세,2017,1797,922,875,105.4,1794,920,874,105.3
경상남도,창원시마산회원구,8세,2017,1740,948,792,119.7,1738,948,790,120
경상남도,창원시마산회원구,9세,2017,1875,948,927,102.3,1873,947,926,102.3
경상남도,창원시마산회원구,10~14세,2017,9451,4961,4490,110.5,9447,4959,4488,110.5
경상남도,창원시마산회원구,10세,2017,1939,1047,892,117.4,1937,1046,891,117.4
경상남도,창원시마산회원구,11세,2017,1799,948,851,111.4,1797,947,850,111.4
경상남도,창원시마산회원구,12세,2017,1785,892,893,99.9,1785,892,893,99.9
경상남도,창원시마산회원구,13세,2017,1935,988,947,104.3,1935,988,947,104.3
경상남도,창원시마산회원구,14세,2017,1993,1086,907,119.7,1993,1086,907,119.7
경상남도,창원시마산회원구,15~19세,2017,11347,5971,5376,111.1,11305,5945,5360,110.9
경상남도,창원시마산회원구,15세,2017,1960,1045,915,114.2,1960,1045,915,114.2
경상남도,창원시마산회원구,16세,2017,2141,1151,990,116.3,2138,1149,989,116.2
경상남도,창원시마산회원구,17세,2017,2399,1272,1127,112.9,2389,1267,1122,112.9
경상남도,창원시마산회원구,18세,2017,2366,1236,1130,109.4,2356,1228,1128,108.9
경상남도,창원시마산회원구,19세,2017,2481,1267,1214,104.4,2462,1256,1206,104.1
경상남도,창원시마산회원구,20~24세,2017,13173,7002,6171,113.5,12919,6874,6045,113.7
경상남도,창원시마산회원구,20세,2017,2789,1437,1352,106.3,2760,1423,1337,106.4
경상남도,창원시마산회원구,21세,2017,2732,1500,1232,121.8,2693,1476,1217,121.3
경상남도,창원시마산회원구,22세,2017,2540,1334,1206,110.6,2481,1307,1174,111.3
경상남도,창원시마산회원구,23세,2017,2527,1358,1169,116.2,2472,1339,1133,118.2
경상남도,창원시마산회원구,24세,2017,2585,1373,1212,113.3,2513,1329,1184,112.2
경상남도,창원시마산회원구,25~29세,2017,11637,6347,5290,120,11069,5981,5088,117.6
경상남도,창원시마산회원구,25세,2017,2543,1385,1158,119.6,2465,1344,1121,119.9
경상남도,창원시마산회원구,26세,2017,2366,1289,1077,119.7,2249,1211,1038,116.7
경상남도,창원시마산회원구,27세,2017,2335,1287,1048,122.8,2192,1189,1003,118.5
경상남도,창원시마산회원구,28세,2017,2250,1221,1029,118.7,2126,1137,989,115
경상남도,창원시마산회원구,29세,2017,2143,1165,978,119.1,2037,1100,937,117.4
경상남도,창원시마산회원구,30~34세,2017,11687,6245,5442,114.8,11149,5895,5254,112.2
경상남도,창원시마산회원구,30세,2017,2188,1150,1038,110.8,2057,1066,991,107.6
경상남도,창원시마산회원구,31세,2017,2117,1151,966,119.2,1987,1061,926,114.6
경상남도,창원시마산회원구,32세,2017,2219,1173,1046,112.1,2118,1110,1008,110.1
경상남도,창원시마산회원구,33세,2017,2458,1329,1129,117.7,2355,1263,1092,115.7
경상남도,창원시마산회원구,34세,2017,2705,1442,1263,114.2,2632,1395,1237,112.8
경상남도,창원시마산회원구,35~39세,2017,15410,8046,7364,109.3,15120,7864,7256,108.4
경상남도,창원시마산회원구,35세,2017,3047,1595,1452,109.8,2974,1553,1421,109.3
경상남도,창원시마산회원구,36세,2017,3113,1638,1475,111.1,3047,1593,1454,109.6
경상남도,창원시마산회원구,37세,2017,3241,1684,1557,108.2,3190,1653,1537,107.5
경상남도,창원시마산회원구,38세,2017,3076,1614,1462,110.4,3021,1577,1444,109.2
경상남도,창원시마산회원구,39세,2017,2933,1515,1418,106.8,2888,1488,1400,106.3
경상남도,창원시마산회원구,40~44세,2017,15711,8012,7699,104.1,15500,7879,7621,103.4
경상남도,창원시마산회원구,40세,2017,2974,1496,1478,101.2,2930,1468,1462,100.4
경상남도,창원시마산회원구,41세,2017,2826,1473,1353,108.9,2778,1440,1338,107.6
경상남도,창원시마산회원구,42세,2017,3094,1543,1551,99.5,3051,1515,1536,98.6
경상남도,창원시마산회원구,43세,2017,3374,1751,1623,107.9,3343,1734,1609,107.8
경상남도,창원시마산회원구,44세,2017,3443,1749,1694,103.2,3398,1722,1676,102.7
경상남도,창원시마산회원구,45~49세,2017,18094,9109,8985,101.4,17816,8949,8867,100.9
경상남도,창원시마산회원구,45세,2017,3271,1680,1591,105.6,3215,1646,1569,104.9
경상남도,창원시마산회원구,46세,2017,3637,1806,1831,98.6,3566,1762,1804,97.7
경상남도,창원시마산회원구,47세,2017,3647,1839,1808,101.7,3596,1812,1784,101.6
경상남도,창원시마산회원구,48세,2017,3761,1941,1820,106.6,3711,1912,1799,106.3
경상남도,창원시마산회원구,49세,2017,3778,1843,1935,95.2,3728,1817,1911,95.1
경상남도,창원시마산회원구,50~54세,2017,17112,8538,8574,99.6,16881,8416,8465,99.4
경상남도,창원시마산회원구,50세,2017,3493,1719,1774,96.9,3453,1695,1758,96.4
경상남도,창원시마산회원구,51세,2017,3572,1844,1728,106.7,3519,1818,1701,106.9
경상남도,창원시마산회원구,52세,2017,3458,1672,1786,93.6,3416,1647,1769,93.1
경상남도,창원시마산회원구,53세,2017,3127,1565,1562,100.2,3086,1542,1544,99.9
경상남도,창원시마산회원구,54세,2017,3462,1738,1724,100.8,3407,1714,1693,101.2
경상남도,창원시마산회원구,55~59세,2017,18960,9300,9660,96.3,18815,9229,9586,96.3
경상남도,창원시마산회원구,55세,2017,3889,1926,1963,98.1,3849,1903,1946,97.8
경상남도,창원시마산회원구,56세,2017,4081,2073,2008,103.2,4062,2063,1999,103.2
경상남도,창원시마산회원구,57세,2017,4054,1935,2119,91.3,4020,1922,2098,91.6
경상남도,창원시마산회원구,58세,2017,3536,1720,1816,94.7,3510,1707,1803,94.7
경상남도,창원시마산회원구,59세,2017,3400,1646,1754,93.8,3374,1634,1740,93.9
경상남도,창원시마산회원구,60~64세,2017,15370,7426,7944,93.5,15265,7375,7890,93.5
경상남도,창원시마산회원구,60세,2017,3492,1684,1808,93.1,3468,1669,1799,92.8
경상남도,창원시마산회원구,61세,2017,3212,1539,1673,92,3184,1525,1659,91.9
경상남도,창원시마산회원구,62세,2017,3396,1616,1780,90.8,3379,1610,1769,91
경상남도,창원시마산회원구,63세,2017,2799,1379,1420,97.1,2776,1367,1409,97
경상남도,창원시마산회원구,64세,2017,2471,1208,1263,95.6,2458,1204,1254,96
경상남도,창원시마산회원구,65~69세,2017,11015,5254,5761,91.2,10981,5239,5742,91.2
경상남도,창원시마산회원구,65세,2017,2678,1331,1347,98.8,2672,1328,1344,98.8
경상남도,창원시마산회원구,66세,2017,2107,969,1138,85.1,2096,965,1131,85.3
경상남도,창원시마산회원구,67세,2017,2066,933,1133,82.3,2056,926,1130,81.9
경상남도,창원시마산회원구,68세,2017,2114,1002,1112,90.1,2111,1002,1109,90.4
경상남도,창원시마산회원구,69세,2017,2050,1019,1031,98.8,2046,1018,1028,99
경상남도,창원시마산회원구,70~74세,2017,7177,3404,3773,90.2,7157,3396,3761,90.3
경상남도,창원시마산회원구,70세,2017,1834,893,941,94.9,1828,890,938,94.9
경상남도,창원시마산회원구,71세,2017,1317,662,655,101.1,1314,660,654,100.9
경상남도,창원시마산회원구,72세,2017,1277,599,678,88.3,1274,598,676,88.5
경상남도,창원시마산회원구,73세,2017,1429,661,768,86.1,1423,660,763,86.5
경상남도,창원시마산회원구,74세,2017,1320,589,731,80.6,1318,588,730,80.5
경상남도,창원시마산회원구,75~79세,2017,5421,2304,3117,73.9,5412,2303,3109,74.1
경상남도,창원시마산회원구,75세,2017,1331,592,739,80.1,1330,591,739,80
경상남도,창원시마산회원구,76세,2017,1214,529,685,77.2,1214,529,685,77.2
경상남도,창원시마산회원구,77세,2017,1039,431,608,70.9,1035,431,604,71.4
경상남도,창원시마산회원구,78세,2017,990,416,574,72.5,989,416,573,72.6
경상남도,창원시마산회원구,79세,2017,847,336,511,65.8,844,336,508,66.1
경상남도,창원시마산회원구,80~84세,2017,3014,1023,1991,51.4,3007,1020,1987,51.3
경상남도,창원시마산회원구,80세,2017,730,272,458,59.4,729,272,457,59.5
경상남도,창원시마산회원구,81세,2017,698,249,449,55.5,697,249,448,55.6
경상남도,창원시마산회원구,82세,2017,637,210,427,49.2,634,209,425,49.2
경상남도,창원시마산회원구,83세,2017,521,169,352,48,520,168,352,47.7
경상남도,창원시마산회원구,84세,2017,428,123,305,40.3,427,122,305,40
경상남도,창원시마산회원구,85세이상,2017,1777,375,1402,26.7,1776,375,1401,26.8
경상남도,창원시마산회원구,85~89세,2017,1329,298,1031,28.9,1328,298,1030,28.9
경상남도,창원시마산회원구,85세,2017,377,104,273,38.1,377,104,273,38.1
경상남도,창원시마산회원구,86세,2017,310,56,254,22,310,56,254,22
경상남도,창원시마산회원구,87세,2017,245,50,195,25.6,244,50,194,25.8
경상남도,창원시마산회원구,88세,2017,233,47,186,25.3,233,47,186,25.3
경상남도,창원시마산회원구,89세,2017,164,41,123,33.3,164,41,123,33.3
경상남도,창원시마산회원구,90~94세,2017,372,65,307,21.2,372,65,307,21.2
경상남도,창원시마산회원구,90세,2017,123,23,100,23,123,23,100,23
경상남도,창원시마산회원구,91세,2017,82,12,70,17.1,82,12,70,17.1
경상남도,창원시마산회원구,92세,2017,83,13,70,18.6,83,13,70,18.6
경상남도,창원시마산회원구,93세,2017,44,11,33,33.3,44,11,33,33.3
경상남도,창원시마산회원구,94세,2017,40,6,34,17.6,40,6,34,17.6
경상남도,창원시마산회원구,95~99세,2017,71,12,59,20.3,71,12,59,20.3
경상남도,창원시마산회원구,95세,2017,27,5,22,22.7,27,5,22,22.7
경상남도,창원시마산회원구,96세,2017,19,X,15,26.7,19,X,15,26.7
경상남도,창원시마산회원구,97세,2017,14,X,13,7.7,14,X,13,7.7
경상남도,창원시마산회원구,98세,2017,5,X,5,0,5,X,5,0
경상남도,창원시마산회원구,99세,2017,6,X,X,50,6,X,X,50
경상남도,창원시마산회원구,100세이상,2017,5,X,5,0,5,X,5,0
경상남도,창원시마산회원구,15세미만,2017,25959,13554,12405,109.3,25922,13535,12387,109.3
경상남도,창원시마산회원구,15~64세,2017,148501,75996,72505,104.8,145839,74407,71432,104.2
경상남도,창원시마산회원구,65세이상,2017,28404,12360,16044,77,28333,12333,16000,77.1
경상남도,창원시마산회원구,평균연령,2017,42.1,40.9,43.3,,42.2,40.9,43.4,
경상남도,창원시마산회원구,중위연령,2017,44,42.5,45.5,,44.1,42.7,45.6,
경상남도,창원시진해구,합계,2017,186658,95782,90876,105.4,182314,92927,89387,104
경상남도,창원시진해구,0~4세,2017,10672,5562,5110,108.8,10589,5521,5068,108.9
경상남도,창원시진해구,0세,2017,1812,915,897,102,1795,905,890,101.7
경상남도,창원시진해구,1세,2017,2105,1075,1030,104.4,2086,1067,1019,104.7
경상남도,창원시진해구,2세,2017,2184,1192,992,120.2,2160,1179,981,120.2
경상남도,창원시진해구,3세,2017,2254,1150,1104,104.2,2240,1144,1096,104.4
경상남도,창원시진해구,4세,2017,2317,1230,1087,113.2,2308,1226,1082,113.3
경상남도,창원시진해구,5~9세,2017,11644,5910,5734,103.1,11621,5895,5726,103
경상남도,창원시진해구,5세,2017,2511,1305,1206,108.2,2507,1303,1204,108.2
경상남도,창원시진해구,6세,2017,2349,1182,1167,101.3,2345,1180,1165,101.3
경상남도,창원시진해구,7세,2017,2288,1209,1079,112,2283,1204,1079,111.6
경상남도,창원시진해구,8세,2017,2191,1096,1095,100.1,2185,1092,1093,99.9
경상남도,창원시진해구,9세,2017,2305,1118,1187,94.2,2301,1116,1185,94.2
경상남도,창원시진해구,10~14세,2017,10247,5401,4846,111.5,10224,5387,4837,111.4
경상남도,창원시진해구,10세,2017,2276,1174,1102,106.5,2269,1170,1099,106.5
경상남도,창원시진해구,11세,2017,2030,1094,936,116.9,2026,1092,934,116.9
경상남도,창원시진해구,12세,2017,1891,954,937,101.8,1887,952,935,101.8
경상남도,창원시진해구,13세,2017,2080,1122,958,117.1,2076,1120,956,117.2
경상남도,창원시진해구,14세,2017,1970,1057,913,115.8,1966,1053,913,115.3
경상남도,창원시진해구,15~19세,2017,9226,4842,4384,110.4,9200,4822,4378,110.1
경상남도,창원시진해구,15세,2017,1926,1020,906,112.6,1923,1017,906,112.3
경상남도,창원시진해구,16세,2017,1981,1040,941,110.5,1977,1037,940,110.3
경상남도,창원시진해구,17세,2017,2032,986,1046,94.3,2027,982,1045,94
경상남도,창원시진해구,18세,2017,1897,995,902,110.3,1890,990,900,110
경상남도,창원시진해구,19세,2017,1390,801,589,136,1383,796,587,135.6
경상남도,창원시진해구,20~24세,2017,8499,4978,3521,141.4,8209,4794,3415,140.4
경상남도,창원시진해구,20세,2017,1648,1013,635,159.5,1620,1000,620,161.3
경상남도,창원시진해구,21세,2017,1730,1044,686,152.2,1698,1027,671,153.1
경상남도,창원시진해구,22세,2017,1583,919,664,138.4,1528,889,639,139.1
경상남도,창원시진해구,23세,2017,1718,971,747,130,1660,931,729,127.7
경상남도,창원시진해구,24세,2017,1820,1031,789,130.7,1703,947,756,125.3
경상남도,창원시진해구,25~29세,2017,10173,5575,4598,121.2,9379,5035,4344,115.9
경상남도,창원시진해구,25세,2017,1991,1084,907,119.5,1855,996,859,115.9
경상남도,창원시진해구,26세,2017,1909,1036,873,118.7,1778,952,826,115.3
경상남도,창원시진해구,27세,2017,2062,1165,897,129.9,1886,1050,836,125.6
경상남도,창원시진해구,28세,2017,2067,1114,953,116.9,1888,986,902,109.3
경상남도,창원시진해구,29세,2017,2144,1176,968,121.5,1972,1051,921,114.1
경상남도,창원시진해구,30~34세,2017,13621,7286,6335,115,12721,6634,6087,109
경상남도,창원시진해구,30세,2017,2348,1267,1081,117.2,2130,1117,1013,110.3
경상남도,창원시진해구,31세,2017,2462,1337,1125,118.8,2268,1203,1065,113
경상남도,창원시진해구,32세,2017,2593,1368,1225,111.7,2410,1226,1184,103.5
경상남도,창원시진해구,33세,2017,2875,1546,1329,116.3,2719,1430,1289,110.9
경상남도,창원시진해구,34세,2017,3343,1768,1575,112.3,3194,1658,1536,107.9
경상남도,창원시진해구,35~39세,2017,18644,9782,8862,110.4,18075,9362,8713,107.4
경상남도,창원시진해구,35세,2017,3743,1970,1773,111.1,3600,1869,1731,108
경상남도,창원시진해구,36세,2017,3855,2056,1799,114.3,3751,1978,1773,111.6
경상남도,창원시진해구,37세,2017,3990,2024,1966,103,3887,1944,1943,100.1
경상남도,창원시진해구,38세,2017,3737,1958,1779,110.1,3618,1875,1743,107.6
경상남도,창원시진해구,39세,2017,3319,1774,1545,114.8,3219,1696,1523,111.4
경상남도,창원시진해구,40~44세,2017,17153,9162,7991,114.7,16743,8867,7876,112.6
경상남도,창원시진해구,40세,2017,3333,1775,1558,113.9,3253,1712,1541,111.1
경상남도,창원시진해구,41세,2017,3261,1769,1492,118.6,3166,1698,1468,115.7
경상남도,창원시진해구,42세,2017,3415,1807,1608,112.4,3357,1766,1591,111
경상남도,창원시진해구,43세,2017,3657,1932,1725,112,3567,1866,1701,109.7
경상남도,창원시진해구,44세,2017,3487,1879,1608,116.9,3400,1825,1575,115.9
경상남도,창원시진해구,45~49세,2017,15835,8531,7304,116.8,15408,8269,7139,115.8
경상남도,창원시진해구,45세,2017,3273,1756,1517,115.8,3193,1703,1490,114.3
경상남도,창원시진해구,46세,2017,3370,1821,1549,117.6,3270,1752,1518,115.4
경상남도,창원시진해구,47세,2017,3153,1674,1479,113.2,3065,1631,1434,113.7
경상남도,창원시진해구,48세,2017,3026,1673,1353,123.7,2956,1629,1327,122.8
경상남도,창원시진해구,49세,2017,3013,1607,1406,114.3,2924,1554,1370,113.4
경상남도,창원시진해구,50~54세,2017,13012,6717,6295,106.7,12677,6524,6153,106
경상남도,창원시진해구,50세,2017,2648,1360,1288,105.6,2579,1319,1260,104.7
경상남도,창원시진해구,51세,2017,2626,1359,1267,107.3,2567,1326,1241,106.8
경상남도,창원시진해구,52세,2017,2521,1297,1224,106,2454,1259,1195,105.4
경상남도,창원시진해구,53세,2017,2466,1275,1191,107.1,2392,1230,1162,105.9
경상남도,창원시진해구,54세,2017,2751,1426,1325,107.6,2685,1390,1295,107.3
경상남도,창원시진해구,55~59세,2017,13943,6802,7141,95.3,13722,6700,7022,95.4
경상남도,창원시진해구,55세,2017,2632,1336,1296,103.1,2577,1312,1265,103.7
경상남도,창원시진해구,56세,2017,2971,1438,1533,93.8,2926,1418,1508,94
경상남도,창원시진해구,57세,2017,3025,1424,1601,88.9,2987,1402,1585,88.5
경상남도,창원시진해구,58세,2017,2715,1311,1404,93.4,2667,1292,1375,94
경상남도,창원시진해구,59세,2017,2600,1293,1307,98.9,2565,1276,1289,99
경상남도,창원시진해구,60~64세,2017,11308,5593,5715,97.9,11165,5520,5645,97.8
경상남도,창원시진해구,60세,2017,2524,1237,1287,96.1,2498,1226,1272,96.4
경상남도,창원시진해구,61세,2017,2419,1198,1221,98.1,2389,1179,1210,97.4
경상남도,창원시진해구,62세,2017,2505,1188,1317,90.2,2474,1172,1302,90
경상남도,창원시진해구,63세,2017,2099,1083,1016,106.6,2074,1076,998,107.8
경상남도,창원시진해구,64세,2017,1761,887,874,101.5,1730,867,863,100.5
경상남도,창원시진해구,65~69세,2017,7798,3781,4017,94.1,7742,3757,3985,94.3
경상남도,창원시진해구,65세,2017,1910,929,981,94.7,1900,924,976,94.7
경상남도,창원시진해구,66세,2017,1486,692,794,87.2,1471,687,784,87.6
경상남도,창원시진해구,67세,2017,1435,683,752,90.8,1422,679,743,91.4
경상남도,창원시진해구,68세,2017,1542,771,771,100,1528,764,764,100
경상남도,창원시진해구,69세,2017,1425,706,719,98.2,1421,703,718,97.9
경상남도,창원시진해구,70~74세,2017,5544,2520,3024,83.3,5525,2509,3016,83.2
경상남도,창원시진해구,70세,2017,1372,639,733,87.2,1364,633,731,86.6
경상남도,창원시진해구,71세,2017,1075,532,543,98,1073,530,543,97.6
경상남도,창원시진해구,72세,2017,1015,433,582,74.4,1013,432,581,74.4
경상남도,창원시진해구,73세,2017,1049,474,575,82.4,1044,472,572,82.5
경상남도,창원시진해구,74세,2017,1033,442,591,74.8,1031,442,589,75
경상남도,창원시진해구,75~79세,2017,4692,1932,2760,70,4674,1925,2749,70
경상남도,창원시진해구,75세,2017,1172,496,676,73.4,1169,494,675,73.2
경상남도,창원시진해구,76세,2017,943,387,556,69.6,939,386,553,69.8
경상남도,창원시진해구,77세,2017,922,376,546,68.9,919,376,543,69.2
경상남도,창원시진해구,78세,2017,882,365,517,70.6,879,363,516,70.3
경상남도,창원시진해구,79세,2017,773,308,465,66.2,768,306,462,66.2
경상남도,창원시진해구,80~84세,2017,2874,995,1879,53,2869,993,1876,52.9
경상남도,창원시진해구,80세,2017,753,273,480,56.9,753,273,480,56.9
경상남도,창원시진해구,81세,2017,627,234,393,59.5,625,233,392,59.4
경상남도,창원시진해구,82세,2017,575,189,386,49,574,189,385,49.1
경상남도,창원시진해구,83세,2017,516,162,354,45.8,515,162,353,45.9
경상남도,창원시진해구,84세,2017,403,137,266,51.5,402,136,266,51.1
경상남도,창원시진해구,85세이상,2017,1773,413,1360,30.4,1771,413,1358,30.4
경상남도,창원시진해구,85~89세,2017,1317,330,987,33.4,1317,330,987,33.4
경상남도,창원시진해구,85세,2017,387,103,284,36.3,387,103,284,36.3
경상남도,창원시진해구,86세,2017,277,73,204,35.8,277,73,204,35.8
경상남도,창원시진해구,87세,2017,246,51,195,26.2,246,51,195,26.2
경상남도,창원시진해구,88세,2017,229,62,167,37.1,229,62,167,37.1
경상남도,창원시진해구,89세,2017,178,41,137,29.9,178,41,137,29.9
경상남도,창원시진해구,90~94세,2017,378,69,309,22.3,376,69,307,22.5
경상남도,창원시진해구,90세,2017,105,23,82,28,105,23,82,28
경상남도,창원시진해구,91세,2017,104,22,82,26.8,103,22,81,27.2
경상남도,창원시진해구,92세,2017,78,12,66,18.2,77,12,65,18.5
경상남도,창원시진해구,93세,2017,52,8,44,18.2,52,8,44,18.2
경상남도,창원시진해구,94세,2017,39,X,35,11.4,39,X,35,11.4
경상남도,창원시진해구,95~99세,2017,66,13,53,24.5,66,13,53,24.5
경상남도,창원시진해구,95세,2017,24,7,17,41.2,24,7,17,41.2
경상남도,창원시진해구,96세,2017,14,X,13,7.7,14,X,13,7.7
경상남도,창원시진해구,97세,2017,18,X,16,12.5,18,X,16,12.5
경상남도,창원시진해구,98세,2017,X,X,X,200,X,X,X,200
경상남도,창원시진해구,99세,2017,7,X,6,16.7,7,X,6,16.7
경상남도,창원시진해구,100세이상,2017,12,X,11,9.1,12,X,11,9.1
경상남도,창원시진해구,15세미만,2017,32563,16873,15690,107.5,32434,16803,15631,107.5
경상남도,창원시진해구,15~64세,2017,131414,69268,62146,111.5,127299,66527,60772,109.5
경상남도,창원시진해구,65세이상,2017,22681,9641,13040,73.9,22581,9597,12984,73.9
경상남도,창원시진해구,평균연령,2017,39.5,38.3,40.7,,39.5,38.4,40.7,
경상남도,창원시진해구,중위연령,2017,40.2,39.2,41.3,,40.3,39.4,41.4,
서울특별시,종로구,합계,2018,157967,77147,80820,95.5,145911,71611,74300,96.4
서울특별시,종로구,0~4세,2018,3870,1957,1913,102.3,3734,1889,1845,102.4
서울특별시,종로구,0세,2018,639,337,302,111.6,619,327,292,112
서울특별시,종로구,1세,2018,704,335,369,90.8,675,319,356,89.6
서울특별시,종로구,2세,2018,814,407,407,100,778,387,391,99
서울특별시,종로구,3세,2018,868,449,419,107.2,842,439,403,108.9
서울특별시,종로구,4세,2018,845,429,416,103.1,820,417,403,103.5
서울특별시,종로구,5~9세,2018,4468,2286,2182,104.8,4353,2233,2120,105.3
서울특별시,종로구,5세,2018,824,422,402,105,795,408,387,105.4
서울특별시,종로구,6세,2018,964,496,468,106,937,482,455,105.9
서울특별시,종로구,7세,2018,898,467,431,108.4,875,457,418,109.3
서울특별시,종로구,8세,2018,879,436,443,98.4,864,431,433,99.5
서울특별시,종로구,9세,2018,903,465,438,106.2,882,455,427,106.6
서울특별시,종로구,10~14세,2018,4863,2509,2354,106.6,4784,2460,2324,105.9
서울특별시,종로구,10세,2018,932,495,437,113.3,912,483,429,112.6
서울특별시,종로구,11세,2018,1030,532,498,106.8,1014,521,493,105.7
서울특별시,종로구,12세,2018,989,504,485,103.9,974,497,477,104.2
서울특별시,종로구,13세,2018,919,473,446,106.1,902,460,442,104.1
서울특별시,종로구,14세,2018,993,505,488,103.5,982,499,483,103.3
서울특별시,종로구,15~19세,2018,9887,5129,4758,107.8,9022,4816,4206,114.5
서울특별시,종로구,15세,2018,1225,657,568,115.7,1209,648,561,115.5
서울특별시,종로구,16세,2018,1453,789,664,118.8,1437,778,659,118.1
서울특별시,종로구,17세,2018,1710,1012,698,145,1667,990,677,146.2
서울특별시,종로구,18세,2018,2552,1410,1142,123.5,2354,1339,1015,131.9
서울특별시,종로구,19세,2018,2947,1261,1686,74.8,2355,1061,1294,82
서울특별시,종로구,20~24세,2018,15995,7391,8604,85.9,12709,6160,6549,94.1
서울특별시,종로구,20세,2018,3181,1316,1865,70.6,2368,1027,1341,76.6
서울특별시,종로구,21세,2018,3017,1280,1737,73.7,2298,1031,1267,81.4
서울특별시,종로구,22세,2018,3252,1517,1735,87.4,2575,1267,1308,96.9
서울특별시,종로구,23세,2018,3363,1674,1689,99.1,2733,1417,1316,107.7
서울특별시,종로구,24세,2018,3182,1604,1578,101.6,2735,1418,1317,107.7
서울특별시,종로구,25~29세,2018,14177,7388,6789,108.8,12650,6669,5981,111.5
서울특별시,종로구,25세,2018,3229,1658,1571,105.5,2828,1480,1348,109.8
서울특별시,종로구,26세,2018,2988,1598,1390,115,2650,1448,1202,120.5
서울특별시,종로구,27세,2018,2896,1534,1362,112.6,2621,1400,1221,114.7
서울특별시,종로구,28세,2018,2642,1345,1297,103.7,2368,1210,1158,104.5
서울특별시,종로구,29세,2018,2422,1253,1169,107.2,2183,1131,1052,107.5
서울특별시,종로구,30~34세,2018,11013,5656,5357,105.6,9810,5017,4793,104.7
서울특별시,종로구,30세,2018,2401,1301,1100,118.3,2133,1150,983,117
서울특별시,종로구,31세,2018,2328,1123,1205,93.2,2071,994,1077,92.3
서울특별시,종로구,32세,2018,2132,1096,1036,105.8,1865,944,921,102.5
서울특별시,종로구,33세,2018,2091,1076,1015,106,1894,990,904,109.5
서울특별시,종로구,34세,2018,2061,1060,1001,105.9,1847,939,908,103.4
서울특별시,종로구,35~39세,2018,10832,5365,5467,98.1,9908,4873,5035,96.8
서울특별시,종로구,35세,2018,2120,1061,1059,100.2,1933,970,963,100.7
서울특별시,종로구,36세,2018,2180,1080,1100,98.2,1975,967,1008,95.9
서울특별시,종로구,37세,2018,2259,1129,1130,99.9,2079,1031,1048,98.4
서울특별시,종로구,38세,2018,2185,1066,1119,95.3,2006,968,1038,93.3
서울특별시,종로구,39세,2018,2088,1029,1059,97.2,1915,937,978,95.8
서울특별시,종로구,40~44세,2018,10267,5048,5219,96.7,9512,4599,4913,93.6
서울특별시,종로구,40세,2018,1890,957,933,102.6,1722,852,870,97.9
서울특별시,종로구,41세,2018,1954,922,1032,89.3,1808,839,969,86.6
서울특별시,종로구,42세,2018,2036,1032,1004,102.8,1873,931,942,98.8
서울특별시,종로구,43세,2018,2087,1017,1070,95,1945,930,1015,91.6
서울특별시,종로구,44세,2018,2300,1120,1180,94.9,2164,1047,1117,93.7
서울특별시,종로구,45~49세,2018,13107,6468,6639,97.4,12287,6030,6257,96.4
서울특별시,종로구,45세,2018,2465,1171,1294,90.5,2292,1076,1216,88.5
서울특별시,종로구,46세,2018,2585,1306,1279,102.1,2417,1218,1199,101.6
서울특별시,종로구,47세,2018,2761,1434,1327,108.1,2603,1347,1256,107.2
서울특별시,종로구,48세,2018,2672,1304,1368,95.3,2505,1213,1292,93.9
서울특별시,종로구,49세,2018,2624,1253,1371,91.4,2470,1176,1294,90.9
서울특별시,종로구,50~54세,2018,12329,5988,6341,94.4,11543,5610,5933,94.6
서울특별시,종로구,50세,2018,2553,1197,1356,88.3,2396,1124,1272,88.4
서울특별시,종로구,51세,2018,2392,1166,1226,95.1,2266,1097,1169,93.8
서울특별시,종로구,52세,2018,2406,1156,1250,92.5,2251,1081,1170,92.4
서울특별시,종로구,53세,2018,2480,1222,1258,97.1,2295,1139,1156,98.5
서울특별시,종로구,54세,2018,2498,1247,1251,99.7,2335,1169,1166,100.3
서울특별시,종로구,55~59세,2018,12701,6313,6388,98.8,12032,6008,6024,99.7
서울특별시,종로구,55세,2018,2504,1270,1234,102.9,2341,1193,1148,103.9
서울특별시,종로구,56세,2018,2517,1307,1210,108,2365,1230,1135,108.4
서울특별시,종로구,57세,2018,2627,1274,1353,94.2,2536,1235,1301,94.9
서울특별시,종로구,58세,2018,2656,1237,1419,87.2,2516,1170,1346,86.9
서울특별시,종로구,59세,2018,2397,1225,1172,104.5,2274,1180,1094,107.9
서울특별시,종로구,60~64세,2018,10411,5177,5234,98.9,9906,4939,4967,99.4
서울특별시,종로구,60세,2018,2259,1151,1108,103.9,2123,1092,1031,105.9
서울특별시,종로구,61세,2018,2157,1075,1082,99.4,2051,1025,1026,99.9
서울특별시,종로구,62세,2018,2076,1035,1041,99.4,1984,990,994,99.6
서울특별시,종로구,63세,2018,2098,1011,1087,93,2006,961,1045,92
서울특별시,종로구,64세,2018,1821,905,916,98.8,1742,871,871,100
서울특별시,종로구,65~69세,2018,7143,3374,3769,89.5,6905,3266,3639,89.7
서울특별시,종로구,65세,2018,1602,774,828,93.5,1532,746,786,94.9
서울특별시,종로구,66세,2018,1661,823,838,98.2,1609,793,816,97.2
서울특별시,종로구,67세,2018,1189,545,644,84.6,1133,522,611,85.4
서울특별시,종로구,68세,2018,1351,615,736,83.6,1317,604,713,84.7
서울특별시,종로구,69세,2018,1340,617,723,85.3,1314,601,713,84.3
서울특별시,종로구,70~74세,2018,6066,2658,3408,78,6001,2635,3366,78.3
서울특별시,종로구,70세,2018,1384,631,753,83.8,1367,624,743,84
서울특별시,종로구,71세,2018,1388,621,767,81,1371,613,758,80.9
서울특별시,종로구,72세,2018,1105,484,621,77.9,1096,482,614,78.5
서울특별시,종로구,73세,2018,1092,475,617,77,1078,472,606,77.9
서울특별시,종로구,74세,2018,1097,447,650,68.8,1089,444,645,68.8
서울특별시,종로구,75~79세,2018,5463,2422,3041,79.6,5422,2408,3014,79.9
서울특별시,종로구,75세,2018,1150,525,625,84,1143,523,620,84.4
서울특별시,종로구,76세,2018,1312,588,724,81.2,1301,584,717,81.5
서울특별시,종로구,77세,2018,1084,482,602,80.1,1076,478,598,79.9
서울특별시,종로구,78세,2018,959,427,532,80.3,952,426,526,81
서울특별시,종로구,79세,2018,958,400,558,71.7,950,397,553,71.8
서울특별시,종로구,80~84세,2018,3209,1307,1902,68.7,3186,1296,1890,68.6
서울특별시,종로구,80세,2018,794,318,476,66.8,789,317,472,67.2
서울특별시,종로구,81세,2018,700,298,402,74.1,695,295,400,73.8
서울특별시,종로구,82세,2018,630,264,366,72.1,628,264,364,72.5
서울특별시,종로구,83세,2018,602,241,361,66.8,594,235,359,65.5
서울특별시,종로구,84세,2018,483,186,297,62.6,480,185,295,62.7
서울특별시,종로구,85세이상,2018,2166,711,1455,48.9,2147,703,1444,48.7
서울특별시,종로구,85~89세,2018,1468,508,960,52.9,1457,504,953,52.9
서울특별시,종로구,85세,2018,378,133,245,54.3,378,133,245,54.3
서울특별시,종로구,86세,2018,337,123,214,57.5,335,123,212,58
서울특별시,종로구,87세,2018,301,98,203,48.3,296,97,199,48.7
서울특별시,종로구,88세,2018,245,76,169,45,243,75,168,44.6
서울특별시,종로구,89세,2018,207,78,129,60.5,205,76,129,58.9
서울특별시,종로구,90~94세,2018,540,157,383,41,536,156,380,41.1
서울특별시,종로구,90세,2018,166,45,121,37.2,164,45,119,37.8
서울특별시,종로구,91세,2018,136,43,93,46.2,134,42,92,45.7
서울특별시,종로구,92세,2018,102,30,72,41.7,102,30,72,41.7
서울특별시,종로구,93세,2018,77,22,55,40,77,22,55,40
서울특별시,종로구,94세,2018,59,17,42,40.5,59,17,42,40.5
서울특별시,종로구,95~99세,2018,136,42,94,44.7,133,40,93,43
서울특별시,종로구,95세,2018,44,16,28,57.1,43,15,28,53.6
서울특별시,종로구,96세,2018,43,13,30,43.3,43,13,30,43.3
서울특별시,종로구,97세,2018,22,6,16,37.5,21,5,16,31.3
서울특별시,종로구,98세,2018,17,X,14,21.4,16,X,13,23.1
서울특별시,종로구,99세,2018,10,X,6,66.7,10,X,6,66.7
서울특별시,종로구,100세이상,2018,22,X,18,22.2,21,X,18,16.7
서울특별시,종로구,15세미만,2018,13201,6752,6449,104.7,12871,6582,6289,104.7
서울특별시,종로구,15~64세,2018,120719,59923,60796,98.6,109379,54721,54658,100.1
서울특별시,종로구,65세이상,2018,24047,10472,13575,77.1,23661,10308,13353,77.2
서울특별시,종로구,평균연령,2018,42.3,41.5,43.1,,42.9,41.9,43.9,
서울특별시,종로구,중위연령,2018,42,40.9,43,,43.3,42,44.4,
서울특별시,중구,합계,2018,129797,62975,66822,94.2,117809,57240,60569,94.5
서울특별시,중구,0~4세,2018,4111,2059,2052,100.3,3824,1912,1912,100
서울특별시,중구,0세,2018,756,371,385,96.4,708,347,361,96.1
서울특별시,중구,1세,2018,787,384,403,95.3,722,355,367,96.7
서울특별시,중구,2세,2018,907,485,422,114.9,826,439,387,113.4
서울특별시,중구,3세,2018,847,409,438,93.4,794,383,411,93.2
서울특별시,중구,4세,2018,814,410,404,101.5,774,388,386,100.5
서울특별시,중구,5~9세,2018,3617,1853,1764,105,3423,1732,1691,102.4
서울특별시,중구,5세,2018,776,410,366,112,725,373,352,106
서울특별시,중구,6세,2018,809,420,389,108,766,403,363,111
서울특별시,중구,7세,2018,741,356,385,92.5,702,333,369,90.2
서울특별시,중구,8세,2018,676,357,319,111.9,650,337,313,107.7
서울특별시,중구,9세,2018,615,310,305,101.6,580,286,294,97.3
서울특별시,중구,10~14세,2018,3148,1574,1574,100,2995,1493,1502,99.4
서울특별시,중구,10세,2018,716,337,379,88.9,682,322,360,89.4
서울특별시,중구,11세,2018,679,345,334,103.3,646,325,321,101.2
서울특별시,중구,12세,2018,530,275,255,107.8,508,262,246,106.5
서울특별시,중구,13세,2018,563,293,270,108.5,538,280,258,108.5
서울특별시,중구,14세,2018,660,324,336,96.4,621,304,317,95.9
서울특별시,중구,15~19세,2018,5634,2532,3102,81.6,5115,2296,2819,81.4
서울특별시,중구,15세,2018,628,314,314,100,611,305,306,99.7
서울특별시,중구,16세,2018,740,350,390,89.7,705,331,374,88.5
서울특별시,중구,17세,2018,1072,428,644,66.5,1044,418,626,66.8
서울특별시,중구,18세,2018,1309,584,725,80.6,1195,537,658,81.6
서울특별시,중구,19세,2018,1885,856,1029,83.2,1560,705,855,82.5
서울특별시,중구,20~24세,2018,10679,4895,5784,84.6,8604,4030,4574,88.1
서울특별시,중구,20세,2018,1957,802,1155,69.4,1517,616,901,68.4
서울특별시,중구,21세,2018,2027,839,1188,70.6,1620,690,930,74.2
서울특별시,중구,22세,2018,2126,988,1138,86.8,1713,822,891,92.3
서울특별시,중구,23세,2018,2222,1078,1144,94.2,1783,880,903,97.5
서울특별시,중구,24세,2018,2347,1188,1159,102.5,1971,1022,949,107.7
서울특별시,중구,25~29세,2018,11534,5784,5750,100.6,10032,5080,4952,102.6
서울특별시,중구,25세,2018,2407,1178,1229,95.9,2043,1023,1020,100.3
서울특별시,중구,26세,2018,2484,1249,1235,101.1,2178,1104,1074,102.8
서울특별시,중구,27세,2018,2336,1166,1170,99.7,2074,1049,1025,102.3
서울특별시,중구,28세,2018,2162,1089,1073,101.5,1872,946,926,102.2
서울특별시,중구,29세,2018,2145,1102,1043,105.7,1865,958,907,105.6
서울특별시,중구,30~34세,2018,10846,5444,5402,100.8,9524,4741,4783,99.1
서울특별시,중구,30세,2018,2220,1091,1129,96.6,1930,949,981,96.7
서울특별시,중구,31세,2018,2183,1125,1058,106.3,1905,983,922,106.6
서울특별시,중구,32세,2018,2169,1064,1105,96.3,1895,914,981,93.2
서울특별시,중구,33세,2018,2052,1027,1025,100.2,1808,900,908,99.1
서울특별시,중구,34세,2018,2222,1137,1085,104.8,1986,995,991,100.4
서울특별시,중구,35~39세,2018,10882,5592,5290,105.7,9866,5020,4846,103.6
서울특별시,중구,35세,2018,2266,1154,1112,103.8,2066,1046,1020,102.5
서울특별시,중구,36세,2018,2255,1140,1115,102.2,2026,1012,1014,99.8
서울특별시,중구,37세,2018,2173,1124,1049,107.1,1980,1018,962,105.8
서울특별시,중구,38세,2018,2223,1151,1072,107.4,2013,1032,981,105.2
서울특별시,중구,39세,2018,1965,1023,942,108.6,1781,912,869,104.9
서울특별시,중구,40~44세,2018,8872,4627,4245,109,7977,4147,3830,108.3
서울특별시,중구,40세,2018,1763,953,810,117.7,1565,838,727,115.3
서울특별시,중구,41세,2018,1750,919,831,110.6,1588,828,760,108.9
서울특별시,중구,42세,2018,1720,898,822,109.2,1533,794,739,107.4
서울특별시,중구,43세,2018,1752,884,868,101.8,1593,807,786,102.7
서울특별시,중구,44세,2018,1887,973,914,106.5,1698,880,818,107.6
서울특별시,중구,45~49세,2018,10126,5128,4998,102.6,9209,4666,4543,102.7
서울특별시,중구,45세,2018,1858,917,941,97.4,1675,828,847,97.8
서울특별시,중구,46세,2018,1986,1023,963,106.2,1807,919,888,103.5
서울특별시,중구,47세,2018,2124,1073,1051,102.1,1945,982,963,102
서울특별시,중구,48세,2018,2042,1006,1036,97.1,1853,920,933,98.6
서울특별시,중구,49세,2018,2116,1109,1007,110.1,1929,1017,912,111.5
서울특별시,중구,50~54세,2018,10154,4977,5177,96.1,9228,4539,4689,96.8
서울특별시,중구,50세,2018,2224,1076,1148,93.7,2011,962,1049,91.7
서울특별시,중구,51세,2018,1966,974,992,98.2,1804,906,898,100.9
서울특별시,중구,52세,2018,1854,943,911,103.5,1696,863,833,103.6
서울특별시,중구,53세,2018,2035,968,1067,90.7,1850,879,971,90.5
서울특별시,중구,54세,2018,2075,1016,1059,95.9,1867,929,938,99
서울특별시,중구,55~59세,2018,10915,5369,5546,96.8,10015,4981,5034,98.9
서울특별시,중구,55세,2018,2167,1075,1092,98.4,1924,970,954,101.7
서울특별시,중구,56세,2018,2180,1096,1084,101.1,1987,1018,969,105.1
서울특별시,중구,57세,2018,2240,1086,1154,94.1,2108,1030,1078,95.5
서울특별시,중구,58세,2018,2258,1086,1172,92.7,2086,1004,1082,92.8
서울특별시,중구,59세,2018,2070,1026,1044,98.3,1910,959,951,100.8
서울특별시,중구,60~64세,2018,9525,4659,4866,95.7,8781,4345,4436,97.9
서울특별시,중구,60세,2018,2029,974,1055,92.3,1842,899,943,95.3
서울특별시,중구,61세,2018,2046,1025,1021,100.4,1880,954,926,103
서울특별시,중구,62세,2018,1958,959,999,96,1827,905,922,98.2
서울특별시,중구,63세,2018,1898,905,993,91.1,1760,847,913,92.8
서울특별시,중구,64세,2018,1594,796,798,99.7,1472,740,732,101.1
서울특별시,중구,65~69세,2018,6294,3005,3289,91.4,5966,2855,3111,91.8
서울특별시,중구,65세,2018,1380,674,706,95.5,1291,630,661,95.3
서울특별시,중구,66세,2018,1439,665,774,85.9,1361,631,730,86.4
서울특별시,중구,67세,2018,1057,514,543,94.7,997,486,511,95.1
서울특별시,중구,68세,2018,1242,605,637,95,1184,580,604,96
서울특별시,중구,69세,2018,1176,547,629,87,1133,528,605,87.3
서울특별시,중구,70~74세,2018,5054,2267,2787,81.3,4955,2227,2728,81.6
서울특별시,중구,70세,2018,1169,550,619,88.9,1151,546,605,90.2
서울특별시,중구,71세,2018,1194,529,665,79.5,1156,513,643,79.8
서울특별시,중구,72세,2018,864,357,507,70.4,849,351,498,70.5
서울특별시,중구,73세,2018,922,423,499,84.8,911,420,491,85.5
서울특별시,중구,74세,2018,905,408,497,82.1,888,397,491,80.9
서울특별시,중구,75~79세,2018,4249,1798,2451,73.4,4187,1780,2407,74
서울특별시,중구,75세,2018,893,387,506,76.5,880,383,497,77.1
서울특별시,중구,76세,2018,1049,444,605,73.4,1034,442,592,74.7
서울특별시,중구,77세,2018,873,365,508,71.9,858,361,497,72.6
서울특별시,중구,78세,2018,713,288,425,67.8,705,283,422,67.1
서울특별시,중구,79세,2018,721,314,407,77.1,710,311,399,77.9
서울특별시,중구,80~84세,2018,2465,905,1560,58,2430,895,1535,58.3
서울특별시,중구,80세,2018,601,235,366,64.2,596,231,365,63.3
서울특별시,중구,81세,2018,545,201,344,58.4,536,199,337,59.1
서울특별시,중구,82세,2018,503,191,312,61.2,498,191,307,62.2
서울특별시,중구,83세,2018,436,162,274,59.1,429,160,269,59.5
서울특별시,중구,84세,2018,380,116,264,43.9,371,114,257,44.4
서울특별시,중구,85세이상,2018,1692,507,1185,42.8,1678,501,1177,42.6
서울특별시,중구,85~89세,2018,1161,366,795,46,1153,362,791,45.8
서울특별시,중구,85세,2018,320,100,220,45.5,317,98,219,44.7
서울특별시,중구,86세,2018,260,77,183,42.1,258,77,181,42.5
서울특별시,중구,87세,2018,211,67,144,46.5,211,67,144,46.5
서울특별시,중구,88세,2018,205,64,141,45.4,203,63,140,45
서울특별시,중구,89세,2018,165,58,107,54.2,164,57,107,53.3
서울특별시,중구,90~94세,2018,429,115,314,36.6,425,114,311,36.7
서울특별시,중구,90세,2018,149,40,109,36.7,148,40,108,37
서울특별시,중구,91세,2018,114,32,82,39,112,31,81,38.3
서울특별시,중구,92세,2018,67,14,53,26.4,67,14,53,26.4
서울특별시,중구,93세,2018,49,11,38,28.9,49,11,38,28.9
서울특별시,중구,94세,2018,50,18,32,56.3,49,18,31,58.1
서울특별시,중구,95~99세,2018,79,20,59,33.9,78,19,59,32.2
서울특별시,중구,95세,2018,26,5,21,23.8,25,X,21,19
서울특별시,중구,96세,2018,29,8,21,38.1,29,8,21,38.1
서울특별시,중구,97세,2018,12,X,9,33.3,12,X,9,33.3
서울특별시,중구,98세,2018,9,X,6,50,9,X,6,50
서울특별시,중구,99세,2018,X,X,X,50,X,X,X,50
서울특별시,중구,100세이상,2018,23,6,17,35.3,22,6,16,37.5
서울특별시,중구,15세미만,2018,10876,5486,5390,101.8,10242,5137,5105,100.6
서울특별시,중구,15~64세,2018,99167,49007,50160,97.7,88351,43845,44506,98.5
서울특별시,중구,65세이상,2018,19754,8482,11272,75.2,19216,8258,10958,75.4
서울특별시,중구,평균연령,2018,43,42.3,43.6,,43.6,42.9,44.2,
서울특별시,중구,중위연령,2018,42.5,41.9,43.3,,43.5,42.8,44.2,
서울특별시,용산구,합계,2018,226938,110685,116253,95.2,207812,99806,108006,92.4
서울특별시,용산구,0~4세,2018,7932,4097,3835,106.8,6926,3581,3345,107.1
서울특별시,용산구,0세,2018,1500,794,706,112.5,1325,691,634,109
서울특별시,용산구,1세,2018,1532,752,780,96.4,1282,629,653,96.3
서울특별시,용산구,2세,2018,1657,855,802,106.6,1456,756,700,108
서울특별시,용산구,3세,2018,1676,884,792,111.6,1478,789,689,114.5
서울특별시,용산구,4세,2018,1567,812,755,107.5,1385,716,669,107
서울특별시,용산구,5~9세,2018,7633,3908,3725,104.9,6845,3522,3323,106
서울특별시,용산구,5세,2018,1581,813,768,105.9,1404,724,680,106.5
서울특별시,용산구,6세,2018,1600,827,773,107,1441,755,686,110.1
서울특별시,용산구,7세,2018,1537,811,726,111.7,1364,723,641,112.8
서울특별시,용산구,8세,2018,1468,760,708,107.3,1332,695,637,109.1
서울특별시,용산구,9세,2018,1447,697,750,92.9,1304,625,679,92
서울특별시,용산구,10~14세,2018,7246,3691,3555,103.8,6679,3411,3268,104.4
서울특별시,용산구,10세,2018,1488,724,764,94.8,1357,666,691,96.4
서울특별시,용산구,11세,2018,1533,785,748,104.9,1409,727,682,106.6
서울특별시,용산구,12세,2018,1373,695,678,102.5,1262,639,623,102.6
서울특별시,용산구,13세,2018,1367,708,659,107.4,1264,651,613,106.2
서울특별시,용산구,14세,2018,1485,779,706,110.3,1387,728,659,110.5
서울특별시,용산구,15~19세,2018,9272,4584,4688,97.8,8642,4212,4430,95.1
서울특별시,용산구,15세,2018,1454,742,712,104.2,1374,699,675,103.6
서울특별시,용산구,16세,2018,1565,822,743,110.6,1495,784,711,110.3
서울특별시,용산구,17세,2018,1771,939,832,112.9,1694,893,801,111.5
서울특별시,용산구,18세,2018,2023,1003,1020,98.3,1912,938,974,96.3
서울특별시,용산구,19세,2018,2459,1078,1381,78.1,2167,898,1269,70.8
서울특별시,용산구,20~24세,2018,15432,6978,8454,82.5,13282,5737,7545,76
서울특별시,용산구,20세,2018,2760,1219,1541,79.1,2315,999,1316,75.9
서울특별시,용산구,21세,2018,2868,1314,1554,84.6,2474,1098,1376,79.8
서울특별시,용산구,22세,2018,2919,1346,1573,85.6,2526,1104,1422,77.6
서울특별시,용산구,23세,2018,3341,1447,1894,76.4,2915,1193,1722,69.3
서울특별시,용산구,24세,2018,3544,1652,1892,87.3,3052,1343,1709,78.6
서울특별시,용산구,25~29세,2018,19802,9932,9870,100.6,17283,8371,8912,93.9
서울특별시,용산구,25세,2018,3708,1772,1936,91.5,3220,1453,1767,82.2
서울특별시,용산구,26세,2018,3982,1959,2023,96.8,3478,1669,1809,92.3
서울특별시,용산구,27세,2018,4080,2053,2027,101.3,3570,1746,1824,95.7
서울특별시,용산구,28세,2018,4029,2089,1940,107.7,3529,1766,1763,100.2
서울특별시,용산구,29세,2018,4003,2059,1944,105.9,3486,1737,1749,99.3
서울특별시,용산구,30~34세,2018,19887,10317,9570,107.8,17242,8655,8587,100.8
서울특별시,용산구,30세,2018,4007,2081,1926,108,3468,1752,1716,102.1
서울특별시,용산구,31세,2018,3892,1963,1929,101.8,3388,1652,1736,95.2
서울특별시,용산구,32세,2018,4056,2122,1934,109.7,3531,1784,1747,102.1
서울특별시,용산구,33세,2018,3889,2020,1869,108.1,3361,1686,1675,100.7
서울특별시,용산구,34세,2018,4043,2131,1912,111.5,3494,1781,1713,104
서울특별시,용산구,35~39세,2018,20348,10441,9907,105.4,18105,9091,9014,100.9
서울특별시,용산구,35세,2018,4150,2155,1995,108,3676,1863,1813,102.8
서울특별시,용산구,36세,2018,4229,2154,2075,103.8,3796,1883,1913,98.4
서울특별시,용산구,37세,2018,4163,2153,2010,107.1,3738,1916,1822,105.2
서울특별시,용산구,38세,2018,4125,2118,2007,105.5,3644,1825,1819,100.3
서울특별시,용산구,39세,2018,3681,1861,1820,102.3,3251,1604,1647,97.4
서울특별시,용산구,40~44세,2018,17140,8647,8493,101.8,15388,7610,7778,97.8
서울특별시,용산구,40세,2018,3386,1741,1645,105.8,2981,1495,1486,100.6
서울특별시,용산구,41세,2018,3330,1626,1704,95.4,2972,1412,1560,90.5
서울특별시,용산구,42세,2018,3279,1661,1618,102.7,2924,1451,1473,98.5
서울특별시,용산구,43세,2018,3437,1738,1699,102.3,3108,1556,1552,100.3
서울특별시,용산구,44세,2018,3708,1881,1827,103,3403,1696,1707,99.4
서울특별시,용산구,45~49세,2018,19574,9761,9813,99.5,18108,8918,9190,97
서울특별시,용산구,45세,2018,3665,1861,1804,103.2,3374,1685,1689,99.8
서울특별시,용산구,46세,2018,3992,2011,1981,101.5,3671,1838,1833,100.3
서울특별시,용산구,47세,2018,4080,2019,2061,98,3794,1853,1941,95.5
서울특별시,용산구,48세,2018,3914,1925,1989,96.8,3629,1766,1863,94.8
서울특별시,용산구,49세,2018,3923,1945,1978,98.3,3640,1776,1864,95.3
서울특별시,용산구,50~54세,2018,17170,8511,8659,98.3,16013,7929,8084,98.1
서울특별시,용산구,50세,2018,3825,1893,1932,98,3537,1726,1811,95.3
서울특별시,용산구,51세,2018,3349,1628,1721,94.6,3130,1512,1618,93.4
서울특별시,용산구,52세,2018,3264,1670,1594,104.8,3046,1565,1481,105.7
서울특별시,용산구,53세,2018,3436,1673,1763,94.9,3211,1580,1631,96.9
서울특별시,용산구,54세,2018,3296,1647,1649,99.9,3089,1546,1543,100.2
서울특별시,용산구,55~59세,2018,17553,8494,9059,93.8,16658,8057,8601,93.7
서울특별시,용산구,55세,2018,3545,1735,1810,95.9,3275,1603,1672,95.9
서울특별시,용산구,56세,2018,3530,1753,1777,98.6,3358,1667,1691,98.6
서울특별시,용산구,57세,2018,3520,1699,1821,93.3,3373,1628,1745,93.3
서울특별시,용산구,58세,2018,3608,1698,1910,88.9,3442,1617,1825,88.6
서울특별시,용산구,59세,2018,3350,1609,1741,92.4,3210,1542,1668,92.4
서울특별시,용산구,60~64세,2018,14977,7276,7701,94.5,14320,6972,7348,94.9
서울특별시,용산구,60세,2018,3211,1608,1603,100.3,3058,1535,1523,100.8
서울특별시,용산구,61세,2018,3183,1535,1648,93.1,3032,1468,1564,93.9
서울특별시,용산구,62세,2018,3023,1486,1537,96.7,2905,1434,1471,97.5
서울특별시,용산구,63세,2018,3010,1409,1601,88,2888,1353,1535,88.1
서울특별시,용산구,64세,2018,2550,1238,1312,94.4,2437,1182,1255,94.2
서울특별시,용산구,65~69세,2018,10067,4686,5381,87.1,9714,4517,5197,86.9
서울특별시,용산구,65세,2018,2221,1069,1152,92.8,2124,1023,1101,92.9
서울특별시,용산구,66세,2018,2286,1005,1281,78.5,2202,970,1232,78.7
서울특별시,용산구,67세,2018,1703,797,906,88,1632,766,866,88.5
서울특별시,용산구,68세,2018,1936,906,1030,88,1887,883,1004,87.9
서울특별시,용산구,69세,2018,1921,909,1012,89.8,1869,875,994,88
서울특별시,용산구,70~74세,2018,8204,3596,4608,78,8080,3533,4547,77.7
서울특별시,용산구,70세,2018,1913,895,1018,87.9,1883,880,1003,87.7
서울특별시,용산구,71세,2018,1869,789,1080,73.1,1836,778,1058,73.5
서울특별시,용산구,72세,2018,1489,638,851,75,1456,620,836,74.2
서울특별시,용산구,73세,2018,1455,661,794,83.2,1442,650,792,82.1
서울특별시,용산구,74세,2018,1478,613,865,70.9,1463,605,858,70.5
서울특별시,용산구,75~79세,2018,7268,3114,4154,75,7169,3068,4101,74.8
서울특별시,용산구,75세,2018,1517,684,833,82.1,1489,670,819,81.8
서울특별시,용산구,76세,2018,1794,783,1011,77.4,1775,776,999,77.7
서울특별시,용산구,77세,2018,1442,600,842,71.3,1424,594,830,71.6
서울특별시,용산구,78세,2018,1275,531,744,71.4,1255,519,736,70.5
서울특별시,용산구,79세,2018,1240,516,724,71.3,1226,509,717,71
서울특별시,용산구,80~84세,2018,4546,1709,2837,60.2,4499,1690,2809,60.2
서울특별시,용산구,80세,2018,1174,453,721,62.8,1165,451,714,63.2
서울특별시,용산구,81세,2018,1021,402,619,64.9,1012,399,613,65.1
서울특별시,용산구,82세,2018,923,327,596,54.9,910,320,590,54.2
서울특별시,용산구,83세,2018,775,303,472,64.2,764,298,466,63.9
서울특별시,용산구,84세,2018,653,224,429,52.2,648,222,426,52.1
서울특별시,용산구,85세이상,2018,2887,943,1944,48.5,2859,932,1927,48.4
서울특별시,용산구,85~89세,2018,2037,712,1325,53.7,2015,705,1310,53.8
서울특별시,용산구,85세,2018,555,203,352,57.7,548,199,349,57
서울특별시,용산구,86세,2018,481,175,306,57.2,478,175,303,57.8
서울특별시,용산구,87세,2018,369,132,237,55.7,366,131,235,55.7
서울특별시,용산구,88세,2018,340,125,215,58.1,335,124,211,58.8
서울특별시,용산구,89세,2018,292,77,215,35.8,288,76,212,35.8
서울특별시,용산구,90~94세,2018,652,175,477,36.7,647,171,476,35.9
서울특별시,용산구,90세,2018,224,53,171,31,221,51,170,30
서울특별시,용산구,91세,2018,153,33,120,27.5,152,32,120,26.7
서울특별시,용산구,92세,2018,115,29,86,33.7,115,29,86,33.7
서울특별시,용산구,93세,2018,80,29,51,56.9,79,28,51,54.9
서울특별시,용산구,94세,2018,80,31,49,63.3,80,31,49,63.3
서울특별시,용산구,95~99세,2018,178,51,127,40.2,177,51,126,40.5
서울특별시,용산구,95세,2018,65,22,43,51.2,65,22,43,51.2
서울특별시,용산구,96세,2018,53,10,43,23.3,53,10,43,23.3
서울특별시,용산구,97세,2018,29,9,20,45,29,9,20,45
서울특별시,용산구,98세,2018,19,6,13,46.2,19,6,13,46.2
서울특별시,용산구,99세,2018,12,X,8,50,11,X,7,57.1
서울특별시,용산구,100세이상,2018,20,5,15,33.3,20,5,15,33.3
서울특별시,용산구,15세미만,2018,22811,11696,11115,105.2,20450,10514,9936,105.8
서울특별시,용산구,15~64세,2018,171155,84941,86214,98.5,155041,75552,79489,95
서울특별시,용산구,65세이상,2018,32972,14048,18924,74.2,32321,13740,18581,73.9
서울특별시,용산구,평균연령,2018,42.3,41.4,43.2,,43,42.2,43.8,
서울특별시,용산구,중위연령,2018,41.8,40.8,42.7,,43,42.3,43.7,
서울특별시,성동구,합계,2018,306796,150623,156173,96.4,295489,145220,150269,96.6
서울특별시,성동구,0~4세,2018,12282,6247,6035,103.5,12041,6127,5914,103.6
서울특별시,성동구,0세,2018,2363,1202,1161,103.5,2325,1184,1141,103.8
서울특별시,성동구,1세,2018,2424,1252,1172,106.8,2360,1220,1140,107
서울특별시,성동구,2세,2018,2533,1271,1262,100.7,2481,1250,1231,101.5
서울특별시,성동구,3세,2018,2559,1316,1243,105.9,2510,1289,1221,105.6
서울특별시,성동구,4세,2018,2403,1206,1197,100.8,2365,1184,1181,100.3
서울특별시,성동구,5~9세,2018,10491,5336,5155,103.5,10350,5263,5087,103.5
서울특별시,성동구,5세,2018,2354,1208,1146,105.4,2320,1194,1126,106
서울특별시,성동구,6세,2018,2270,1152,1118,103,2233,1128,1105,102.1
서울특별시,성동구,7세,2018,2089,1068,1021,104.6,2067,1056,1011,104.5
서울특별시,성동구,8세,2018,1949,981,968,101.3,1919,969,950,102
서울특별시,성동구,9세,2018,1829,927,902,102.8,1811,916,895,102.3
서울특별시,성동구,10~14세,2018,9545,4871,4674,104.2,9473,4838,4635,104.4
서울특별시,성동구,10세,2018,2030,1041,989,105.3,2015,1034,981,105.4
서울특별시,성동구,11세,2018,2032,1048,984,106.5,2021,1043,978,106.6
서울특별시,성동구,12세,2018,1772,905,867,104.4,1760,898,862,104.2
서울특별시,성동구,13세,2018,1785,900,885,101.7,1768,892,876,101.8
서울특별시,성동구,14세,2018,1926,977,949,103,1909,971,938,103.5
서울특별시,성동구,15~19세,2018,12994,6353,6641,95.7,12622,6198,6424,96.5
서울특별시,성동구,15세,2018,1892,874,1018,85.9,1874,865,1009,85.7
서울특별시,성동구,16세,2018,2064,989,1075,92,2043,978,1065,91.8
서울특별시,성동구,17세,2018,2334,1209,1125,107.5,2308,1191,1117,106.6
서울특별시,성동구,18세,2018,2920,1447,1473,98.2,2830,1414,1416,99.9
서울특별시,성동구,19세,2018,3784,1834,1950,94.1,3567,1750,1817,96.3
서울특별시,성동구,20~24세,2018,24010,11722,12288,95.4,21884,10848,11036,98.3
서울특별시,성동구,20세,2018,4133,1949,2184,89.2,3738,1792,1946,92.1
서울특별시,성동구,21세,2018,4391,2080,2311,90,4015,1931,2084,92.7
서울특별시,성동구,22세,2018,4861,2390,2471,96.7,4402,2215,2187,101.3
서울특별시,성동구,23세,2018,5193,2632,2561,102.8,4705,2405,2300,104.6
서울특별시,성동구,24세,2018,5432,2671,2761,96.7,5024,2505,2519,99.4
서울특별시,성동구,25~29세,2018,26682,13638,13044,104.6,25210,12939,12271,105.4
서울특별시,성동구,25세,2018,5495,2864,2631,108.9,5167,2729,2438,111.9
서울특별시,성동구,26세,2018,5678,2968,2710,109.5,5391,2840,2551,111.3
서울특별시,성동구,27세,2018,5336,2777,2559,108.5,5054,2634,2420,108.8
서울특별시,성동구,28세,2018,5228,2603,2625,99.2,4923,2455,2468,99.5
서울특별시,성동구,29세,2018,4945,2426,2519,96.3,4675,2281,2394,95.3
서울특별시,성동구,30~34세,2018,25451,12449,13002,95.7,24176,11784,12392,95.1
서울특별시,성동구,30세,2018,4993,2406,2587,93,4731,2274,2457,92.6
서울특별시,성동구,31세,2018,4939,2398,2541,94.4,4656,2249,2407,93.4
서울특별시,성동구,32세,2018,5015,2503,2512,99.6,4766,2371,2395,99
서울특별시,성동구,33세,2018,5265,2570,2695,95.4,5015,2442,2573,94.9
서울특별시,성동구,34세,2018,5239,2572,2667,96.4,5008,2448,2560,95.6
서울특별시,성동구,35~39세,2018,27523,14051,13472,104.3,26550,13491,13059,103.3
서울특별시,성동구,35세,2018,5489,2799,2690,104.1,5280,2677,2603,102.8
서울특별시,성동구,36세,2018,5824,2983,2841,105,5579,2845,2734,104.1
서울특별시,성동구,37세,2018,5642,2894,2748,105.3,5451,2777,2674,103.9
서울특별시,성동구,38세,2018,5595,2861,2734,104.6,5421,2761,2660,103.8
서울특별시,성동구,39세,2018,4973,2514,2459,102.2,4819,2431,2388,101.8
서울특별시,성동구,40~44세,2018,22590,11577,11013,105.1,21834,11171,10663,104.8
서울특별시,성동구,40세,2018,4484,2326,2158,107.8,4322,2235,2087,107.1
서울특별시,성동구,41세,2018,4526,2310,2216,104.2,4369,2230,2139,104.3
서울특별시,성동구,42세,2018,4348,2269,2079,109.1,4200,2187,2013,108.6
서울특별시,성동구,43세,2018,4432,2224,2208,100.7,4281,2139,2142,99.9
서울특별시,성동구,44세,2018,4800,2448,2352,104.1,4662,2380,2282,104.3
서울특별시,성동구,45~49세,2018,25312,12628,12684,99.6,24402,12181,12221,99.7
서울특별시,성동구,45세,2018,4894,2497,2397,104.2,4731,2418,2313,104.5
서울특별시,성동구,46세,2018,4885,2449,2436,100.5,4690,2353,2337,100.7
서울특별시,성동구,47세,2018,5239,2589,2650,97.7,5064,2498,2566,97.3
서울특별시,성동구,48세,2018,5195,2610,2585,101,4997,2513,2484,101.2
서울특별시,성동구,49세,2018,5099,2483,2616,94.9,4920,2399,2521,95.2
서울특별시,성동구,50~54세,2018,23867,11745,12122,96.9,22912,11283,11629,97
서울특별시,성동구,50세,2018,5075,2481,2594,95.6,4878,2385,2493,95.7
서울특별시,성동구,51세,2018,4647,2254,2393,94.2,4516,2182,2334,93.5
서울특별시,성동구,52세,2018,4620,2289,2331,98.2,4414,2194,2220,98.8
서울특별시,성동구,53세,2018,4832,2369,2463,96.2,4608,2257,2351,96
서울특별시,성동구,54세,2018,4693,2352,2341,100.5,4496,2265,2231,101.5
서울특별시,성동구,55~59세,2018,24851,12304,12547,98.1,24011,11925,12086,98.7
서울특별시,성동구,55세,2018,4854,2371,2483,95.5,4638,2279,2359,96.6
서울특별시,성동구,56세,2018,4986,2529,2457,102.9,4794,2438,2356,103.5
서울특별시,성동구,57세,2018,5074,2502,2572,97.3,4947,2448,2499,98
서울특별시,성동구,58세,2018,5258,2584,2674,96.6,5095,2517,2578,97.6
서울특별시,성동구,59세,2018,4679,2318,2361,98.2,4537,2243,2294,97.8
서울특별시,성동구,60~64세,2018,20377,9939,10438,95.2,19668,9609,10059,95.5
서울특별시,성동구,60세,2018,4480,2265,2215,102.3,4295,2180,2115,103.1
서울특별시,성동구,61세,2018,4384,2153,2231,96.5,4234,2078,2156,96.4
서울특별시,성동구,62세,2018,4013,1952,2061,94.7,3872,1884,1988,94.8
서울특별시,성동구,63세,2018,4037,1896,2141,88.6,3914,1842,2072,88.9
서울특별시,성동구,64세,2018,3463,1673,1790,93.5,3353,1625,1728,94
서울특별시,성동구,65~69세,2018,13403,6315,7088,89.1,13090,6163,6927,89
서울특별시,성동구,65세,2018,2906,1421,1485,95.7,2824,1382,1442,95.8
서울특별시,성동구,66세,2018,3099,1468,1631,90,3017,1423,1594,89.3
서울특별시,성동구,67세,2018,2326,1079,1247,86.5,2262,1055,1207,87.4
서울특별시,성동구,68세,2018,2554,1189,1365,87.1,2506,1164,1342,86.7
서울특별시,성동구,69세,2018,2518,1158,1360,85.1,2481,1139,1342,84.9
서울특별시,성동구,70~74세,2018,10765,4869,5896,82.6,10687,4844,5843,82.9
서울특별시,성동구,70세,2018,2434,1144,1290,88.7,2410,1139,1271,89.6
서울특별시,성동구,71세,2018,2537,1132,1405,80.6,2523,1128,1395,80.9
서울특별시,성동구,72세,2018,1989,895,1094,81.8,1966,885,1081,81.9
서울특별시,성동구,73세,2018,1900,827,1073,77.1,1892,825,1067,77.3
서울특별시,성동구,74세,2018,1905,871,1034,84.2,1896,867,1029,84.3
서울특별시,성동구,75~79세,2018,8788,3852,4936,78,8749,3840,4909,78.2
서울특별시,성동구,75세,2018,1902,845,1057,79.9,1892,842,1050,80.2
서울특별시,성동구,76세,2018,2218,1007,1211,83.2,2209,1005,1204,83.5
서울특별시,성동구,77세,2018,1753,780,973,80.2,1749,779,970,80.3
서울특별시,성동구,78세,2018,1489,602,887,67.9,1480,598,882,67.8
서울특별시,성동구,79세,2018,1426,618,808,76.5,1419,616,803,76.7
서울특별시,성동구,80~84세,2018,4979,1900,3079,61.7,4955,1893,3062,61.8
서울특별시,성동구,80세,2018,1269,499,770,64.8,1266,497,769,64.6
서울특별시,성동구,81세,2018,1132,437,695,62.9,1127,436,691,63.1
서울특별시,성동구,82세,2018,982,358,624,57.4,978,358,620,57.7
서울특별시,성동구,83세,2018,823,306,517,59.2,815,303,512,59.2
서울특별시,성동구,84세,2018,773,300,473,63.4,769,299,470,63.6
서울특별시,성동구,85세이상,2018,2886,827,2059,40.2,2875,823,2052,40.1
서울특별시,성동구,85~89세,2018,2045,614,1431,42.9,2037,611,1426,42.8
서울특별시,성동구,85세,2018,558,180,378,47.6,556,180,376,47.9
서울특별시,성동구,86세,2018,488,155,333,46.5,486,154,332,46.4
서울특별시,성동구,87세,2018,381,106,275,38.5,378,104,274,38
서울특별시,성동구,88세,2018,342,88,254,34.6,341,88,253,34.8
서울특별시,성동구,89세,2018,276,85,191,44.5,276,85,191,44.5
서울특별시,성동구,90~94세,2018,653,163,490,33.3,652,163,489,33.3
서울특별시,성동구,90세,2018,212,57,155,36.8,212,57,155,36.8
서울특별시,성동구,91세,2018,163,43,120,35.8,162,43,119,36.1
서울특별시,성동구,92세,2018,117,28,89,31.5,117,28,89,31.5
서울특별시,성동구,93세,2018,87,18,69,26.1,87,18,69,26.1
서울특별시,성동구,94세,2018,74,17,57,29.8,74,17,57,29.8
서울특별시,성동구,95~99세,2018,169,46,123,37.4,167,45,122,36.9
서울특별시,성동구,95세,2018,70,21,49,42.9,68,20,48,41.7
서울특별시,성동구,96세,2018,37,9,28,32.1,37,9,28,32.1
서울특별시,성동구,97세,2018,32,8,24,33.3,32,8,24,33.3
서울특별시,성동구,98세,2018,20,6,14,42.9,20,6,14,42.9
서울특별시,성동구,99세,2018,10,X,8,25,10,X,8,25
서울특별시,성동구,100세이상,2018,19,X,15,26.7,19,X,15,26.7
서울특별시,성동구,15세미만,2018,32318,16454,15864,103.7,31864,16228,15636,103.8
서울특별시,성동구,15~64세,2018,233657,116406,117251,99.3,223269,111429,111840,99.6
서울특별시,성동구,65세이상,2018,40821,17763,23058,77,40356,17563,22793,77.1
서울특별시,성동구,평균연령,2018,41.5,40.8,42.2,,41.7,40.9,42.4,
서울특별시,성동구,중위연령,2018,41,40.3,41.7,,41.3,40.5,42,
서울특별시,광진구,합계,2018,362304,175762,186542,94.2,342575,166730,175845,94.8
서울특별시,광진구,0~4세,2018,11239,5753,5486,104.9,10854,5558,5296,104.9
서울특별시,광진구,0세,2018,2137,1090,1047,104.1,2075,1063,1012,105
서울특별시,광진구,1세,2018,2134,1076,1058,101.7,2056,1031,1025,100.6
서울특별시,광진구,2세,2018,2310,1201,1109,108.3,2222,1157,1065,108.6
서울특별시,광진구,3세,2018,2408,1217,1191,102.2,2342,1181,1161,101.7
서울특별시,광진구,4세,2018,2250,1169,1081,108.1,2159,1126,1033,109
서울특별시,광진구,5~9세,2018,11552,5953,5599,106.3,11330,5833,5497,106.1
서울특별시,광진구,5세,2018,2273,1160,1113,104.2,2227,1134,1093,103.8
서울특별시,광진구,6세,2018,2392,1231,1161,106,2340,1200,1140,105.3
서울특별시,광진구,7세,2018,2352,1188,1164,102.1,2306,1161,1145,101.4
서울특별시,광진구,8세,2018,2347,1247,1100,113.4,2305,1224,1081,113.2
서울특별시,광진구,9세,2018,2188,1127,1061,106.2,2152,1114,1038,107.3
서울특별시,광진구,10~14세,2018,12225,6246,5979,104.5,12098,6176,5922,104.3
서울특별시,광진구,10세,2018,2387,1234,1153,107,2360,1220,1140,107
서울특별시,광진구,11세,2018,2539,1266,1273,99.5,2502,1246,1256,99.2
서울특별시,광진구,12세,2018,2369,1208,1161,104,2347,1195,1152,103.7
서울특별시,광진구,13세,2018,2376,1217,1159,105,2364,1208,1156,104.5
서울특별시,광진구,14세,2018,2554,1321,1233,107.1,2525,1307,1218,107.3
서울특별시,광진구,15~19세,2018,17094,8595,8499,101.1,16343,8325,8018,103.8
서울특별시,광진구,15세,2018,2576,1328,1248,106.4,2560,1319,1241,106.3
서울특별시,광진구,16세,2018,2639,1330,1309,101.6,2603,1319,1284,102.7
서울특별시,광진구,17세,2018,3040,1600,1440,111.1,2976,1575,1401,112.4
서울특별시,광진구,18세,2018,3971,1968,2003,98.3,3757,1886,1871,100.8
서울특별시,광진구,19세,2018,4868,2369,2499,94.8,4447,2226,2221,100.2
서울특별시,광진구,20~24세,2018,31468,14403,17065,84.4,28038,13132,14906,88.1
서울특별시,광진구,20세,2018,5486,2501,2985,83.8,4864,2275,2589,87.9
서울특별시,광진구,21세,2018,5714,2574,3140,82,4988,2312,2676,86.4
서울특별시,광진구,22세,2018,6338,2864,3474,82.4,5608,2616,2992,87.4
서울특별시,광진구,23세,2018,6771,3160,3611,87.5,6046,2874,3172,90.6
서울특별시,광진구,24세,2018,7159,3304,3855,85.7,6532,3055,3477,87.9
서울특별시,광진구,25~29세,2018,36283,17770,18513,96,33847,16701,17146,97.4
서울특별시,광진구,25세,2018,7618,3729,3889,95.9,7036,3488,3548,98.3
서울특별시,광진구,26세,2018,7603,3711,3892,95.3,7164,3533,3631,97.3
서울특별시,광진구,27세,2018,7290,3647,3643,100.1,6858,3439,3419,100.6
서울특별시,광진구,28세,2018,7019,3445,3574,96.4,6496,3215,3281,98
서울특별시,광진구,29세,2018,6753,3238,3515,92.1,6293,3026,3267,92.6
서울특별시,광진구,30~34세,2018,31022,15429,15593,98.9,29006,14403,14603,98.6
서울특별시,광진구,30세,2018,6577,3203,3374,94.9,6125,2981,3144,94.8
서울특별시,광진구,31세,2018,6380,3130,3250,96.3,5910,2893,3017,95.9
서울특별시,광진구,32세,2018,6191,3107,3084,100.7,5789,2892,2897,99.8
서울특별시,광진구,33세,2018,5947,2980,2967,100.4,5577,2802,2775,101
서울특별시,광진구,34세,2018,5927,3009,2918,103.1,5605,2835,2770,102.3
서울특별시,광진구,35~39세,2018,30108,15065,15043,100.1,28742,14369,14373,100
서울특별시,광진구,35세,2018,6308,3170,3138,101,5970,3014,2956,102
서울특별시,광진구,36세,2018,6387,3172,3215,98.7,6087,3017,3070,98.3
서울특별시,광진구,37세,2018,6022,3020,3002,100.6,5762,2881,2881,100
서울특별시,광진구,38세,2018,5881,2952,2929,100.8,5637,2825,2812,100.5
서울특별시,광진구,39세,2018,5510,2751,2759,99.7,5286,2632,2654,99.2
서울특별시,광진구,40~44세,2018,25673,12962,12711,102,24527,12324,12203,101
서울특별시,광진구,40세,2018,4873,2511,2362,106.3,4628,2371,2257,105.1
서울특별시,광진구,41세,2018,5206,2597,2609,99.5,4971,2459,2512,97.9
서울특별시,광진구,42세,2018,4955,2530,2425,104.3,4741,2411,2330,103.5
서울특별시,광진구,43세,2018,5151,2572,2579,99.7,4945,2460,2485,99
서울특별시,광진구,44세,2018,5488,2752,2736,100.6,5242,2623,2619,100.2
서울특별시,광진구,45~49세,2018,30109,14646,15463,94.7,28495,13831,14664,94.3
서울특별시,광진구,45세,2018,5697,2747,2950,93.1,5422,2600,2822,92.1
서울특별시,광진구,46세,2018,5900,2977,2923,101.8,5605,2832,2773,102.1
서울특별시,광진구,47세,2018,6309,3090,3219,96,5954,2896,3058,94.7
서울특별시,광진구,48세,2018,6163,2946,3217,91.6,5825,2785,3040,91.6
서울특별시,광진구,49세,2018,6040,2886,3154,91.5,5689,2718,2971,91.5
서울특별시,광진구,50~54세,2018,28396,13764,14632,94.1,26500,12877,13623,94.5
서울특별시,광진구,50세,2018,6219,2984,3235,92.2,5859,2823,3036,93
서울특별시,광진구,51세,2018,5545,2681,2864,93.6,5235,2539,2696,94.2
서울특별시,광진구,52세,2018,5494,2637,2857,92.3,5122,2455,2667,92.1
서울특별시,광진구,53세,2018,5738,2805,2933,95.6,5322,2615,2707,96.6
서울특별시,광진구,54세,2018,5400,2657,2743,96.9,4962,2445,2517,97.1
서울특별시,광진구,55~59세,2018,29158,13981,15177,92.1,27187,13088,14099,92.8
서울특별시,광진구,55세,2018,5837,2891,2946,98.1,5256,2627,2629,99.9
서울특별시,광진구,56세,2018,5797,2831,2966,95.4,5382,2653,2729,97.2
서울특별시,광진구,57세,2018,5912,2747,3165,86.8,5655,2641,3014,87.6
서울특별시,광진구,58세,2018,6149,2943,3206,91.8,5745,2750,2995,91.8
서울특별시,광진구,59세,2018,5463,2569,2894,88.8,5149,2417,2732,88.5
서울특별시,광진구,60~64세,2018,23857,11490,12367,92.9,22428,10799,11629,92.9
서울특별시,광진구,60세,2018,5323,2565,2758,93,4981,2404,2577,93.3
서울특별시,광진구,61세,2018,5173,2517,2656,94.8,4819,2338,2481,94.2
서울특별시,광진구,62세,2018,4660,2223,2437,91.2,4412,2103,2309,91.1
서울특별시,광진구,63세,2018,4760,2265,2495,90.8,4502,2144,2358,90.9
서울특별시,광진구,64세,2018,3941,1920,2021,95,3714,1810,1904,95.1
서울특별시,광진구,65~69세,2018,15301,7232,8069,89.6,14714,6973,7741,90.1
서울특별시,광진구,65세,2018,3468,1649,1819,90.7,3286,1563,1723,90.7
서울특별시,광진구,66세,2018,3707,1769,1938,91.3,3567,1708,1859,91.9
서울특별시,광진구,67세,2018,2578,1190,1388,85.7,2473,1151,1322,87.1
서울특별시,광진구,68세,2018,2728,1287,1441,89.3,2645,1248,1397,89.3
서울특별시,광진구,69세,2018,2820,1337,1483,90.2,2743,1303,1440,90.5
서울특별시,광진구,70~74세,2018,11773,5484,6289,87.2,11598,5405,6193,87.3
서울특별시,광진구,70세,2018,2796,1314,1482,88.7,2742,1287,1455,88.5
서울특별시,광진구,71세,2018,2704,1227,1477,83.1,2664,1211,1453,83.3
서울특별시,광진구,72세,2018,2162,1024,1138,90,2125,1006,1119,89.9
서울특별시,광진구,73세,2018,2023,974,1049,92.9,2001,967,1034,93.5
서울특별시,광진구,74세,2018,2088,945,1143,82.7,2066,934,1132,82.5
서울특별시,광진구,75~79세,2018,8966,4131,4835,85.4,8881,4099,4782,85.7
서울특별시,광진구,75세,2018,1974,913,1061,86.1,1952,906,1046,86.6
서울특별시,광진구,76세,2018,2239,1042,1197,87.1,2210,1028,1182,87
서울특별시,광진구,77세,2018,1738,792,946,83.7,1727,786,941,83.5
서울특별시,광진구,78세,2018,1553,722,831,86.9,1542,718,824,87.1
서울특별시,광진구,79세,2018,1462,662,800,82.8,1450,661,789,83.8
서울특별시,광진구,80~84세,2018,4995,1962,3033,64.7,4926,1945,2981,65.2
서울특별시,광진구,80세,2018,1345,573,772,74.2,1320,568,752,75.5
서울특별시,광진구,81세,2018,1113,462,651,71,1099,459,640,71.7
서울특별시,광진구,82세,2018,932,338,594,56.9,918,335,583,57.5
서울특별시,광진구,83세,2018,884,319,565,56.5,878,318,560,56.8
서울특별시,광진구,84세,2018,721,270,451,59.9,711,265,446,59.4
서울특별시,광진구,85세이상,2018,3085,896,2189,40.9,3061,892,2169,41.1
서울특별시,광진구,85~89세,2018,2164,671,1493,44.9,2145,668,1477,45.2
서울특별시,광진구,85세,2018,592,198,394,50.3,584,197,387,50.9
서울특별시,광진구,86세,2018,545,174,371,46.9,542,174,368,47.3
서울특별시,광진구,87세,2018,384,116,268,43.3,382,116,266,43.6
서울특별시,광진구,88세,2018,343,94,249,37.8,339,93,246,37.8
서울특별시,광진구,89세,2018,300,89,211,42.2,298,88,210,41.9
서울특별시,광진구,90~94세,2018,711,187,524,35.7,707,186,521,35.7
서울특별시,광진구,90세,2018,238,63,175,36,238,63,175,36
서울특별시,광진구,91세,2018,183,50,133,37.6,180,49,131,37.4
서울특별시,광진구,92세,2018,112,23,89,25.8,112,23,89,25.8
서울특별시,광진구,93세,2018,97,28,69,40.6,96,28,68,41.2
서울특별시,광진구,94세,2018,81,23,58,39.7,81,23,58,39.7
서울특별시,광진구,95~99세,2018,183,36,147,24.5,182,36,146,24.7
서울특별시,광진구,95세,2018,58,10,48,20.8,57,10,47,21.3
서울특별시,광진구,96세,2018,50,9,41,22,50,9,41,22
서울특별시,광진구,97세,2018,39,8,31,25.8,39,8,31,25.8
서울특별시,광진구,98세,2018,20,X,16,25,20,X,16,25
서울특별시,광진구,99세,2018,16,5,11,45.5,16,5,11,45.5
서울특별시,광진구,100세이상,2018,27,X,25,8,27,X,25,8
서울특별시,광진구,15세미만,2018,35016,17952,17064,105.2,34282,17567,16715,105.1
서울특별시,광진구,15~64세,2018,283168,138105,145063,95.2,265113,129849,135264,96
서울특별시,광진구,65세이상,2018,44120,19705,24415,80.7,43180,19314,23866,80.9
서울특별시,광진구,평균연령,2018,41,40.4,41.5,,41.1,40.4,41.7,
서울특별시,광진구,중위연령,2018,40,39.5,40.6,,40.2,39.6,41,
서울특별시,동대문구,합계,2018,358141,176323,181818,97,338293,167999,170294,98.7
서울특별시,동대문구,0~4세,2018,11274,5802,5472,106,11046,5698,5348,106.5
서울특별시,동대문구,0세,2018,1957,1032,925,111.6,1916,1011,905,111.7
서울특별시,동대문구,1세,2018,2154,1113,1041,106.9,2114,1093,1021,107.1
서울특별시,동대문구,2세,2018,2398,1230,1168,105.3,2339,1205,1134,106.3
서울특별시,동대문구,3세,2018,2443,1228,1215,101.1,2386,1206,1180,102.2
서울특별시,동대문구,4세,2018,2322,1199,1123,106.8,2291,1183,1108,106.8
서울특별시,동대문구,5~9세,2018,11456,5901,5555,106.2,11329,5824,5505,105.8
서울특별시,동대문구,5세,2018,2346,1227,1119,109.7,2311,1208,1103,109.5
서울특별시,동대문구,6세,2018,2371,1208,1163,103.9,2350,1196,1154,103.6
서울특별시,동대문구,7세,2018,2333,1177,1156,101.8,2307,1157,1150,100.6
서울특별시,동대문구,8세,2018,2235,1166,1069,109.1,2216,1155,1061,108.9
서울특별시,동대문구,9세,2018,2171,1123,1048,107.2,2145,1108,1037,106.8
서울특별시,동대문구,10~14세,2018,11169,5740,5429,105.7,11071,5692,5379,105.8
서울특별시,동대문구,10세,2018,2338,1176,1162,101.2,2318,1165,1153,101
서울특별시,동대문구,11세,2018,2325,1220,1105,110.4,2298,1204,1094,110.1
서울특별시,동대문구,12세,2018,2205,1146,1059,108.2,2181,1137,1044,108.9
서울특별시,동대문구,13세,2018,2037,1042,995,104.7,2021,1037,984,105.4
서울특별시,동대문구,14세,2018,2264,1156,1108,104.3,2253,1149,1104,104.1
서울특별시,동대문구,15~19세,2018,16903,8066,8837,91.3,15614,7604,8010,94.9
서울특별시,동대문구,15세,2018,2313,1175,1138,103.3,2303,1169,1134,103.1
서울특별시,동대문구,16세,2018,2272,1144,1128,101.4,2253,1139,1114,102.2
서울특별시,동대문구,17세,2018,2748,1384,1364,101.5,2700,1367,1333,102.6
서울특별시,동대문구,18세,2018,3850,1842,2008,91.7,3513,1717,1796,95.6
서울특별시,동대문구,19세,2018,5720,2521,3199,78.8,4845,2212,2633,84
서울특별시,동대문구,20~24세,2018,35535,16232,19303,84.1,28989,13987,15002,93.2
서울특별시,동대문구,20세,2018,6674,2836,3838,73.9,5213,2311,2902,79.6
서울특별시,동대문구,21세,2018,6589,2768,3821,72.4,5196,2325,2871,81
서울특별시,동대문구,22세,2018,7367,3301,4066,81.2,5950,2824,3126,90.3
서울특별시,동대문구,23세,2018,7408,3520,3888,90.5,6181,3095,3086,100.3
서울특별시,동대문구,24세,2018,7497,3807,3690,103.2,6449,3432,3017,113.8
서울특별시,동대문구,25~29세,2018,31871,16924,14947,113.2,28790,15669,13121,119.4
서울특별시,동대문구,25세,2018,7261,3806,3455,110.2,6416,3497,2919,119.8
서울특별시,동대문구,26세,2018,7015,3767,3248,116,6335,3495,2840,123.1
서울특별시,동대문구,27세,2018,6241,3353,2888,116.1,5712,3136,2576,121.7
서울특별시,동대문구,28세,2018,5870,3106,2764,112.4,5348,2853,2495,114.3
서울특별시,동대문구,29세,2018,5484,2892,2592,111.6,4979,2688,2291,117.3
서울특별시,동대문구,30~34세,2018,25495,13214,12281,107.6,23657,12345,11312,109.1
서울특별시,동대문구,30세,2018,5186,2640,2546,103.7,4766,2478,2288,108.3
서울특별시,동대문구,31세,2018,5049,2646,2403,110.1,4617,2439,2178,112
서울특별시,동대문구,32세,2018,5167,2728,2439,111.8,4788,2527,2261,111.8
서울특별시,동대문구,33세,2018,4985,2561,2424,105.7,4668,2410,2258,106.7
서울특별시,동대문구,34세,2018,5108,2639,2469,106.9,4818,2491,2327,107
서울특별시,동대문구,35~39세,2018,28161,14580,13581,107.4,26897,13933,12964,107.5
서울특별시,동대문구,35세,2018,5561,2878,2683,107.3,5273,2741,2532,108.3
서울특별시,동대문구,36세,2018,5851,2992,2859,104.7,5565,2842,2723,104.4
서울특별시,동대문구,37세,2018,5725,2964,2761,107.4,5506,2851,2655,107.4
서울특별시,동대문구,38세,2018,5672,2970,2702,109.9,5441,2850,2591,110
서울특별시,동대문구,39세,2018,5352,2776,2576,107.8,5112,2649,2463,107.6
서울특별시,동대문구,40~44세,2018,24714,12841,11873,108.2,23692,12299,11393,108
서울특별시,동대문구,40세,2018,4803,2503,2300,108.8,4578,2373,2205,107.6
서울특별시,동대문구,41세,2018,4880,2491,2389,104.3,4683,2395,2288,104.7
서울특별시,동대문구,42세,2018,4815,2527,2288,110.4,4602,2421,2181,111
서울특별시,동대문구,43세,2018,4983,2598,2385,108.9,4807,2497,2310,108.1
서울특별시,동대문구,44세,2018,5233,2722,2511,108.4,5022,2613,2409,108.5
서울특별시,동대문구,45~49세,2018,27862,14176,13686,103.6,26729,13591,13138,103.4
서울특별시,동대문구,45세,2018,5305,2707,2598,104.2,5102,2605,2497,104.3
서울특별시,동대문구,46세,2018,5556,2913,2643,110.2,5325,2780,2545,109.2
서울특별시,동대문구,47세,2018,5831,3012,2819,106.8,5606,2903,2703,107.4
서울특별시,동대문구,48세,2018,5586,2794,2792,100.1,5351,2662,2689,99
서울특별시,동대문구,49세,2018,5584,2750,2834,97,5345,2641,2704,97.7
서울특별시,동대문구,50~54세,2018,26127,13037,13090,99.6,25093,12564,12529,100.3
서울특별시,동대문구,50세,2018,5518,2743,2775,98.8,5319,2650,2669,99.3
서울특별시,동대문구,51세,2018,5093,2459,2634,93.4,4921,2390,2531,94.4
서울특별시,동대문구,52세,2018,5107,2663,2444,109,4894,2567,2327,110.3
서울특별시,동대문구,53세,2018,5342,2660,2682,99.2,5108,2546,2562,99.4
서울특별시,동대문구,54세,2018,5067,2512,2555,98.3,4851,2411,2440,98.8
서울특별시,동대문구,55~59세,2018,28042,13583,14459,93.9,27141,13146,13995,93.9
서울특별시,동대문구,55세,2018,5323,2652,2671,99.3,5063,2517,2546,98.9
서울특별시,동대문구,56세,2018,5457,2659,2798,95,5246,2572,2674,96.2
서울특별시,동대문구,57세,2018,5812,2821,2991,94.3,5692,2758,2934,94
서울특별시,동대문구,58세,2018,5956,2822,3134,90,5775,2737,3038,90.1
서울특별시,동대문구,59세,2018,5494,2629,2865,91.8,5365,2562,2803,91.4
서울특별시,동대문구,60~64세,2018,24931,12094,12837,94.2,24211,11766,12445,94.5
서울특별시,동대문구,60세,2018,5378,2639,2739,96.3,5215,2576,2639,97.6
서울특별시,동대문구,61세,2018,5188,2498,2690,92.9,5008,2407,2601,92.5
서울특별시,동대문구,62세,2018,4906,2403,2503,96,4774,2340,2434,96.1
서울특별시,동대문구,63세,2018,5078,2445,2633,92.9,4938,2384,2554,93.3
서울특별시,동대문구,64세,2018,4381,2109,2272,92.8,4276,2059,2217,92.9
서울특별시,동대문구,65~69세,2018,17578,8353,9225,90.5,17232,8187,9045,90.5
서울특별시,동대문구,65세,2018,3835,1857,1978,93.9,3738,1820,1918,94.9
서울특별시,동대문구,66세,2018,4063,1871,2192,85.4,3983,1829,2154,84.9
서울특별시,동대문구,67세,2018,3050,1456,1594,91.3,2984,1421,1563,90.9
서울특별시,동대문구,68세,2018,3359,1641,1718,95.5,3306,1612,1694,95.2
서울특별시,동대문구,69세,2018,3271,1528,1743,87.7,3221,1505,1716,87.7
서울특별시,동대문구,70~74세,2018,14562,6522,8040,81.1,14450,6474,7976,81.2
서울특별시,동대문구,70세,2018,3313,1484,1829,81.1,3277,1468,1809,81.1
서울특별시,동대문구,71세,2018,3383,1517,1866,81.3,3354,1502,1852,81.1
서울특별시,동대문구,72세,2018,2683,1245,1438,86.6,2662,1234,1428,86.4
서울특별시,동대문구,73세,2018,2602,1163,1439,80.8,2590,1162,1428,81.4
서울특별시,동대문구,74세,2018,2581,1113,1468,75.8,2567,1108,1459,75.9
서울특별시,동대문구,75~79세,2018,11996,5372,6624,81.1,11945,5353,6592,81.2
서울특별시,동대문구,75세,2018,2670,1249,1421,87.9,2658,1241,1417,87.6
서울특별시,동대문구,76세,2018,2970,1321,1649,80.1,2962,1320,1642,80.4
서울특별시,동대문구,77세,2018,2335,1067,1268,84.1,2324,1061,1263,84
서울특별시,동대문구,78세,2018,2059,879,1180,74.5,2044,876,1168,75
서울특별시,동대문구,79세,2018,1962,856,1106,77.4,1957,855,1102,77.6
서울특별시,동대문구,80~84세,2018,6669,2698,3971,67.9,6629,2684,3945,68
서울특별시,동대문구,80세,2018,1732,735,997,73.7,1725,733,992,73.9
서울특별시,동대문구,81세,2018,1483,605,878,68.9,1469,601,868,69.2
서울특별시,동대문구,82세,2018,1294,533,761,70,1286,530,756,70.1
서울특별시,동대문구,83세,2018,1177,463,714,64.8,1169,461,708,65.1
서울특별시,동대문구,84세,2018,983,362,621,58.3,980,359,621,57.8
서울특별시,동대문구,85세이상,2018,3796,1188,2608,45.6,3778,1183,2595,45.6
서울특별시,동대문구,85~89세,2018,2711,900,1811,49.7,2694,896,1798,49.8
서울특별시,동대문구,85세,2018,767,257,510,50.4,760,256,504,50.8
서울특별시,동대문구,86세,2018,689,252,437,57.7,684,250,434,57.6
서울특별시,동대문구,87세,2018,470,153,317,48.3,469,153,316,48.4
서울특별시,동대문구,88세,2018,425,131,294,44.6,422,130,292,44.5
서울특별시,동대문구,89세,2018,360,107,253,42.3,359,107,252,42.5
서울특별시,동대문구,90~94세,2018,849,223,626,35.6,848,222,626,35.5
서울특별시,동대문구,90세,2018,282,89,193,46.1,282,89,193,46.1
서울특별시,동대문구,91세,2018,238,63,175,36,238,63,175,36
서울특별시,동대문구,92세,2018,140,26,114,22.8,139,25,114,21.9
서울특별시,동대문구,93세,2018,109,28,81,34.6,109,28,81,34.6
서울특별시,동대문구,94세,2018,80,17,63,27,80,17,63,27
서울특별시,동대문구,95~99세,2018,211,60,151,39.7,211,60,151,39.7
서울특별시,동대문구,95세,2018,88,27,61,44.3,88,27,61,44.3
서울특별시,동대문구,96세,2018,51,10,41,24.4,51,10,41,24.4
서울특별시,동대문구,97세,2018,31,7,24,29.2,31,7,24,29.2
서울특별시,동대문구,98세,2018,29,10,19,52.6,29,10,19,52.6
서울특별시,동대문구,99세,2018,12,6,6,100,12,6,6,100
서울특별시,동대문구,100세이상,2018,25,5,20,25,25,5,20,25
서울특별시,동대문구,15세미만,2018,33899,17443,16456,106,33446,17214,16232,106
서울특별시,동대문구,15~64세,2018,269641,134747,134894,99.9,250813,126904,123909,102.4
서울특별시,동대문구,65세이상,2018,54601,24133,30468,79.2,54034,23881,30153,79.2
서울특별시,동대문구,평균연령,2018,42.1,41.4,42.8,,42.7,41.7,43.6,
서울특별시,동대문구,중위연령,2018,41.5,40.7,42.4,,42.5,41.4,43.8,
서울특별시,중랑구,합계,2018,391668,193599,198069,97.7,385082,190871,194211,98.3
서울특별시,중랑구,0~4세,2018,12974,6685,6289,106.3,12811,6598,6213,106.2
서울특별시,중랑구,0세,2018,2396,1258,1138,110.5,2364,1244,1120,111.1
서울특별시,중랑구,1세,2018,2483,1247,1236,100.9,2444,1230,1214,101.3
서울특별시,중랑구,2세,2018,2683,1378,1305,105.6,2650,1356,1294,104.8
서울특별시,중랑구,3세,2018,2766,1458,1308,111.5,2740,1444,1296,111.4
서울특별시,중랑구,4세,2018,2646,1344,1302,103.2,2613,1324,1289,102.7
서울특별시,중랑구,5~9세,2018,13069,6673,6396,104.3,12953,6624,6329,104.7
서울특별시,중랑구,5세,2018,2658,1356,1302,104.1,2636,1345,1291,104.2
서울특별시,중랑구,6세,2018,2798,1437,1361,105.6,2768,1425,1343,106.1
서울특별시,중랑구,7세,2018,2678,1376,1302,105.7,2659,1366,1293,105.6
서울특별시,중랑구,8세,2018,2530,1285,1245,103.2,2508,1275,1233,103.4
서울특별시,중랑구,9세,2018,2405,1219,1186,102.8,2382,1213,1169,103.8
서울특별시,중랑구,10~14세,2018,12685,6536,6149,106.3,12612,6498,6114,106.3
서울특별시,중랑구,10세,2018,2583,1294,1289,100.4,2560,1281,1279,100.2
서울특별시,중랑구,11세,2018,2589,1336,1253,106.6,2575,1328,1247,106.5
서울특별시,중랑구,12세,2018,2447,1320,1127,117.1,2437,1315,1122,117.2
서울특별시,중랑구,13세,2018,2406,1255,1151,109,2395,1249,1146,109
서울특별시,중랑구,14세,2018,2660,1331,1329,100.2,2645,1325,1320,100.4
서울특별시,중랑구,15~19세,2018,16662,8528,8134,104.8,16518,8467,8051,105.2
서울특별시,중랑구,15세,2018,2815,1413,1402,100.8,2800,1405,1395,100.7
서울특별시,중랑구,16세,2018,2882,1507,1375,109.6,2867,1496,1371,109.1
서울특별시,중랑구,17세,2018,3393,1793,1600,112.1,3370,1784,1586,112.5
서울특별시,중랑구,18세,2018,3881,1933,1948,99.2,3836,1917,1919,99.9
서울특별시,중랑구,19세,2018,3691,1882,1809,104,3645,1865,1780,104.8
서울특별시,중랑구,20~24세,2018,25056,12769,12287,103.9,24579,12568,12011,104.6
서울특별시,중랑구,20세,2018,4145,2226,1919,116,4064,2198,1866,117.8
서울특별시,중랑구,21세,2018,4693,2449,2244,109.1,4600,2402,2198,109.3
서울특별시,중랑구,22세,2018,5023,2571,2452,104.9,4944,2534,2410,105.1
서울특별시,중랑구,23세,2018,5403,2702,2701,100,5290,2659,2631,101.1
서울특별시,중랑구,24세,2018,5792,2821,2971,95,5681,2775,2906,95.5
서울특별시,중랑구,25~29세,2018,30637,15120,15517,97.4,29778,14787,14991,98.6
서울특별시,중랑구,25세,2018,6101,3056,3045,100.4,5957,3000,2957,101.5
서울특별시,중랑구,26세,2018,6550,3235,3315,97.6,6387,3160,3227,97.9
서울특별시,중랑구,27세,2018,6136,2976,3160,94.2,5972,2913,3059,95.2
서울특별시,중랑구,28세,2018,6019,2957,3062,96.6,5841,2891,2950,98
서울특별시,중랑구,29세,2018,5831,2896,2935,98.7,5621,2823,2798,100.9
서울특별시,중랑구,30~34세,2018,29173,14878,14295,104.1,28306,14503,13803,105.1
서울특별시,중랑구,30세,2018,5804,2908,2896,100.4,5626,2837,2789,101.7
서울특별시,중랑구,31세,2018,5794,2933,2861,102.5,5596,2841,2755,103.1
서울특별시,중랑구,32세,2018,5903,3043,2860,106.4,5732,2976,2756,108
서울특별시,중랑구,33세,2018,5784,2942,2842,103.5,5619,2864,2755,104
서울특별시,중랑구,34세,2018,5888,3052,2836,107.6,5733,2985,2748,108.6
서울특별시,중랑구,35~39세,2018,32088,16898,15190,111.2,31436,16631,14805,112.3
서울특별시,중랑구,35세,2018,6267,3297,2970,111,6121,3238,2883,112.3
서울특별시,중랑구,36세,2018,6607,3472,3135,110.7,6483,3421,3062,111.7
서울특별시,중랑구,37세,2018,6599,3501,3098,113,6471,3456,3015,114.6
서울특별시,중랑구,38세,2018,6583,3446,3137,109.9,6465,3391,3074,110.3
서울특별시,중랑구,39세,2018,6032,3182,2850,111.6,5896,3125,2771,112.8
서울특별시,중랑구,40~44세,2018,26894,13994,12900,108.5,26378,13782,12596,109.4
서울특별시,중랑구,40세,2018,5197,2780,2417,115,5091,2731,2360,115.7
서울특별시,중랑구,41세,2018,5420,2838,2582,109.9,5321,2801,2520,111.2
서울특별시,중랑구,42세,2018,5157,2693,2464,109.3,5042,2648,2394,110.6
서울특별시,중랑구,43세,2018,5296,2704,2592,104.3,5198,2662,2536,105
서울특별시,중랑구,44세,2018,5824,2979,2845,104.7,5726,2940,2786,105.5
서울특별시,중랑구,45~49세,2018,32495,16231,16264,99.8,31845,15966,15879,100.5
서울특별시,중랑구,45세,2018,6011,3018,2993,100.8,5903,2971,2932,101.3
서울특별시,중랑구,46세,2018,6143,3072,3071,100,6007,3020,2987,101.1
서울특별시,중랑구,47세,2018,6823,3485,3338,104.4,6694,3431,3263,105.1
서울특별시,중랑구,48세,2018,6581,3260,3321,98.2,6433,3201,3232,99
서울특별시,중랑구,49세,2018,6937,3396,3541,95.9,6808,3343,3465,96.5
서울특별시,중랑구,50~54세,2018,33261,16069,17192,93.5,32629,15803,16826,93.9
서울특별시,중랑구,50세,2018,6946,3286,3660,89.8,6829,3235,3594,90
서울특별시,중랑구,51세,2018,6500,3099,3401,91.1,6398,3060,3338,91.7
서울특별시,중랑구,52세,2018,6423,3159,3264,96.8,6285,3093,3192,96.9
서울특별시,중랑구,53세,2018,6784,3267,3517,92.9,6646,3226,3420,94.3
서울특별시,중랑구,54세,2018,6608,3258,3350,97.3,6471,3189,3282,97.2
서울특별시,중랑구,55~59세,2018,36505,17780,18725,95,35921,17552,18369,95.6
서울특별시,중랑구,55세,2018,6848,3324,3524,94.3,6692,3264,3428,95.2
서울특별시,중랑구,56세,2018,7259,3640,3619,100.6,7123,3582,3541,101.2
서울특별시,중랑구,57세,2018,7786,3715,4071,91.3,7708,3684,4024,91.6
서울특별시,중랑구,58세,2018,7744,3752,3992,94,7627,3705,3922,94.5
서울특별시,중랑구,59세,2018,6868,3349,3519,95.2,6771,3317,3454,96
서울특별시,중랑구,60~64세,2018,30603,14861,15742,94.4,30148,14669,15479,94.8
서울특별시,중랑구,60세,2018,6683,3284,3399,96.6,6576,3241,3335,97.2
서울특별시,중랑구,61세,2018,6457,3128,3329,94,6346,3083,3263,94.5
서울특별시,중랑구,62세,2018,6004,2936,3068,95.7,5931,2903,3028,95.9
서울특별시,중랑구,63세,2018,6218,2938,3280,89.6,6135,2902,3233,89.8
서울특별시,중랑구,64세,2018,5241,2575,2666,96.6,5160,2540,2620,96.9
서울특별시,중랑구,65~69세,2018,20753,9947,10806,92.1,20516,9842,10674,92.2
서울특별시,중랑구,65세,2018,4555,2181,2374,91.9,4487,2150,2337,92
서울특별시,중랑구,66세,2018,4901,2364,2537,93.2,4845,2340,2505,93.4
서울특별시,중랑구,67세,2018,3545,1663,1882,88.4,3502,1646,1856,88.7
서울특별시,중랑구,68세,2018,3846,1876,1970,95.2,3815,1865,1950,95.6
서울특별시,중랑구,69세,2018,3906,1863,2043,91.2,3867,1841,2026,90.9
서울특별시,중랑구,70~74세,2018,16096,7423,8673,85.6,16003,7392,8611,85.8
서울특별시,중랑구,70세,2018,3778,1776,2002,88.7,3752,1766,1986,88.9
서울특별시,중랑구,71세,2018,3836,1771,2065,85.8,3812,1761,2051,85.9
서울특별시,중랑구,72세,2018,2943,1373,1570,87.5,2925,1369,1556,88
서울특별시,중랑구,73세,2018,2764,1256,1508,83.3,2751,1252,1499,83.5
서울특별시,중랑구,74세,2018,2775,1247,1528,81.6,2763,1244,1519,81.9
서울특별시,중랑구,75~79세,2018,12388,5588,6800,82.2,12354,5575,6779,82.2
서울특별시,중랑구,75세,2018,2712,1231,1481,83.1,2702,1227,1475,83.2
서울특별시,중랑구,76세,2018,3143,1413,1730,81.7,3138,1411,1727,81.7
서울특별시,중랑구,77세,2018,2444,1135,1309,86.7,2441,1134,1307,86.8
서울특별시,중랑구,78세,2018,2124,931,1193,78,2113,927,1186,78.2
서울특별시,중랑구,79세,2018,1965,878,1087,80.8,1960,876,1084,80.8
서울특별시,중랑구,80~84세,2018,6519,2597,3922,66.2,6500,2595,3905,66.5
서울특별시,중랑구,80세,2018,1680,701,979,71.6,1675,701,974,72
서울특별시,중랑구,81세,2018,1476,623,853,73,1470,622,848,73.3
서울특별시,중랑구,82세,2018,1296,527,769,68.5,1293,527,766,68.8
서울특별시,중랑구,83세,2018,1127,409,718,57,1124,408,716,57
서울특별시,중랑구,84세,2018,940,337,603,55.9,938,337,601,56.1
서울특별시,중랑구,85세이상,2018,3810,1022,2788,36.7,3795,1019,2776,36.7
서울특별시,중랑구,85~89세,2018,2664,771,1893,40.7,2653,768,1885,40.7
서울특별시,중랑구,85세,2018,751,248,503,49.3,749,248,501,49.5
서울특별시,중랑구,86세,2018,615,212,403,52.6,611,210,401,52.4
서울특별시,중랑구,87세,2018,512,135,377,35.8,509,134,375,35.7
서울특별시,중랑구,88세,2018,434,94,340,27.6,432,94,338,27.8
서울특별시,중랑구,89세,2018,352,82,270,30.4,352,82,270,30.4
서울특별시,중랑구,90~94세,2018,892,201,691,29.1,888,201,687,29.3
서울특별시,중랑구,90세,2018,320,70,250,28,320,70,250,28
서울특별시,중랑구,91세,2018,215,57,158,36.1,213,57,156,36.5
서울특별시,중랑구,92세,2018,150,34,116,29.3,149,34,115,29.6
서울특별시,중랑구,93세,2018,113,21,92,22.8,113,21,92,22.8
서울특별시,중랑구,94세,2018,94,19,75,25.3,93,19,74,25.7
서울특별시,중랑구,95~99세,2018,228,48,180,26.7,228,48,180,26.7
서울특별시,중랑구,95세,2018,90,23,67,34.3,90,23,67,34.3
서울특별시,중랑구,96세,2018,57,8,49,16.3,57,8,49,16.3
서울특별시,중랑구,97세,2018,40,13,27,48.1,40,13,27,48.1
서울특별시,중랑구,98세,2018,21,X,18,16.7,21,X,18,16.7
서울특별시,중랑구,99세,2018,20,X,19,5.3,20,X,19,5.3
서울특별시,중랑구,100세이상,2018,26,X,24,8.3,26,X,24,8.3
서울특별시,중랑구,15세미만,2018,38728,19894,18834,105.6,38376,19720,18656,105.7
서울특별시,중랑구,15~64세,2018,293374,147128,146246,100.6,287538,144728,142810,101.3
서울특별시,중랑구,65세이상,2018,59566,26577,32989,80.6,59168,26423,32745,80.7
서울특별시,중랑구,평균연령,2018,43.4,42.5,44.2,,43.4,42.5,44.3,
서울특별시,중랑구,중위연령,2018,44.4,43.1,45.6,,44.5,43.2,45.7,
서울특별시,성북구,합계,2018,438734,211204,227530,92.8,424211,205031,219180,93.5
서울특별시,성북구,0~4세,2018,14176,7295,6881,106,13949,7182,6767,106.1
서울특별시,성북구,0세,2018,2271,1183,1088,108.7,2234,1164,1070,108.8
서울특별시,성북구,1세,2018,2665,1363,1302,104.7,2603,1336,1267,105.4
서울특별시,성북구,2세,2018,2981,1516,1465,103.5,2925,1487,1438,103.4
서울특별시,성북구,3세,2018,3153,1638,1515,108.1,3114,1616,1498,107.9
서울특별시,성북구,4세,2018,3106,1595,1511,105.6,3073,1579,1494,105.7
서울특별시,성북구,5~9세,2018,16649,8539,8110,105.3,16519,8478,8041,105.4
서울특별시,성북구,5세,2018,3131,1576,1555,101.4,3091,1555,1536,101.2
서울특별시,성북구,6세,2018,3494,1842,1652,111.5,3474,1831,1643,111.4
서울특별시,성북구,7세,2018,3470,1775,1695,104.7,3447,1769,1678,105.4
서울특별시,성북구,8세,2018,3381,1705,1676,101.7,3354,1694,1660,102
서울특별시,성북구,9세,2018,3173,1641,1532,107.1,3153,1629,1524,106.9
서울특별시,성북구,10~14세,2018,17371,8999,8372,107.5,17274,8947,8327,107.4
서울특별시,성북구,10세,2018,3458,1801,1657,108.7,3440,1790,1650,108.5
서울특별시,성북구,11세,2018,3666,1908,1758,108.5,3642,1896,1746,108.6
서울특별시,성북구,12세,2018,3276,1659,1617,102.6,3257,1651,1606,102.8
서울특별시,성북구,13세,2018,3284,1735,1549,112,3271,1728,1543,112
서울특별시,성북구,14세,2018,3687,1896,1791,105.9,3664,1882,1782,105.6
서울특별시,성북구,15~19세,2018,24511,11677,12834,91,23528,11353,12175,93.2
서울특별시,성북구,15세,2018,3588,1856,1732,107.2,3572,1845,1727,106.8
서울특별시,성북구,16세,2018,3646,1836,1810,101.4,3628,1826,1802,101.3
서울특별시,성북구,17세,2018,4173,2076,2097,99,4108,2051,2057,99.7
서울특별시,성북구,18세,2018,5388,2540,2848,89.2,5105,2449,2656,92.2
서울특별시,성북구,19세,2018,7716,3369,4347,77.5,7115,3182,3933,80.9
서울특별시,성북구,20~24세,2018,40660,18033,22627,79.7,35882,16334,19548,83.6
서울특별시,성북구,20세,2018,8184,3373,4811,70.1,7060,3014,4046,74.5
서울특별시,성북구,21세,2018,7914,3182,4732,67.2,6834,2820,4014,70.3
서울특별시,성북구,22세,2018,8103,3551,4552,78,7136,3196,3940,81.1
서울특별시,성북구,23세,2018,8326,3850,4476,86,7391,3499,3892,89.9
서울특별시,성북구,24세,2018,8133,4077,4056,100.5,7461,3805,3656,104.1
서울특별시,성북구,25~29세,2018,34569,17685,16884,104.7,32381,16734,15647,106.9
서울특별시,성북구,25세,2018,7862,4059,3803,106.7,7322,3818,3504,109
서울특별시,성북구,26세,2018,7618,3904,3714,105.1,7130,3692,3438,107.4
서울특별시,성북구,27세,2018,6956,3622,3334,108.6,6568,3464,3104,111.6
서울특별시,성북구,28세,2018,6321,3144,3177,99,5923,2986,2937,101.7
서울특별시,성북구,29세,2018,5812,2956,2856,103.5,5438,2774,2664,104.1
서울특별시,성북구,30~34세,2018,28462,14220,14242,99.8,26929,13471,13458,100.1
서울특별시,성북구,30세,2018,5737,2895,2842,101.9,5375,2726,2649,102.9
서울특별시,성북구,31세,2018,5604,2803,2801,100.1,5288,2643,2645,99.9
서울특별시,성북구,32세,2018,5698,2869,2829,101.4,5395,2704,2691,100.5
서울특별시,성북구,33세,2018,5621,2752,2869,95.9,5335,2619,2716,96.4
서울특별시,성북구,34세,2018,5802,2901,2901,100,5536,2779,2757,100.8
서울특별시,성북구,35~39세,2018,33213,16570,16643,99.6,32153,16044,16109,99.6
서울특별시,성북구,35세,2018,6274,3145,3129,100.5,6025,3025,3000,100.8
서울특별시,성북구,36세,2018,6734,3339,3395,98.4,6506,3226,3280,98.4
서울특별시,성북구,37세,2018,6866,3494,3372,103.6,6657,3391,3266,103.8
서울특별시,성북구,38세,2018,6668,3266,3402,96,6483,3177,3306,96.1
서울특별시,성북구,39세,2018,6671,3326,3345,99.4,6482,3225,3257,99
서울특별시,성북구,40~44세,2018,32184,15965,16219,98.4,31380,15553,15827,98.3
서울특별시,성북구,40세,2018,5862,2924,2938,99.5,5657,2823,2834,99.6
서울특별시,성북구,41세,2018,6103,3005,3098,97,5949,2926,3023,96.8
서울특별시,성북구,42세,2018,6234,3089,3145,98.2,6083,3009,3074,97.9
서울특별시,성북구,43세,2018,6669,3293,3376,97.5,6518,3222,3296,97.8
서울특별시,성북구,44세,2018,7316,3654,3662,99.8,7173,3573,3600,99.3
서울특별시,성북구,45~49세,2018,38300,19095,19205,99.4,37459,18672,18787,99.4
서울특별시,성북구,45세,2018,7478,3700,3778,97.9,7310,3601,3709,97.1
서울특별시,성북구,46세,2018,7631,3859,3772,102.3,7457,3778,3679,102.7
서울특별시,성북구,47세,2018,7964,3958,4006,98.8,7788,3869,3919,98.7
서울특별시,성북구,48세,2018,7679,3797,3882,97.8,7514,3717,3797,97.9
서울특별시,성북구,49세,2018,7548,3781,3767,100.4,7390,3707,3683,100.7
서울특별시,성북구,50~54세,2018,32645,16048,16597,96.7,31968,15731,16237,96.9
서울특별시,성북구,50세,2018,7247,3620,3627,99.8,7085,3547,3538,100.3
서울특별시,성북구,51세,2018,6545,3211,3334,96.3,6409,3148,3261,96.5
서울특별시,성북구,52세,2018,6200,3080,3120,98.7,6074,3017,3057,98.7
서울특별시,성북구,53세,2018,6393,3124,3269,95.6,6264,3070,3194,96.1
서울특별시,성북구,54세,2018,6260,3013,3247,92.8,6136,2949,3187,92.5
서울특별시,성북구,55~59세,2018,32881,15748,17133,91.9,32383,15524,16859,92.1
서울특별시,성북구,55세,2018,6373,3067,3306,92.8,6240,3003,3237,92.8
서울특별시,성북구,56세,2018,6430,3109,3321,93.6,6318,3064,3254,94.2
서울특별시,성북구,57세,2018,6771,3258,3513,92.7,6688,3223,3465,93
서울특별시,성북구,58세,2018,6962,3233,3729,86.7,6863,3184,3679,86.5
서울특별시,성북구,59세,2018,6345,3081,3264,94.4,6274,3050,3224,94.6
서울특별시,성북구,60~64세,2018,28680,13558,15122,89.7,28313,13395,14918,89.8
서울특별시,성북구,60세,2018,6156,2967,3189,93,6088,2937,3151,93.2
서울특별시,성북구,61세,2018,6083,2851,3232,88.2,5996,2808,3188,88.1
서울특별시,성북구,62세,2018,5733,2706,3027,89.4,5645,2664,2981,89.4
서울특별시,성북구,63세,2018,5806,2677,3129,85.6,5735,2652,3083,86
서울특별시,성북구,64세,2018,4902,2357,2545,92.6,4849,2334,2515,92.8
서울특별시,성북구,65~69세,2018,20314,9380,10934,85.8,20124,9284,10840,85.6
서울특별시,성북구,65세,2018,4355,2022,2333,86.7,4302,1992,2310,86.2
서울특별시,성북구,66세,2018,4735,2223,2512,88.5,4687,2198,2489,88.3
서울특별시,성북구,67세,2018,3332,1547,1785,86.7,3300,1530,1770,86.4
서울특별시,성북구,68세,2018,3906,1804,2102,85.8,3876,1790,2086,85.8
서울특별시,성북구,69세,2018,3986,1784,2202,81,3959,1774,2185,81.2
서울특별시,성북구,70~74세,2018,16902,7426,9476,78.4,16838,7395,9443,78.3
서울특별시,성북구,70세,2018,3749,1631,2118,77,3733,1624,2109,77
서울특별시,성북구,71세,2018,3981,1776,2205,80.5,3965,1767,2198,80.4
서울특별시,성북구,72세,2018,3116,1354,1762,76.8,3106,1348,1758,76.7
서울특별시,성북구,73세,2018,2999,1331,1668,79.8,2993,1329,1664,79.9
서울특별시,성북구,74세,2018,3057,1334,1723,77.4,3041,1327,1714,77.4
서울특별시,성북구,75~79세,2018,14382,6301,8081,78,14340,6284,8056,78
서울특별시,성북구,75세,2018,3116,1406,1710,82.2,3107,1402,1705,82.2
서울특별시,성북구,76세,2018,3550,1590,1960,81.1,3543,1587,1956,81.1
서울특별시,성북구,77세,2018,2817,1251,1566,79.9,2811,1249,1562,80
서울특별시,성북구,78세,2018,2491,1040,1451,71.7,2483,1037,1446,71.7
서울특별시,성북구,79세,2018,2408,1014,1394,72.7,2396,1009,1387,72.7
서울특별시,성북구,80~84세,2018,8056,3202,4854,66,8031,3193,4838,66
서울특별시,성북구,80세,2018,2064,872,1192,73.2,2059,870,1189,73.2
서울특별시,성북구,81세,2018,1811,724,1087,66.6,1808,723,1085,66.6
서울특별시,성북구,82세,2018,1573,610,963,63.3,1563,608,955,63.7
서울특별시,성북구,83세,2018,1475,563,912,61.7,1473,562,911,61.7
서울특별시,성북구,84세,2018,1133,433,700,61.9,1128,430,698,61.6
서울특별시,성북구,85세이상,2018,4779,1463,3316,44.1,4760,1457,3303,44.1
서울특별시,성북구,85~89세,2018,3368,1104,2264,48.8,3353,1100,2253,48.8
서울특별시,성북구,85세,2018,940,353,587,60.1,933,352,581,60.6
서울특별시,성북구,86세,2018,771,253,518,48.8,767,252,515,48.9
서울특별시,성북구,87세,2018,643,206,437,47.1,642,205,437,46.9
서울특별시,성북구,88세,2018,552,165,387,42.6,551,165,386,42.7
서울특별시,성북구,89세,2018,462,127,335,37.9,460,126,334,37.7
서울특별시,성북구,90~94세,2018,1137,279,858,32.5,1134,278,856,32.5
서울특별시,성북구,90세,2018,391,102,289,35.3,391,102,289,35.3
서울특별시,성북구,91세,2018,305,77,228,33.8,305,77,228,33.8
서울특별시,성북구,92세,2018,207,50,157,31.8,204,49,155,31.6
서울특별시,성북구,93세,2018,138,26,112,23.2,138,26,112,23.2
서울특별시,성북구,94세,2018,96,24,72,33.3,96,24,72,33.3
서울특별시,성북구,95~99세,2018,254,71,183,38.8,254,71,183,38.8
서울특별시,성북구,95세,2018,88,23,65,35.4,88,23,65,35.4
서울특별시,성북구,96세,2018,70,24,46,52.2,70,24,46,52.2
서울특별시,성북구,97세,2018,42,11,31,35.5,42,11,31,35.5
서울특별시,성북구,98세,2018,30,5,25,20,30,5,25,20
서울특별시,성북구,99세,2018,24,8,16,50,24,8,16,50
서울특별시,성북구,100세이상,2018,20,9,11,81.8,19,8,11,72.7
서울특별시,성북구,15세미만,2018,48196,24833,23363,106.3,47742,24607,23135,106.4
서울특별시,성북구,15~64세,2018,326105,158599,167506,94.7,312376,152811,159565,95.8
서울특별시,성북구,65세이상,2018,64433,27772,36661,75.8,64093,27613,36480,75.7
서울특별시,성북구,평균연령,2018,41.5,40.8,42.3,,41.9,41,42.7,
서울특별시,성북구,중위연령,2018,41.6,40.9,42.4,,42.3,41.4,43.2,
서울특별시,강북구,합계,2018,309138,150028,159110,94.3,304191,148057,156134,94.8
서울특별시,강북구,0~4세,2018,8662,4394,4268,103,8591,4360,4231,103
서울특별시,강북구,0세,2018,1421,736,685,107.4,1395,721,674,107
서울특별시,강북구,1세,2018,1673,834,839,99.4,1657,829,828,100.1
서울특별시,강북구,2세,2018,1830,921,909,101.3,1820,914,906,100.9
서울특별시,강북구,3세,2018,1868,958,910,105.3,1858,956,902,106
서울특별시,강북구,4세,2018,1870,945,925,102.2,1861,940,921,102.1
서울특별시,강북구,5~9세,2018,10021,5185,4836,107.2,9987,5172,4815,107.4
서울특별시,강북구,5세,2018,1957,1037,920,112.7,1949,1032,917,112.5
서울특별시,강북구,6세,2018,2026,1057,969,109.1,2014,1051,963,109.1
서울특별시,강북구,7세,2018,2049,1040,1009,103.1,2046,1040,1006,103.4
서울특별시,강북구,8세,2018,2008,1041,967,107.7,2000,1039,961,108.1
서울특별시,강북구,9세,2018,1981,1010,971,104,1978,1010,968,104.3
서울특별시,강북구,10~14세,2018,10310,5267,5043,104.4,10288,5259,5029,104.6
서울특별시,강북구,10세,2018,2022,1011,1011,100,2015,1008,1007,100.1
서울특별시,강북구,11세,2018,2078,1088,990,109.9,2073,1087,986,110.2
서울특별시,강북구,12세,2018,2022,1051,971,108.2,2020,1050,970,108.2
서울특별시,강북구,13세,2018,2002,1025,977,104.9,1999,1024,975,105
서울특별시,강북구,14세,2018,2186,1092,1094,99.8,2181,1090,1091,99.9
서울특별시,강북구,15~19세,2018,13789,7028,6761,103.9,13644,6970,6674,104.4
서울특별시,강북구,15세,2018,2365,1240,1125,110.2,2358,1237,1121,110.3
서울특별시,강북구,16세,2018,2375,1245,1130,110.2,2367,1241,1126,110.2
서울특별시,강북구,17세,2018,2773,1440,1333,108,2764,1437,1327,108.3
서울특별시,강북구,18세,2018,3117,1627,1490,109.2,3085,1615,1470,109.9
서울특별시,강북구,19세,2018,3159,1476,1683,87.7,3070,1440,1630,88.3
서울특별시,강북구,20~24세,2018,20968,9964,11004,90.5,20345,9746,10599,92
서울특별시,강북구,20세,2018,3671,1719,1952,88.1,3566,1676,1890,88.7
서울특별시,강북구,21세,2018,4024,1902,2122,89.6,3913,1861,2052,90.7
서울특별시,강북구,22세,2018,4218,2010,2208,91,4112,1979,2133,92.8
서울특별시,강북구,23세,2018,4372,2086,2286,91.3,4212,2030,2182,93
서울특별시,강북구,24세,2018,4683,2247,2436,92.2,4542,2200,2342,93.9
서울특별시,강북구,25~29세,2018,22283,11125,11158,99.7,21548,10874,10674,101.9
서울특별시,강북구,25세,2018,4630,2304,2326,99.1,4506,2255,2251,100.2
서울특별시,강북구,26세,2018,4905,2394,2511,95.3,4740,2340,2400,97.5
서울특별시,강북구,27세,2018,4558,2229,2329,95.7,4420,2181,2239,97.4
서울특별시,강북구,28세,2018,4118,2112,2006,105.3,3958,2059,1899,108.4
서울특별시,강북구,29세,2018,4072,2086,1986,105,3924,2039,1885,108.2
서울특별시,강북구,30~34세,2018,19541,10212,9329,109.5,18917,9975,8942,111.6
서울특별시,강북구,30세,2018,3872,1981,1891,104.8,3728,1926,1802,106.9
서울특별시,강북구,31세,2018,3771,1985,1786,111.1,3648,1940,1708,113.6
서울특별시,강북구,32세,2018,3926,2065,1861,111,3785,2012,1773,113.5
서울특별시,강북구,33세,2018,3883,2004,1879,106.7,3775,1967,1808,108.8
서울특별시,강북구,34세,2018,4089,2177,1912,113.9,3981,2130,1851,115.1
서울특별시,강북구,35~39세,2018,23054,12092,10962,110.3,22598,11890,10708,111
서울특별시,강북구,35세,2018,4329,2251,2078,108.3,4227,2208,2019,109.4
서울특별시,강북구,36세,2018,4731,2435,2296,106.1,4614,2381,2233,106.6
서울특별시,강북구,37세,2018,4639,2502,2137,117.1,4552,2462,2090,117.8
서울특별시,강북구,38세,2018,4793,2518,2275,110.7,4708,2480,2228,111.3
서울특별시,강북구,39세,2018,4562,2386,2176,109.7,4497,2359,2138,110.3
서울특별시,강북구,40~44세,2018,21840,11178,10662,104.8,21488,11034,10454,105.5
서울특별시,강북구,40세,2018,4019,2040,1979,103.1,3943,2010,1933,104
서울특별시,강북구,41세,2018,4269,2203,2066,106.6,4199,2171,2028,107.1
서울특별시,강북구,42세,2018,4165,2166,1999,108.4,4103,2141,1962,109.1
서울특별시,강북구,43세,2018,4438,2271,2167,104.8,4365,2243,2122,105.7
서울특별시,강북구,44세,2018,4949,2498,2451,101.9,4878,2469,2409,102.5
서울특별시,강북구,45~49세,2018,26698,13331,13367,99.7,26298,13147,13151,100
서울특별시,강북구,45세,2018,5109,2551,2558,99.7,5028,2517,2511,100.2
서울특별시,강북구,46세,2018,5223,2715,2508,108.3,5154,2689,2465,109.1
서울특별시,강북구,47세,2018,5541,2774,2767,100.3,5451,2728,2723,100.2
서울특별시,강북구,48세,2018,5388,2687,2701,99.5,5307,2652,2655,99.9
서울특별시,강북구,49세,2018,5437,2604,2833,91.9,5358,2561,2797,91.6
서울특별시,강북구,50~54세,2018,25031,12072,12959,93.2,24620,11908,12712,93.7
서울특별시,강북구,50세,2018,5414,2602,2812,92.5,5339,2569,2770,92.7
서울특별시,강북구,51세,2018,4942,2369,2573,92.1,4870,2340,2530,92.5
서울특별시,강북구,52세,2018,4758,2322,2436,95.3,4680,2291,2389,95.9
서울특별시,강북구,53세,2018,5068,2404,2664,90.2,4974,2365,2609,90.6
서울특별시,강북구,54세,2018,4849,2375,2474,96,4757,2343,2414,97.1
서울특별시,강북구,55~59세,2018,27243,12991,14252,91.2,26803,12801,14002,91.4
서울특별시,강북구,55세,2018,5242,2615,2627,99.5,5128,2561,2567,99.8
서울특별시,강북구,56세,2018,5159,2523,2636,95.7,5068,2493,2575,96.8
서울특별시,강북구,57세,2018,5746,2682,3064,87.5,5686,2655,3031,87.6
서울특별시,강북구,58세,2018,5857,2683,3174,84.5,5751,2632,3119,84.4
서울특별시,강북구,59세,2018,5239,2488,2751,90.4,5170,2460,2710,90.8
서울특별시,강북구,60~64세,2018,23944,11255,12689,88.7,23614,11112,12502,88.9
서울특별시,강북구,60세,2018,5135,2432,2703,90,5065,2401,2664,90.1
서울특별시,강북구,61세,2018,4938,2404,2534,94.9,4862,2368,2494,94.9
서울특별시,강북구,62세,2018,4683,2194,2489,88.1,4637,2176,2461,88.4
서울특별시,강북구,63세,2018,4965,2292,2673,85.7,4893,2264,2629,86.1
서울특별시,강북구,64세,2018,4223,1933,2290,84.4,4157,1903,2254,84.4
서울특별시,강북구,65~69세,2018,17701,7926,9775,81.1,17522,7846,9676,81.1
서울특별시,강북구,65세,2018,3645,1662,1983,83.8,3595,1640,1955,83.9
서울특별시,강북구,66세,2018,4062,1849,2213,83.6,4018,1830,2188,83.6
서울특별시,강북구,67세,2018,3083,1395,1688,82.6,3051,1379,1672,82.5
서울특별시,강북구,68세,2018,3338,1437,1901,75.6,3305,1425,1880,75.8
서울특별시,강북구,69세,2018,3573,1583,1990,79.5,3553,1572,1981,79.4
서울특별시,강북구,70~74세,2018,15193,6644,8549,77.7,15130,6619,8511,77.8
서울특별시,강북구,70세,2018,3503,1546,1957,79,3487,1538,1949,78.9
서울특별시,강북구,71세,2018,3539,1546,1993,77.6,3527,1542,1985,77.7
서울특별시,강북구,72세,2018,2720,1166,1554,75,2707,1161,1546,75.1
서울특별시,강북구,73세,2018,2742,1151,1591,72.3,2728,1148,1580,72.7
서울특별시,강북구,74세,2018,2689,1235,1454,84.9,2681,1230,1451,84.8
서울특별시,강북구,75~79세,2018,12664,5587,7077,78.9,12634,5575,7059,79
서울특별시,강북구,75세,2018,2795,1211,1584,76.5,2789,1208,1581,76.4
서울특별시,강북구,76세,2018,3236,1476,1760,83.9,3232,1474,1758,83.8
서울특별시,강북구,77세,2018,2534,1148,1386,82.8,2527,1145,1382,82.9
서울특별시,강북구,78세,2018,2090,925,1165,79.4,2085,924,1161,79.6
서울특별시,강북구,79세,2018,2009,827,1182,70,2001,824,1177,70
서울특별시,강북구,80~84세,2018,6587,2695,3892,69.2,6571,2692,3879,69.4
서울특별시,강북구,80세,2018,1741,725,1016,71.4,1735,724,1011,71.6
서울특별시,강북구,81세,2018,1469,631,838,75.3,1466,631,835,75.6
서울특별시,강북구,82세,2018,1372,558,814,68.6,1368,557,811,68.7
서울특별시,강북구,83세,2018,1125,453,672,67.4,1123,452,671,67.4
서울특별시,강북구,84세,2018,880,328,552,59.4,879,328,551,59.5
서울특별시,강북구,85세이상,2018,3609,1082,2527,42.8,3593,1077,2516,42.8
서울특별시,강북구,85~89세,2018,2529,811,1718,47.2,2520,808,1712,47.2
서울특별시,강북구,85세,2018,693,253,440,57.5,691,253,438,57.8
서울특별시,강북구,86세,2018,617,214,403,53.1,617,214,403,53.1
서울특별시,강북구,87세,2018,435,127,308,41.2,433,126,307,41
서울특별시,강북구,88세,2018,411,107,304,35.2,409,107,302,35.4
서울특별시,강북구,89세,2018,373,110,263,41.8,370,108,262,41.2
서울특별시,강북구,90~94세,2018,839,209,630,33.2,832,207,625,33.1
서울특별시,강북구,90세,2018,279,81,198,40.9,277,81,196,41.3
서울특별시,강북구,91세,2018,196,46,150,30.7,196,46,150,30.7
서울특별시,강북구,92세,2018,151,38,113,33.6,149,37,112,33
서울특별시,강북구,93세,2018,120,26,94,27.7,117,25,92,27.2
서울특별시,강북구,94세,2018,93,18,75,24,93,18,75,24
서울특별시,강북구,95~99세,2018,214,54,160,33.8,214,54,160,33.8
서울특별시,강북구,95세,2018,73,23,50,46,73,23,50,46
서울특별시,강북구,96세,2018,61,15,46,32.6,61,15,46,32.6
서울특별시,강북구,97세,2018,41,10,31,32.3,41,10,31,32.3
서울특별시,강북구,98세,2018,24,5,19,26.3,24,5,19,26.3
서울특별시,강북구,99세,2018,15,X,14,7.1,15,X,14,7.1
서울특별시,강북구,100세이상,2018,27,8,19,42.1,27,8,19,42.1
서울특별시,강북구,15세미만,2018,28993,14846,14147,104.9,28866,14791,14075,105.1
서울특별시,강북구,15~64세,2018,224391,111248,113143,98.3,219875,109457,110418,99.1
서울특별시,강북구,65세이상,2018,55754,23934,31820,75.2,55450,23809,31641,75.2
서울특별시,강북구,평균연령,2018,44.5,43.4,45.6,,44.6,43.4,45.7,
서울특별시,강북구,중위연령,2018,45.8,44.4,47.2,,45.9,44.5,47.4,
서울특별시,도봉구,합계,2018,328243,159569,168674,94.6,325292,158370,166922,94.9
서울특별시,도봉구,0~4세,2018,10236,5258,4978,105.6,10172,5227,4945,105.7
서울특별시,도봉구,0세,2018,1708,902,806,111.9,1691,896,795,112.7
서울특별시,도봉구,1세,2018,1874,964,910,105.9,1861,959,902,106.3
서울특별시,도봉구,2세,2018,2154,1090,1064,102.4,2140,1085,1055,102.8
서울특별시,도봉구,3세,2018,2250,1151,1099,104.7,2238,1143,1095,104.4
서울특별시,도봉구,4세,2018,2250,1151,1099,104.7,2242,1144,1098,104.2
서울특별시,도봉구,5~9세,2018,11549,5989,5560,107.7,11521,5972,5549,107.6
서울특별시,도봉구,5세,2018,2155,1135,1020,111.3,2147,1131,1016,111.3
서울특별시,도봉구,6세,2018,2428,1265,1163,108.8,2423,1263,1160,108.9
서울특별시,도봉구,7세,2018,2379,1216,1163,104.6,2374,1213,1161,104.5
서울특별시,도봉구,8세,2018,2345,1209,1136,106.4,2340,1205,1135,106.2
서울특별시,도봉구,9세,2018,2242,1164,1078,108,2237,1160,1077,107.7
서울특별시,도봉구,10~14세,2018,12250,6323,5927,106.7,12231,6314,5917,106.7
서울특별시,도봉구,10세,2018,2307,1206,1101,109.5,2304,1206,1098,109.8
서울특별시,도봉구,11세,2018,2630,1366,1264,108.1,2626,1363,1263,107.9
서울특별시,도봉구,12세,2018,2311,1197,1114,107.5,2308,1196,1112,107.6
서울특별시,도봉구,13세,2018,2269,1138,1131,100.6,2263,1135,1128,100.6
서울특별시,도봉구,14세,2018,2733,1416,1317,107.5,2730,1414,1316,107.4
서울특별시,도봉구,15~19세,2018,16096,8147,7949,102.5,16013,8113,7900,102.7
서울특별시,도봉구,15세,2018,2636,1344,1292,104,2629,1340,1289,104
서울특별시,도봉구,16세,2018,2853,1466,1387,105.7,2849,1464,1385,105.7
서울특별시,도봉구,17세,2018,3283,1748,1535,113.9,3277,1744,1533,113.8
서울특별시,도봉구,18세,2018,3688,1843,1845,99.9,3671,1837,1834,100.2
서울특별시,도봉구,19세,2018,3636,1746,1890,92.4,3587,1728,1859,93
서울특별시,도봉구,20~24세,2018,21818,10767,11051,97.4,21449,10632,10817,98.3
서울특별시,도봉구,20세,2018,3929,1868,2061,90.6,3845,1843,2002,92.1
서울특별시,도봉구,21세,2018,4401,2217,2184,101.5,4334,2194,2140,102.5
서울특별시,도봉구,22세,2018,4417,2195,2222,98.8,4347,2168,2179,99.5
서울특별시,도봉구,23세,2018,4549,2239,2310,96.9,4473,2206,2267,97.3
서울특별시,도봉구,24세,2018,4522,2248,2274,98.9,4450,2221,2229,99.6
서울특별시,도봉구,25~29세,2018,22565,11387,11178,101.9,22129,11225,10904,102.9
서울특별시,도봉구,25세,2018,4850,2499,2351,106.3,4762,2458,2304,106.7
서울특별시,도봉구,26세,2018,4812,2390,2422,98.7,4718,2359,2359,100
서울특별시,도봉구,27세,2018,4535,2281,2254,101.2,4466,2261,2205,102.5
서울특별시,도봉구,28세,2018,4203,2097,2106,99.6,4114,2062,2052,100.5
서울특별시,도봉구,29세,2018,4165,2120,2045,103.7,4069,2085,1984,105.1
서울특별시,도봉구,30~34세,2018,20165,10348,9817,105.4,19764,10182,9582,106.3
서울특별시,도봉구,30세,2018,4018,2052,1966,104.4,3932,2016,1916,105.2
서울특별시,도봉구,31세,2018,3871,1982,1889,104.9,3790,1954,1836,106.4
서울특별시,도봉구,32세,2018,4005,2061,1944,106,3929,2021,1908,105.9
서울특별시,도봉구,33세,2018,4121,2091,2030,103,4041,2061,1980,104.1
서울특별시,도봉구,34세,2018,4150,2162,1988,108.8,4072,2130,1942,109.7
서울특별시,도봉구,35~39세,2018,23924,12175,11749,103.6,23616,12044,11572,104.1
서울특별시,도봉구,35세,2018,4586,2396,2190,109.4,4516,2369,2147,110.3
서울특별시,도봉구,36세,2018,4911,2468,2443,101,4842,2434,2408,101.1
서울특별시,도봉구,37세,2018,4887,2482,2405,103.2,4828,2459,2369,103.8
서울특별시,도봉구,38세,2018,4873,2466,2407,102.5,4823,2447,2376,103
서울특별시,도봉구,39세,2018,4667,2363,2304,102.6,4607,2335,2272,102.8
서울특별시,도봉구,40~44세,2018,22591,11281,11310,99.7,22357,11190,11167,100.2
서울특별시,도봉구,40세,2018,4161,2081,2080,100,4100,2056,2044,100.6
서울특별시,도봉구,41세,2018,4363,2214,2149,103,4322,2197,2125,103.4
서울특별시,도봉구,42세,2018,4361,2196,2165,101.4,4313,2182,2131,102.4
서울특별시,도봉구,43세,2018,4633,2237,2396,93.4,4596,2225,2371,93.8
서울특별시,도봉구,44세,2018,5073,2553,2520,101.3,5026,2530,2496,101.4
서울특별시,도봉구,45~49세,2018,28487,13758,14729,93.4,28235,13640,14595,93.5
서울특별시,도봉구,45세,2018,5400,2577,2823,91.3,5353,2555,2798,91.3
서울특별시,도봉구,46세,2018,5444,2739,2705,101.3,5391,2710,2681,101.1
서울특별시,도봉구,47세,2018,5959,2864,3095,92.5,5897,2832,3065,92.4
서울특별시,도봉구,48세,2018,5853,2810,3043,92.3,5805,2793,3012,92.7
서울특별시,도봉구,49세,2018,5831,2768,3063,90.4,5789,2750,3039,90.5
서울특별시,도봉구,50~54세,2018,27557,13058,14499,90.1,27333,12967,14366,90.3
서울특별시,도봉구,50세,2018,5974,2809,3165,88.8,5925,2790,3135,89
서울특별시,도봉구,51세,2018,5440,2540,2900,87.6,5395,2518,2877,87.5
서울특별시,도봉구,52세,2018,5355,2610,2745,95.1,5308,2599,2709,95.9
서울특별시,도봉구,53세,2018,5529,2595,2934,88.4,5483,2572,2911,88.4
서울특별시,도봉구,54세,2018,5259,2504,2755,90.9,5222,2488,2734,91
서울특별시,도봉구,55~59세,2018,30145,14217,15928,89.3,29953,14143,15810,89.5
서울특별시,도봉구,55세,2018,5641,2784,2857,97.4,5594,2764,2830,97.7
서울특별시,도봉구,56세,2018,5830,2757,3073,89.7,5787,2744,3043,90.2
서울특별시,도봉구,57세,2018,6280,2904,3376,86,6245,2892,3353,86.3
서울특별시,도봉구,58세,2018,6506,3032,3474,87.3,6469,3013,3456,87.2
서울특별시,도봉구,59세,2018,5888,2740,3148,87,5858,2730,3128,87.3
서울특별시,도봉구,60~64세,2018,26469,12721,13748,92.5,26299,12650,13649,92.7
서울특별시,도봉구,60세,2018,5694,2682,3012,89,5660,2667,2993,89.1
서울특별시,도봉구,61세,2018,5748,2809,2939,95.6,5707,2790,2917,95.6
서울특별시,도봉구,62세,2018,5208,2476,2732,90.6,5165,2457,2708,90.7
서울특별시,도봉구,63세,2018,5417,2575,2842,90.6,5390,2565,2825,90.8
서울특별시,도봉구,64세,2018,4402,2179,2223,98,4377,2171,2206,98.4
서울특별시,도봉구,65~69세,2018,17603,8513,9090,93.7,17515,8475,9040,93.8
서울특별시,도봉구,65세,2018,3836,1907,1929,98.9,3818,1898,1920,98.9
서울특별시,도봉구,66세,2018,4189,2023,2166,93.4,4159,2009,2150,93.4
서울특별시,도봉구,67세,2018,3036,1450,1586,91.4,3020,1446,1574,91.9
서울특별시,도봉구,68세,2018,3312,1590,1722,92.3,3299,1585,1714,92.5
서울특별시,도봉구,69세,2018,3230,1543,1687,91.5,3219,1537,1682,91.4
서울특별시,도봉구,70~74세,2018,14061,6537,7524,86.9,14025,6520,7505,86.9
서울특별시,도봉구,70세,2018,3316,1603,1713,93.6,3306,1598,1708,93.6
서울특별시,도봉구,71세,2018,3271,1504,1767,85.1,3264,1501,1763,85.1
서울특별시,도봉구,72세,2018,2532,1184,1348,87.8,2527,1182,1345,87.9
서울특별시,도봉구,73세,2018,2495,1153,1342,85.9,2487,1149,1338,85.9
서울특별시,도봉구,74세,2018,2447,1093,1354,80.7,2441,1090,1351,80.7
서울특별시,도봉구,75~79세,2018,11747,5257,6490,81,11724,5250,6474,81.1
서울특별시,도봉구,75세,2018,2541,1139,1402,81.2,2537,1138,1399,81.3
서울특별시,도봉구,76세,2018,2886,1348,1538,87.6,2881,1348,1533,87.9
서울특별시,도봉구,77세,2018,2335,1074,1261,85.2,2330,1071,1259,85.1
서울특별시,도봉구,78세,2018,2001,865,1136,76.1,1997,864,1133,76.3
서울특별시,도봉구,79세,2018,1984,831,1153,72.1,1979,829,1150,72.1
서울특별시,도봉구,80~84세,2018,6573,2548,4025,63.3,6559,2545,4014,63.4
서울특별시,도봉구,80세,2018,1667,697,970,71.9,1663,695,968,71.8
서울특별시,도봉구,81세,2018,1492,596,896,66.5,1489,596,893,66.7
서울특별시,도봉구,82세,2018,1298,490,808,60.6,1295,489,806,60.7
서울특별시,도봉구,83세,2018,1163,439,724,60.6,1160,439,721,60.9
서울특별시,도봉구,84세,2018,953,326,627,52,952,326,626,52.1
서울특별시,도봉구,85세이상,2018,4407,1285,3122,41.2,4397,1281,3116,41.1
서울특별시,도봉구,85~89세,2018,3075,955,2120,45,3071,955,2116,45.1
서울특별시,도봉구,85세,2018,844,291,553,52.6,844,291,553,52.6
서울특별시,도봉구,86세,2018,734,216,518,41.7,734,216,518,41.7
서울특별시,도봉구,87세,2018,567,175,392,44.6,565,175,390,44.9
서울특별시,도봉구,88세,2018,485,140,345,40.6,484,140,344,40.7
서울특별시,도봉구,89세,2018,445,133,312,42.6,444,133,311,42.8
서울특별시,도봉구,90~94세,2018,1046,266,780,34.1,1043,265,778,34.1
서울특별시,도봉구,90세,2018,348,96,252,38.1,347,95,252,37.7
서울특별시,도봉구,91세,2018,268,77,191,40.3,268,77,191,40.3
서울특별시,도봉구,92세,2018,183,48,135,35.6,182,48,134,35.8
서울특별시,도봉구,93세,2018,150,28,122,23,149,28,121,23.1
서울특별시,도봉구,94세,2018,97,17,80,21.3,97,17,80,21.3
서울특별시,도봉구,95~99세,2018,254,57,197,28.9,253,56,197,28.4
서울특별시,도봉구,95세,2018,115,28,87,32.2,114,27,87,31
서울특별시,도봉구,96세,2018,58,14,44,31.8,58,14,44,31.8
서울특별시,도봉구,97세,2018,41,8,33,24.2,41,8,33,24.2
서울특별시,도봉구,98세,2018,25,X,24,4.2,25,X,24,4.2
서울특별시,도봉구,99세,2018,15,6,9,66.7,15,6,9,66.7
서울특별시,도봉구,100세이상,2018,32,7,25,28,30,5,25,20
서울특별시,도봉구,15세미만,2018,34035,17570,16465,106.7,33924,17513,16411,106.7
서울특별시,도봉구,15~64세,2018,239817,117859,121958,96.6,237148,116786,120362,97
서울특별시,도봉구,65세이상,2018,54391,24140,30251,79.8,54220,24071,30149,79.8
서울특별시,도봉구,평균연령,2018,43.9,42.8,44.9,,43.9,42.9,45,
서울특별시,도봉구,중위연령,2018,45.5,44.3,46.7,,45.6,44.3,46.9,
서울특별시,노원구,합계,2018,534096,258737,275359,94,528268,256124,272144,94.1
서울특별시,노원구,0~4세,2018,17276,8904,8372,106.4,17198,8864,8334,106.4
서울특별시,노원구,0세,2018,2893,1506,1387,108.6,2875,1499,1376,108.9
서울특별시,노원구,1세,2018,3264,1646,1618,101.7,3242,1630,1612,101.1
서울특별시,노원구,2세,2018,3569,1846,1723,107.1,3561,1840,1721,106.9
서울특별시,노원구,3세,2018,3816,1993,1823,109.3,3804,1989,1815,109.6
서울특별시,노원구,4세,2018,3734,1913,1821,105.1,3716,1906,1810,105.3
서울특별시,노원구,5~9세,2018,20384,10441,9943,105,20333,10416,9917,105
서울특별시,노원구,5세,2018,3696,1892,1804,104.9,3683,1886,1797,105
서울특별시,노원구,6세,2018,4159,2142,2017,106.2,4148,2138,2010,106.4
서울특별시,노원구,7세,2018,4155,2114,2041,103.6,4146,2110,2036,103.6
서울특별시,노원구,8세,2018,4200,2149,2051,104.8,4190,2143,2047,104.7
서울특별시,노원구,9세,2018,4174,2144,2030,105.6,4166,2139,2027,105.5
서울특별시,노원구,10~14세,2018,25257,13096,12161,107.7,25229,13082,12147,107.7
서울특별시,노원구,10세,2018,4741,2434,2307,105.5,4735,2431,2304,105.5
서울특별시,노원구,11세,2018,4977,2560,2417,105.9,4971,2555,2416,105.8
서울특별시,노원구,12세,2018,4854,2562,2292,111.8,4850,2560,2290,111.8
서울특별시,노원구,13세,2018,5048,2619,2429,107.8,5042,2616,2426,107.8
서울특별시,노원구,14세,2018,5637,2921,2716,107.5,5631,2920,2711,107.7
서울특별시,노원구,15~19세,2018,34359,17751,16608,106.9,33932,17564,16368,107.3
서울특별시,노원구,15세,2018,5760,3033,2727,111.2,5754,3030,2724,111.2
서울특별시,노원구,16세,2018,5886,3050,2836,107.5,5876,3045,2831,107.6
서울특별시,노원구,17세,2018,6767,3572,3195,111.8,6741,3559,3182,111.8
서울특별시,노원구,18세,2018,7787,4066,3721,109.3,7708,4025,3683,109.3
서울특별시,노원구,19세,2018,8159,4030,4129,97.6,7853,3905,3948,98.9
서울특별시,노원구,20~24세,2018,42934,21683,21251,102,41554,21037,20517,102.5
서울특별시,노원구,20세,2018,8590,4131,4459,92.6,8232,3987,4245,93.9
서울특별시,노원구,21세,2018,8460,4103,4357,94.2,8173,3953,4220,93.7
서울특별시,노원구,22세,2018,8642,4388,4254,103.1,8404,4263,4141,102.9
서울특별시,노원구,23세,2018,8814,4569,4245,107.6,8554,4450,4104,108.4
서울특별시,노원구,24세,2018,8428,4492,3936,114.1,8191,4384,3807,115.2
서울특별시,노원구,25~29세,2018,35102,18300,16802,108.9,34236,17889,16347,109.4
서울특별시,노원구,25세,2018,8066,4391,3675,119.5,7859,4278,3581,119.5
서울특별시,노원구,26세,2018,7601,4052,3549,114.2,7428,3977,3451,115.2
서울특별시,노원구,27세,2018,6882,3510,3372,104.1,6722,3436,3286,104.6
서울특별시,노원구,28세,2018,6408,3278,3130,104.7,6235,3199,3036,105.4
서울특별시,노원구,29세,2018,6145,3069,3076,99.8,5992,2999,2993,100.2
서울특별시,노원구,30~34세,2018,31004,15406,15598,98.8,30322,15114,15208,99.4
서울특별시,노원구,30세,2018,5908,2932,2976,98.5,5757,2869,2888,99.3
서울특별시,노원구,31세,2018,6014,3006,3008,99.9,5863,2943,2920,100.8
서울특별시,노원구,32세,2018,6317,3114,3203,97.2,6180,3056,3124,97.8
서울특별시,노원구,33세,2018,6320,3172,3148,100.8,6188,3120,3068,101.7
서울특별시,노원구,34세,2018,6445,3182,3263,97.5,6334,3126,3208,97.4
서울특별시,노원구,35~39세,2018,38653,19198,19455,98.7,38135,18977,19158,99.1
서울특별시,노원구,35세,2018,7247,3616,3631,99.6,7130,3569,3561,100.2
서울특별시,노원구,36세,2018,7776,3864,3912,98.8,7668,3820,3848,99.3
서울특별시,노원구,37세,2018,7772,3946,3826,103.1,7658,3895,3763,103.5
서울특별시,노원구,38세,2018,8065,3913,4152,94.2,7983,3882,4101,94.7
서울특별시,노원구,39세,2018,7793,3859,3934,98.1,7696,3811,3885,98.1
서울특별시,노원구,40~44세,2018,39914,19011,20903,90.9,39514,18820,20694,90.9
서울특별시,노원구,40세,2018,7135,3474,3661,94.9,7042,3430,3612,95
서울특별시,노원구,41세,2018,7672,3625,4047,89.6,7589,3586,4003,89.6
서울특별시,노원구,42세,2018,7500,3632,3868,93.9,7432,3598,3834,93.8
서울특별시,노원구,43세,2018,8358,3894,4464,87.2,8277,3854,4423,87.1
서울특별시,노원구,44세,2018,9249,4386,4863,90.2,9174,4352,4822,90.3
서울특별시,노원구,45~49세,2018,51235,24533,26702,91.9,50824,24335,26489,91.9
서울특별시,노원구,45세,2018,9742,4625,5117,90.4,9674,4595,5079,90.5
서울특별시,노원구,46세,2018,9927,4699,5228,89.9,9850,4659,5191,89.8
서울특별시,노원구,47세,2018,10910,5217,5693,91.6,10825,5169,5656,91.4
서울특별시,노원구,48세,2018,10383,4985,5398,92.3,10296,4947,5349,92.5
서울특별시,노원구,49세,2018,10273,5007,5266,95.1,10179,4965,5214,95.2
서울특별시,노원구,50~54세,2018,44072,21555,22517,95.7,43699,21395,22304,95.9
서울특별시,노원구,50세,2018,9939,4799,5140,93.4,9862,4765,5097,93.5
서울특별시,노원구,51세,2018,9016,4390,4626,94.9,8941,4358,4583,95.1
서울특별시,노원구,52세,2018,8491,4260,4231,100.7,8422,4224,4198,100.6
서울특별시,노원구,53세,2018,8574,4124,4450,92.7,8503,4095,4408,92.9
서울특별시,노원구,54세,2018,8052,3982,4070,97.8,7971,3953,4018,98.4
서울특별시,노원구,55~59세,2018,43323,20655,22668,91.1,43059,20565,22494,91.4
서울특별시,노원구,55세,2018,8470,4045,4425,91.4,8393,4023,4370,92.1
서울특별시,노원구,56세,2018,8571,4195,4376,95.9,8520,4175,4345,96.1
서울특별시,노원구,57세,2018,9047,4358,4689,92.9,9001,4344,4657,93.3
서울특별시,노원구,58세,2018,9082,4236,4846,87.4,9030,4217,4813,87.6
서울특별시,노원구,59세,2018,8153,3821,4332,88.2,8115,3806,4309,88.3
서울특별시,노원구,60~64세,2018,36264,17043,19221,88.7,36083,16971,19112,88.8
서울특별시,노원구,60세,2018,7888,3746,4142,90.4,7848,3729,4119,90.5
서울특별시,노원구,61세,2018,7745,3633,4112,88.4,7704,3610,4094,88.2
서울특별시,노원구,62세,2018,7133,3346,3787,88.4,7103,3338,3765,88.7
서울특별시,노원구,63세,2018,7308,3354,3954,84.8,7272,3344,3928,85.1
서울특별시,노원구,64세,2018,6190,2964,3226,91.9,6156,2950,3206,92
서울특별시,노원구,65~69세,2018,24421,11471,12950,88.6,24340,11438,12902,88.7
서울특별시,노원구,65세,2018,5295,2556,2739,93.3,5280,2549,2731,93.3
서울특별시,노원구,66세,2018,5860,2776,3084,90,5836,2767,3069,90.2
서울특별시,노원구,67세,2018,4123,1927,2196,87.8,4109,1924,2185,88.1
서울특별시,노원구,68세,2018,4558,2124,2434,87.3,4546,2119,2427,87.3
서울특별시,노원구,69세,2018,4585,2088,2497,83.6,4569,2079,2490,83.5
서울특별시,노원구,70~74세,2018,18673,8226,10447,78.7,18631,8207,10424,78.7
서울특별시,노원구,70세,2018,4371,2016,2355,85.6,4364,2015,2349,85.8
서울특별시,노원구,71세,2018,4404,1928,2476,77.9,4394,1923,2471,77.8
서울특별시,노원구,72세,2018,3440,1476,1964,75.2,3429,1470,1959,75
서울특별시,노원구,73세,2018,3229,1449,1780,81.4,3225,1448,1777,81.5
서울특별시,노원구,74세,2018,3229,1357,1872,72.5,3219,1351,1868,72.3
서울특별시,노원구,75~79세,2018,15601,6464,9137,70.7,15577,6457,9120,70.8
서울특별시,노원구,75세,2018,3347,1448,1899,76.3,3339,1446,1893,76.4
서울특별시,노원구,76세,2018,3813,1617,2196,73.6,3809,1615,2194,73.6
서울특별시,노원구,77세,2018,3048,1212,1836,66,3045,1212,1833,66.1
서울특별시,노원구,78세,2018,2773,1155,1618,71.4,2769,1153,1616,71.3
서울특별시,노원구,79세,2018,2620,1032,1588,65,2615,1031,1584,65.1
서울특별시,노원구,80~84세,2018,9451,3284,6167,53.3,9439,3279,6160,53.2
서울특별시,노원구,80세,2018,2370,867,1503,57.7,2366,865,1501,57.6
서울특별시,노원구,81세,2018,2122,778,1344,57.9,2122,778,1344,57.9
서울특별시,노원구,82세,2018,1815,634,1181,53.7,1813,634,1179,53.8
서울특별시,노원구,83세,2018,1725,543,1182,45.9,1723,542,1181,45.9
서울특별시,노원구,84세,2018,1419,462,957,48.3,1415,460,955,48.2
서울특별시,노원구,85세이상,2018,6173,1716,4457,38.5,6163,1714,4449,38.5
서울특별시,노원구,85~89세,2018,4327,1306,3021,43.2,4320,1304,3016,43.2
서울특별시,노원구,85세,2018,1148,363,785,46.2,1147,363,784,46.3
서울특별시,노원구,86세,2018,1050,323,727,44.4,1048,323,725,44.6
서울특별시,노원구,87세,2018,791,220,571,38.5,789,220,569,38.7
서울특별시,노원구,88세,2018,748,224,524,42.7,748,224,524,42.7
서울특별시,노원구,89세,2018,590,176,414,42.5,588,174,414,42
서울특별시,노원구,90~94세,2018,1461,326,1135,28.7,1460,326,1134,28.7
서울특별시,노원구,90세,2018,490,121,369,32.8,489,121,368,32.9
서울특별시,노원구,91세,2018,365,78,287,27.2,365,78,287,27.2
서울특별시,노원구,92세,2018,260,52,208,25,260,52,208,25
서울특별시,노원구,93세,2018,185,38,147,25.9,185,38,147,25.9
서울특별시,노원구,94세,2018,161,37,124,29.8,161,37,124,29.8
서울특별시,노원구,95~99세,2018,346,82,264,31.1,346,82,264,31.1
서울특별시,노원구,95세,2018,127,29,98,29.6,127,29,98,29.6
서울특별시,노원구,96세,2018,81,20,61,32.8,81,20,61,32.8
서울특별시,노원구,97세,2018,66,14,52,26.9,66,14,52,26.9
서울특별시,노원구,98세,2018,45,14,31,45.2,45,14,31,45.2
서울특별시,노원구,99세,2018,27,5,22,22.7,27,5,22,22.7
서울특별시,노원구,100세이상,2018,39,X,37,5.4,37,X,35,5.7
서울특별시,노원구,15세미만,2018,62917,32441,30476,106.4,62760,32362,30398,106.5
서울특별시,노원구,15~64세,2018,396860,195135,201725,96.7,391358,192667,198691,97
서울특별시,노원구,65세이상,2018,74319,31161,43158,72.2,74150,31095,43055,72.2
서울특별시,노원구,평균연령,2018,41.6,40.3,42.9,,41.7,40.4,43,
서울특별시,노원구,중위연령,2018,43,41.3,44.3,,43.1,41.5,44.5,
서울특별시,은평구,합계,2018,462552,223452,239100,93.5,456582,220818,235764,93.7
서울특별시,은평구,0~4세,2018,15485,7912,7573,104.5,15362,7848,7514,104.4
서울특별시,은평구,0세,2018,2732,1382,1350,102.4,2705,1370,1335,102.6
서울특별시,은평구,1세,2018,2854,1464,1390,105.3,2824,1447,1377,105.1
서울특별시,은평구,2세,2018,3224,1647,1577,104.4,3201,1632,1569,104
서울특별시,은평구,3세,2018,3411,1725,1686,102.3,3387,1711,1676,102.1
서울특별시,은평구,4세,2018,3264,1694,1570,107.9,3245,1688,1557,108.4
서울특별시,은평구,5~9세,2018,17336,8959,8377,106.9,17262,8913,8349,106.8
서울특별시,은평구,5세,2018,3260,1715,1545,111,3243,1707,1536,111.1
서울특별시,은평구,6세,2018,3658,1895,1763,107.5,3631,1875,1756,106.8
서울특별시,은평구,7세,2018,3513,1797,1716,104.7,3505,1793,1712,104.7
서울특별시,은평구,8세,2018,3461,1783,1678,106.3,3449,1774,1675,105.9
서울특별시,은평구,9세,2018,3444,1769,1675,105.6,3434,1764,1670,105.6
서울특별시,은평구,10~14세,2018,18027,9363,8664,108.1,17961,9330,8631,108.1
서울특별시,은평구,10세,2018,3564,1836,1728,106.3,3551,1829,1722,106.2
서울특별시,은평구,11세,2018,3762,1994,1768,112.8,3753,1989,1764,112.8
서울특별시,은평구,12세,2018,3504,1800,1704,105.6,3497,1798,1699,105.8
서울특별시,은평구,13세,2018,3324,1764,1560,113.1,3312,1756,1556,112.9
서울특별시,은평구,14세,2018,3873,1969,1904,103.4,3848,1958,1890,103.6
서울특별시,은평구,15~19세,2018,22894,11622,11272,103.1,22689,11518,11171,103.1
서울특별시,은평구,15세,2018,4049,2112,1937,109,4026,2101,1925,109.1
서울특별시,은평구,16세,2018,4257,2155,2102,102.5,4222,2137,2085,102.5
서울특별시,은평구,17세,2018,4622,2315,2307,100.3,4587,2303,2284,100.8
서울특별시,은평구,18세,2018,5305,2700,2605,103.6,5252,2666,2586,103.1
서울특별시,은평구,19세,2018,4661,2340,2321,100.8,4602,2311,2291,100.9
서울특별시,은평구,20~24세,2018,28347,14144,14203,99.6,27883,13957,13926,100.2
서울특별시,은평구,20세,2018,4984,2548,2436,104.6,4919,2515,2404,104.6
서울특별시,은평구,21세,2018,5447,2774,2673,103.8,5384,2758,2626,105
서울특별시,은평구,22세,2018,5664,2823,2841,99.4,5579,2793,2786,100.3
서울특별시,은평구,23세,2018,5998,2982,3016,98.9,5883,2938,2945,99.8
서울특별시,은평구,24세,2018,6254,3017,3237,93.2,6118,2953,3165,93.3
서울특별시,은평구,25~29세,2018,33045,15939,17106,93.2,32284,15637,16647,93.9
서울특별시,은평구,25세,2018,6689,3216,3473,92.6,6540,3155,3385,93.2
서울특별시,은평구,26세,2018,6878,3324,3554,93.5,6742,3262,3480,93.7
서울특별시,은평구,27세,2018,6766,3293,3473,94.8,6609,3236,3373,95.9
서울특별시,은평구,28세,2018,6494,3108,3386,91.8,6329,3046,3283,92.8
서울특별시,은평구,29세,2018,6218,2998,3220,93.1,6064,2938,3126,94
서울특별시,은평구,30~34세,2018,31402,15397,16005,96.2,30565,15032,15533,96.8
서울특별시,은평구,30세,2018,6134,2973,3161,94.1,5953,2898,3055,94.9
서울특별시,은평구,31세,2018,6152,2999,3153,95.1,5962,2913,3049,95.5
서울특별시,은평구,32세,2018,6203,3015,3188,94.6,6024,2936,3088,95.1
서울특별시,은평구,33세,2018,6361,3172,3189,99.5,6216,3113,3103,100.3
서울특별시,은평구,34세,2018,6552,3238,3314,97.7,6410,3172,3238,98
서울특별시,은평구,35~39세,2018,38139,19323,18816,102.7,37465,19032,18433,103.2
서울특별시,은평구,35세,2018,7209,3604,3605,100,7069,3546,3523,100.7
서울특별시,은평구,36세,2018,7793,3994,3799,105.1,7635,3924,3711,105.7
서울특별시,은평구,37세,2018,7840,3973,3867,102.7,7712,3913,3799,103
서울특별시,은평구,38세,2018,7961,4052,3909,103.7,7830,3997,3833,104.3
서울특별시,은평구,39세,2018,7336,3700,3636,101.8,7219,3652,3567,102.4
서울특별시,은평구,40~44세,2018,35233,17529,17704,99,34754,17302,17452,99.1
서울특별시,은평구,40세,2018,6440,3167,3273,96.8,6346,3122,3224,96.8
서울특별시,은평구,41세,2018,6949,3485,3464,100.6,6852,3432,3420,100.4
서울특별시,은평구,42세,2018,6825,3433,3392,101.2,6723,3387,3336,101.5
서울특별시,은평구,43세,2018,7142,3541,3601,98.3,7043,3495,3548,98.5
서울특별시,은평구,44세,2018,7877,3903,3974,98.2,7790,3866,3924,98.5
서울특별시,은평구,45~49세,2018,41125,20261,20864,97.1,40645,20023,20622,97.1
서울특별시,은평구,45세,2018,8097,4043,4054,99.7,8020,4002,4018,99.6
서울특별시,은평구,46세,2018,8148,4051,4097,98.9,8053,4001,4052,98.7
서울특별시,은평구,47세,2018,8616,4256,4360,97.6,8515,4211,4304,97.8
서울특별시,은평구,48세,2018,8057,3876,4181,92.7,7949,3827,4122,92.8
서울특별시,은평구,49세,2018,8207,4035,4172,96.7,8108,3982,4126,96.5
서울특별시,은평구,50~54세,2018,36322,17421,18901,92.2,35826,17205,18621,92.4
서울특별시,은평구,50세,2018,7935,3802,4133,92,7821,3760,4061,92.6
서울특별시,은평구,51세,2018,7322,3498,3824,91.5,7236,3455,3781,91.4
서울특별시,은평구,52세,2018,6964,3395,3569,95.1,6888,3358,3530,95.1
서울특별시,은평구,53세,2018,7138,3353,3785,88.6,7030,3311,3719,89
서울특별시,은평구,54세,2018,6963,3373,3590,94,6851,3321,3530,94.1
서울특별시,은평구,55~59세,2018,38339,18103,20236,89.5,37834,17874,19960,89.5
서울특별시,은평구,55세,2018,7288,3478,3810,91.3,7146,3420,3726,91.8
서울특별시,은평구,56세,2018,7443,3613,3830,94.3,7343,3565,3778,94.4
서울특별시,은평구,57세,2018,7924,3731,4193,89,7851,3699,4152,89.1
서울특별시,은평구,58세,2018,8156,3721,4435,83.9,8065,3678,4387,83.8
서울특별시,은평구,59세,2018,7528,3560,3968,89.7,7429,3512,3917,89.7
서울특별시,은평구,60~64세,2018,33231,15478,17753,87.2,32801,15307,17494,87.5
서울특별시,은평구,60세,2018,7117,3332,3785,88,7030,3302,3728,88.6
서울특별시,은평구,61세,2018,6996,3268,3728,87.7,6891,3230,3661,88.2
서울특별시,은평구,62세,2018,6597,3108,3489,89.1,6518,3072,3446,89.1
서울특별시,은평구,63세,2018,6739,3144,3595,87.5,6653,3107,3546,87.6
서울특별시,은평구,64세,2018,5782,2626,3156,83.2,5709,2596,3113,83.4
서울특별시,은평구,65~69세,2018,23603,10800,12803,84.4,23400,10700,12700,84.3
서울특별시,은평구,65세,2018,5169,2339,2830,82.7,5109,2306,2803,82.3
서울특별시,은평구,66세,2018,5335,2531,2804,90.3,5284,2508,2776,90.3
서울특별시,은평구,67세,2018,4021,1811,2210,81.9,3988,1793,2195,81.7
서울특별시,은평구,68세,2018,4480,2062,2418,85.3,4451,2050,2401,85.4
서울특별시,은평구,69세,2018,4598,2057,2541,81,4568,2043,2525,80.9
서울특별시,은평구,70~74세,2018,19678,8769,10909,80.4,19596,8736,10860,80.4
서울특별시,은평구,70세,2018,4585,2070,2515,82.3,4557,2057,2500,82.3
서울특별시,은평구,71세,2018,4593,2056,2537,81,4580,2049,2531,81
서울특별시,은평구,72세,2018,3607,1618,1989,81.3,3593,1611,1982,81.3
서울특별시,은평구,73세,2018,3459,1526,1933,78.9,3449,1522,1927,79
서울특별시,은평구,74세,2018,3434,1499,1935,77.5,3417,1497,1920,78
서울특별시,은평구,75~79세,2018,16212,7228,8984,80.5,16167,7213,8954,80.6
서울특별시,은평구,75세,2018,3552,1534,2018,76,3543,1530,2013,76
서울특별시,은평구,76세,2018,4032,1818,2214,82.1,4018,1813,2205,82.2
서울특별시,은평구,77세,2018,3145,1445,1700,85,3137,1441,1696,85
서울특별시,은평구,78세,2018,2827,1303,1524,85.5,2819,1301,1518,85.7
서울특별시,은평구,79세,2018,2656,1128,1528,73.8,2650,1128,1522,74.1
서울특별시,은평구,80~84세,2018,8991,3660,5331,68.7,8959,3651,5308,68.8
서울특별시,은평구,80세,2018,2280,966,1314,73.5,2269,962,1307,73.6
서울특별시,은평구,81세,2018,2099,886,1213,73,2088,884,1204,73.4
서울특별시,은평구,82세,2018,1776,692,1084,63.8,1773,692,1081,64
서울특별시,은평구,83세,2018,1592,634,958,66.2,1589,632,957,66
서울특별시,은평구,84세,2018,1244,482,762,63.3,1240,481,759,63.4
서울특별시,은평구,85세이상,2018,5143,1544,3599,42.9,5129,1540,3589,42.9
서울특별시,은평구,85~89세,2018,3609,1179,2430,48.5,3600,1175,2425,48.5
서울특별시,은평구,85세,2018,988,347,641,54.1,986,347,639,54.3
서울특별시,은평구,86세,2018,878,309,569,54.3,875,306,569,53.8
서울특별시,은평구,87세,2018,668,199,469,42.4,666,199,467,42.6
서울특별시,은평구,88세,2018,559,159,400,39.8,558,158,400,39.5
서울특별시,은평구,89세,2018,516,165,351,47,515,165,350,47.1
서울특별시,은평구,90~94세,2018,1248,300,948,31.6,1244,300,944,31.8
서울특별시,은평구,90세,2018,409,116,293,39.6,408,116,292,39.7
서울특별시,은평구,91세,2018,326,63,263,24,323,63,260,24.2
서울특별시,은평구,92세,2018,208,55,153,35.9,208,55,153,35.9
서울특별시,은평구,93세,2018,167,30,137,21.9,167,30,137,21.9
서울특별시,은평구,94세,2018,138,36,102,35.3,138,36,102,35.3
서울특별시,은평구,95~99세,2018,260,62,198,31.3,259,62,197,31.5
서울특별시,은평구,95세,2018,112,31,81,38.3,111,31,80,38.8
서울특별시,은평구,96세,2018,61,13,48,27.1,61,13,48,27.1
서울특별시,은평구,97세,2018,40,8,32,25,40,8,32,25
서울특별시,은평구,98세,2018,30,7,23,30.4,30,7,23,30.4
서울특별시,은평구,99세,2018,17,X,14,21.4,17,X,14,21.4
서울특별시,은평구,100세이상,2018,26,X,23,13,26,X,23,13
서울특별시,은평구,15세미만,2018,50848,26234,24614,106.6,50585,26091,24494,106.5
서울특별시,은평구,15~64세,2018,338077,165217,172860,95.6,332746,162887,169859,95.9
서울특별시,은평구,65세이상,2018,73627,32001,41626,76.9,73251,31840,41411,76.9
서울특별시,은평구,평균연령,2018,43,42,44,,43.1,42,44.1,
서울특별시,은평구,중위연령,2018,43.9,42.7,45,,44,42.8,45.1,
서울특별시,서대문구,합계,2018,318874,149438,169436,88.2,304508,144208,160300,90
서울특별시,서대문구,0~4세,2018,10148,5164,4984,103.6,9896,5050,4846,104.2
서울특별시,서대문구,0세,2018,1808,952,856,111.2,1774,940,834,112.7
서울특별시,서대문구,1세,2018,1898,1015,883,114.9,1846,984,862,114.2
서울특별시,서대문구,2세,2018,2127,1076,1051,102.4,2055,1048,1007,104.1
서울특별시,서대문구,3세,2018,2148,1062,1086,97.8,2093,1038,1055,98.4
서울특별시,서대문구,4세,2018,2167,1059,1108,95.6,2128,1040,1088,95.6
서울특별시,서대문구,5~9세,2018,10413,5274,5139,102.6,10227,5172,5055,102.3
서울특별시,서대문구,5세,2018,2039,1047,992,105.5,1999,1023,976,104.8
서울특별시,서대문구,6세,2018,2172,1110,1062,104.5,2134,1092,1042,104.8
서울특별시,서대문구,7세,2018,2067,1013,1054,96.1,2028,990,1038,95.4
서울특별시,서대문구,8세,2018,2046,1062,984,107.9,2005,1037,968,107.1
서울특별시,서대문구,9세,2018,2089,1042,1047,99.5,2061,1030,1031,99.9
서울특별시,서대문구,10~14세,2018,10573,5340,5233,102,10384,5246,5138,102.1
서울특별시,서대문구,10세,2018,2036,1025,1011,101.4,1990,1003,987,101.6
서울특별시,서대문구,11세,2018,2115,1064,1051,101.2,2078,1046,1032,101.4
서울특별시,서대문구,12세,2018,2106,1074,1032,104.1,2067,1053,1014,103.8
서울특별시,서대문구,13세,2018,2036,1023,1013,101,2008,1008,1000,100.8
서울특별시,서대문구,14세,2018,2280,1154,1126,102.5,2241,1136,1105,102.8
서울특별시,서대문구,15~19세,2018,16526,7559,8967,84.3,15745,7325,8420,87
서울특별시,서대문구,15세,2018,2433,1222,1211,100.9,2394,1203,1191,101
서울특별시,서대문구,16세,2018,2430,1238,1192,103.9,2394,1217,1177,103.4
서울특별시,서대문구,17세,2018,2917,1531,1386,110.5,2848,1499,1349,111.1
서울특별시,서대문구,18세,2018,3699,1724,1975,87.3,3511,1679,1832,91.6
서울특별시,서대문구,19세,2018,5047,1844,3203,57.6,4598,1727,2871,60.2
서울특별시,서대문구,20~24세,2018,33419,12920,20499,63,29002,11875,17127,69.3
서울특별시,서대문구,20세,2018,6224,2180,4044,53.9,5334,1970,3364,58.6
서울특별시,서대문구,21세,2018,6480,2201,4279,51.4,5525,1991,3534,56.3
서울특별시,서대문구,22세,2018,6795,2585,4210,61.4,5904,2383,3521,67.7
서울특별시,서대문구,23세,2018,7173,2980,4193,71.1,6234,2746,3488,78.7
서울특별시,서대문구,24세,2018,6747,2974,3773,78.8,6005,2785,3220,86.5
서울특별시,서대문구,25~29세,2018,29146,14360,14786,97.1,26647,13563,13084,103.7
서울특별시,서대문구,25세,2018,6797,3266,3531,92.5,6097,3073,3024,101.6
서울특별시,서대문구,26세,2018,6352,3142,3210,97.9,5807,2984,2823,105.7
서울특별시,서대문구,27세,2018,5904,2918,2986,97.7,5465,2761,2704,102.1
서울특별시,서대문구,28세,2018,5258,2594,2664,97.4,4838,2445,2393,102.2
서울특별시,서대문구,29세,2018,4835,2440,2395,101.9,4440,2300,2140,107.5
서울특별시,서대문구,30~34세,2018,21831,10726,11105,96.6,20453,10131,10322,98.1
서울특별시,서대문구,30세,2018,4485,2201,2284,96.4,4178,2069,2109,98.1
서울특별시,서대문구,31세,2018,4414,2177,2237,97.3,4099,2063,2036,101.3
서울특별시,서대문구,32세,2018,4292,2142,2150,99.6,4019,2017,2002,100.7
서울특별시,서대문구,33세,2018,4318,2097,2221,94.4,4050,1971,2079,94.8
서울특별시,서대문구,34세,2018,4322,2109,2213,95.3,4107,2011,2096,95.9
서울특별시,서대문구,35~39세,2018,23697,11798,11899,99.2,22691,11332,11359,99.8
서울특별시,서대문구,35세,2018,4622,2342,2280,102.7,4403,2241,2162,103.7
서울특별시,서대문구,36세,2018,4922,2396,2526,94.9,4696,2293,2403,95.4
서울특별시,서대문구,37세,2018,4915,2481,2434,101.9,4710,2384,2326,102.5
서울특별시,서대문구,38세,2018,4835,2402,2433,98.7,4650,2313,2337,99
서울특별시,서대문구,39세,2018,4403,2177,2226,97.8,4232,2101,2131,98.6
서울특별시,서대문구,40~44세,2018,21796,10900,10896,100,21042,10510,10532,99.8
서울특별시,서대문구,40세,2018,4095,2038,2057,99.1,3924,1961,1963,99.9
서울특별시,서대문구,41세,2018,4310,2159,2151,100.4,4148,2065,2083,99.1
서울특별시,서대문구,42세,2018,4218,2117,2101,100.8,4086,2054,2032,101.1
서울특별시,서대문구,43세,2018,4357,2212,2145,103.1,4224,2139,2085,102.6
서울특별시,서대문구,44세,2018,4816,2374,2442,97.2,4660,2291,2369,96.7
서울특별시,서대문구,45~49세,2018,25863,12700,13163,96.5,25100,12305,12795,96.2
서울특별시,서대문구,45세,2018,4805,2316,2489,93,4656,2242,2414,92.9
서울특별시,서대문구,46세,2018,5137,2597,2540,102.2,4970,2511,2459,102.1
서울특별시,서대문구,47세,2018,5533,2791,2742,101.8,5362,2704,2658,101.7
서울특별시,서대문구,48세,2018,5219,2537,2682,94.6,5089,2462,2627,93.7
서울특별시,서대문구,49세,2018,5169,2459,2710,90.7,5023,2386,2637,90.5
서울특별시,서대문구,50~54세,2018,23534,11355,12179,93.2,22915,11044,11871,93
서울특별시,서대문구,50세,2018,5135,2460,2675,92,4997,2395,2602,92
서울특별시,서대문구,51세,2018,4689,2191,2498,87.7,4592,2143,2449,87.5
서울특별시,서대문구,52세,2018,4482,2324,2158,107.7,4359,2270,2089,108.7
서울특별시,서대문구,53세,2018,4703,2209,2494,88.6,4566,2133,2433,87.7
서울특별시,서대문구,54세,2018,4525,2171,2354,92.2,4401,2103,2298,91.5
서울특별시,서대문구,55~59세,2018,24150,11548,12602,91.6,23543,11272,12271,91.9
서울특별시,서대문구,55세,2018,4727,2323,2404,96.6,4561,2241,2320,96.6
서울특별시,서대문구,56세,2018,4754,2308,2446,94.4,4627,2253,2374,94.9
서울특별시,서대문구,57세,2018,5043,2389,2654,90,4923,2339,2584,90.5
서울특별시,서대문구,58세,2018,4993,2326,2667,87.2,4891,2279,2612,87.3
서울특별시,서대문구,59세,2018,4633,2202,2431,90.6,4541,2160,2381,90.7
서울특별시,서대문구,60~64세,2018,20300,9668,10632,90.9,19836,9454,10382,91.1
서울특별시,서대문구,60세,2018,4483,2194,2289,95.8,4365,2139,2226,96.1
서울특별시,서대문구,61세,2018,4283,2045,2238,91.4,4191,1997,2194,91
서울특별시,서대문구,62세,2018,3955,1861,2094,88.9,3867,1826,2041,89.5
서울특별시,서대문구,63세,2018,4130,1946,2184,89.1,4037,1900,2137,88.9
서울특별시,서대문구,64세,2018,3449,1622,1827,88.8,3376,1592,1784,89.2
서울특별시,서대문구,65~69세,2018,14253,6416,7837,81.9,14029,6308,7721,81.7
서울특별시,서대문구,65세,2018,3104,1450,1654,87.7,3029,1412,1617,87.3
서울특별시,서대문구,66세,2018,3209,1466,1743,84.1,3164,1449,1715,84.5
서울특별시,서대문구,67세,2018,2421,1136,1285,88.4,2387,1117,1270,88
서울특별시,서대문구,68세,2018,2748,1174,1574,74.6,2711,1156,1555,74.3
서울특별시,서대문구,69세,2018,2771,1190,1581,75.3,2738,1174,1564,75.1
서울특별시,서대문구,70~74세,2018,12308,5381,6927,77.7,12203,5334,6869,77.7
서울특별시,서대문구,70세,2018,2661,1169,1492,78.4,2631,1156,1475,78.4
서울특별시,서대문구,71세,2018,2943,1302,1641,79.3,2918,1290,1628,79.2
서울특별시,서대문구,72세,2018,2272,1008,1264,79.7,2252,999,1253,79.7
서울특별시,서대문구,73세,2018,2241,969,1272,76.2,2224,959,1265,75.8
서울특별시,서대문구,74세,2018,2191,933,1258,74.2,2178,930,1248,74.5
서울특별시,서대문구,75~79세,2018,10848,4654,6194,75.1,10794,4635,6159,75.3
서울특별시,서대문구,75세,2018,2256,956,1300,73.5,2244,949,1295,73.3
서울특별시,서대문구,76세,2018,2643,1172,1471,79.7,2635,1169,1466,79.7
서울특별시,서대문구,77세,2018,2074,909,1165,78,2056,905,1151,78.6
서울특별시,서대문구,78세,2018,1945,823,1122,73.4,1937,820,1117,73.4
서울특별시,서대문구,79세,2018,1930,794,1136,69.9,1922,792,1130,70.1
서울특별시,서대문구,80~84세,2018,6418,2564,3854,66.5,6375,2547,3828,66.5
서울특별시,서대문구,80세,2018,1621,678,943,71.9,1615,675,940,71.8
서울특별시,서대문구,81세,2018,1450,590,860,68.6,1437,587,850,69.1
서울특별시,서대문구,82세,2018,1261,509,752,67.7,1247,502,745,67.4
서울특별시,서대문구,83세,2018,1171,451,720,62.6,1169,449,720,62.4
서울특별시,서대문구,84세,2018,915,336,579,58,907,334,573,58.3
서울특별시,서대문구,85세이상,2018,3651,1111,2540,43.7,3626,1105,2521,43.8
서울특별시,서대문구,85~89세,2018,2581,857,1724,49.7,2564,852,1712,49.8
서울특별시,서대문구,85세,2018,732,258,474,54.4,728,256,472,54.2
서울특별시,서대문구,86세,2018,592,204,388,52.6,592,204,388,52.6
서울특별시,서대문구,87세,2018,438,138,300,46,432,137,295,46.4
서울특별시,서대문구,88세,2018,451,138,313,44.1,449,138,311,44.4
서울특별시,서대문구,89세,2018,368,119,249,47.8,363,117,246,47.6
서울특별시,서대문구,90~94세,2018,864,214,650,32.9,858,214,644,33.2
서울특별시,서대문구,90세,2018,277,80,197,40.6,276,80,196,40.8
서울특별시,서대문구,91세,2018,229,50,179,27.9,228,50,178,28.1
서울특별시,서대문구,92세,2018,144,39,105,37.1,144,39,105,37.1
서울특별시,서대문구,93세,2018,121,25,96,26,118,25,93,26.9
서울특별시,서대문구,94세,2018,93,20,73,27.4,92,20,72,27.8
서울특별시,서대문구,95~99세,2018,182,33,149,22.1,181,33,148,22.3
서울특별시,서대문구,95세,2018,65,13,52,25,65,13,52,25
서울특별시,서대문구,96세,2018,61,11,50,22,60,11,49,22.4
서울특별시,서대문구,97세,2018,26,X,22,18.2,26,X,22,18.2
서울특별시,서대문구,98세,2018,15,X,12,25,15,X,12,25
서울특별시,서대문구,99세,2018,15,X,13,15.4,15,X,13,15.4
서울특별시,서대문구,100세이상,2018,24,7,17,41.2,23,6,17,35.3
서울특별시,서대문구,15세미만,2018,31134,15778,15356,102.7,30507,15468,15039,102.9
서울특별시,서대문구,15~64세,2018,240262,113534,126728,89.6,226974,108811,118163,92.1
서울특별시,서대문구,65세이상,2018,47478,20126,27352,73.6,47027,19929,27098,73.5
서울특별시,서대문구,평균연령,2018,41.6,41.2,42,,42.1,41.4,42.7,
서울특별시,서대문구,중위연령,2018,40.9,40.8,41,,41.8,41.2,42.4,
서울특별시,마포구,합계,2018,368181,174194,193987,89.8,355405,168819,186586,90.5
서울특별시,마포구,0~4세,2018,13679,6979,6700,104.2,13443,6858,6585,104.1
서울특별시,마포구,0세,2018,2662,1365,1297,105.2,2614,1338,1276,104.9
서울특별시,마포구,1세,2018,2645,1381,1264,109.3,2593,1361,1232,110.5
서울특별시,마포구,2세,2018,2889,1477,1412,104.6,2845,1452,1393,104.2
서울특별시,마포구,3세,2018,2783,1400,1383,101.2,2732,1374,1358,101.2
서울특별시,마포구,4세,2018,2700,1356,1344,100.9,2659,1333,1326,100.5
서울특별시,마포구,5~9세,2018,13336,6748,6588,102.4,13184,6673,6511,102.5
서울특별시,마포구,5세,2018,2638,1302,1336,97.5,2596,1282,1314,97.6
서울특별시,마포구,6세,2018,2767,1399,1368,102.3,2733,1381,1352,102.1
서울특별시,마포구,7세,2018,2699,1367,1332,102.6,2677,1356,1321,102.6
서울특별시,마포구,8세,2018,2623,1327,1296,102.4,2598,1315,1283,102.5
서울특별시,마포구,9세,2018,2609,1353,1256,107.7,2580,1339,1241,107.9
서울특별시,마포구,10~14세,2018,13483,6806,6677,101.9,13356,6739,6617,101.8
서울특별시,마포구,10세,2018,2791,1419,1372,103.4,2760,1405,1355,103.7
서울특별시,마포구,11세,2018,2824,1434,1390,103.2,2807,1424,1383,103
서울특별시,마포구,12세,2018,2527,1259,1268,99.3,2498,1241,1257,98.7
서울특별시,마포구,13세,2018,2579,1322,1257,105.2,2557,1309,1248,104.9
서울특별시,마포구,14세,2018,2762,1372,1390,98.7,2734,1360,1374,99
서울특별시,마포구,15~19세,2018,15939,7908,8031,98.5,15456,7746,7710,100.5
서울특별시,마포구,15세,2018,2716,1440,1276,112.9,2700,1434,1266,113.3
서울특별시,마포구,16세,2018,2631,1318,1313,100.4,2614,1309,1305,100.3
서울특별시,마포구,17세,2018,2968,1540,1428,107.8,2941,1528,1413,108.1
서울특별시,마포구,18세,2018,3497,1685,1812,93,3381,1656,1725,96
서울특별시,마포구,19세,2018,4127,1925,2202,87.4,3820,1819,2001,90.9
서울특별시,마포구,20~24세,2018,28582,12587,15995,78.7,25752,11780,13972,84.3
서울특별시,마포구,20세,2018,4776,2103,2673,78.7,4240,1945,2295,84.7
서울특별시,마포구,21세,2018,5169,2229,2940,75.8,4621,2069,2552,81.1
서울특별시,마포구,22세,2018,5705,2477,3228,76.7,5122,2317,2805,82.6
서울특별시,마포구,23세,2018,6193,2720,3473,78.3,5628,2574,3054,84.3
서울특별시,마포구,24세,2018,6739,3058,3681,83.1,6141,2875,3266,88
서울특별시,마포구,25~29세,2018,34885,16165,18720,86.4,32743,15370,17373,88.5
서울특별시,마포구,25세,2018,7107,3338,3769,88.6,6595,3159,3436,91.9
서울특별시,마포구,26세,2018,7342,3399,3943,86.2,6910,3256,3654,89.1
서울특별시,마포구,27세,2018,7048,3304,3744,88.2,6645,3154,3491,90.3
서울특별시,마포구,28세,2018,6855,3108,3747,82.9,6411,2932,3479,84.3
서울특별시,마포구,29세,2018,6533,3016,3517,85.8,6182,2869,3313,86.6
서울특별시,마포구,30~34세,2018,32791,15308,17483,87.6,31183,14560,16623,87.6
서울특별시,마포구,30세,2018,6420,2977,3443,86.5,6061,2821,3240,87.1
서울특별시,마포구,31세,2018,6478,2880,3598,80,6132,2737,3395,80.6
서울특별시,마포구,32세,2018,6595,3043,3552,85.7,6281,2893,3388,85.4
서울특별시,마포구,33세,2018,6565,3110,3455,90,6276,2973,3303,90
서울특별시,마포구,34세,2018,6733,3298,3435,96,6433,3136,3297,95.1
서울특별시,마포구,35~39세,2018,33687,16546,17141,96.5,32494,15923,16571,96.1
서울특별시,마포구,35세,2018,6842,3313,3529,93.9,6569,3170,3399,93.3
서울특별시,마포구,36세,2018,7185,3530,3655,96.6,6933,3400,3533,96.2
서울특별시,마포구,37세,2018,6861,3404,3457,98.5,6631,3287,3344,98.3
서울특별시,마포구,38세,2018,6546,3211,3335,96.3,6341,3104,3237,95.9
서울특별시,마포구,39세,2018,6253,3088,3165,97.6,6020,2962,3058,96.9
서울특별시,마포구,40~44세,2018,29479,14471,15008,96.4,28615,13994,14621,95.7
서울특별시,마포구,40세,2018,5622,2759,2863,96.4,5426,2649,2777,95.4
서울특별시,마포구,41세,2018,5864,2824,3040,92.9,5676,2723,2953,92.2
서울특별시,마포구,42세,2018,5835,2812,3023,93,5676,2726,2950,92.4
서울특별시,마포구,43세,2018,5944,2967,2977,99.7,5770,2871,2899,99
서울특별시,마포구,44세,2018,6214,3109,3105,100.1,6067,3025,3042,99.4
서울특별시,마포구,45~49세,2018,31729,15694,16035,97.9,30917,15264,15653,97.5
서울특별시,마포구,45세,2018,6359,3053,3306,92.3,6183,2956,3227,91.6
서울특별시,마포구,46세,2018,6461,3253,3208,101.4,6309,3173,3136,101.2
서울특별시,마포구,47세,2018,6626,3246,3380,96,6468,3156,3312,95.3
서울특별시,마포구,48세,2018,6188,3079,3109,99,6013,2999,3014,99.5
서울특별시,마포구,49세,2018,6095,3063,3032,101,5944,2980,2964,100.5
서울특별시,마포구,50~54세,2018,26115,12675,13440,94.3,25365,12317,13048,94.4
서울특별시,마포구,50세,2018,5799,2776,3023,91.8,5631,2694,2937,91.7
서울특별시,마포구,51세,2018,5225,2489,2736,91,5061,2402,2659,90.3
서울특별시,마포구,52세,2018,4894,2467,2427,101.6,4776,2412,2364,102
서울특별시,마포구,53세,2018,5317,2571,2746,93.6,5171,2510,2661,94.3
서울특별시,마포구,54세,2018,4880,2372,2508,94.6,4726,2299,2427,94.7
서울특별시,마포구,55~59세,2018,25830,12431,13399,92.8,25200,12141,13059,93
서울특별시,마포구,55세,2018,5097,2472,2625,94.2,4935,2402,2533,94.8
서울특별시,마포구,56세,2018,5039,2447,2592,94.4,4893,2377,2516,94.5
서울특별시,마포구,57세,2018,5331,2586,2745,94.2,5233,2542,2691,94.5
서울특별시,마포구,58세,2018,5446,2586,2860,90.4,5323,2528,2795,90.4
서울특별시,마포구,59세,2018,4917,2340,2577,90.8,4816,2292,2524,90.8
서울특별시,마포구,60~64세,2018,21067,9805,11262,87.1,20561,9577,10984,87.2
서울특별시,마포구,60세,2018,4521,2114,2407,87.8,4395,2068,2327,88.9
서울특별시,마포구,61세,2018,4551,2126,2425,87.7,4441,2063,2378,86.8
서울특별시,마포구,62세,2018,4145,1926,2219,86.8,4057,1888,2169,87
서울특별시,마포구,63세,2018,4308,2012,2296,87.6,4207,1970,2237,88.1
서울특별시,마포구,64세,2018,3542,1627,1915,85,3461,1588,1873,84.8
서울특별시,마포구,65~69세,2018,14582,6499,8083,80.4,14347,6379,7968,80.1
서울특별시,마포구,65세,2018,3093,1408,1685,83.6,3031,1377,1654,83.3
서울특별시,마포구,66세,2018,3411,1571,1840,85.4,3351,1540,1811,85
서울특별시,마포구,67세,2018,2405,1068,1337,79.9,2363,1049,1314,79.8
서울특별시,마포구,68세,2018,2792,1223,1569,77.9,2752,1203,1549,77.7
서울특별시,마포구,69세,2018,2881,1229,1652,74.4,2850,1210,1640,73.8
서울특별시,마포구,70~74세,2018,12480,5280,7200,73.3,12373,5238,7135,73.4
서울특별시,마포구,70세,2018,2863,1221,1642,74.4,2836,1212,1624,74.6
서울특별시,마포구,71세,2018,2868,1216,1652,73.6,2839,1206,1633,73.9
서울특별시,마포구,72세,2018,2207,922,1285,71.8,2190,916,1274,71.9
서울특별시,마포구,73세,2018,2288,968,1320,73.3,2274,961,1313,73.2
서울특별시,마포구,74세,2018,2254,953,1301,73.3,2234,943,1291,73
서울특별시,마포구,75~79세,2018,10575,4622,5953,77.6,10529,4608,5921,77.8
서울특별시,마포구,75세,2018,2242,1006,1236,81.4,2231,1001,1230,81.4
서울특별시,마포구,76세,2018,2628,1152,1476,78,2621,1152,1469,78.4
서울특별시,마포구,77세,2018,2044,895,1149,77.9,2033,891,1142,78
서울특별시,마포구,78세,2018,1906,808,1098,73.6,1895,804,1091,73.7
서울특별시,마포구,79세,2018,1755,761,994,76.6,1749,760,989,76.8
서울특별시,마포구,80~84세,2018,6215,2431,3784,64.2,6188,2423,3765,64.4
서울특별시,마포구,80세,2018,1506,635,871,72.9,1500,635,865,73.4
서울특별시,마포구,81세,2018,1457,588,869,67.7,1450,586,864,67.8
서울특별시,마포구,82세,2018,1253,494,759,65.1,1243,490,753,65.1
서울특별시,마포구,83세,2018,1137,421,716,58.8,1133,419,714,58.7
서울특별시,마포구,84세,2018,862,293,569,51.5,862,293,569,51.5
서울특별시,마포구,85세이상,2018,3727,1239,2488,49.8,3699,1229,2470,49.8
서울특별시,마포구,85~89세,2018,2690,950,1740,54.6,2671,943,1728,54.6
서울특별시,마포구,85세,2018,765,309,456,67.8,761,307,454,67.6
서울특별시,마포구,86세,2018,646,226,420,53.8,641,224,417,53.7
서울특별시,마포구,87세,2018,474,156,318,49.1,473,156,317,49.2
서울특별시,마포구,88세,2018,445,139,306,45.4,438,137,301,45.5
서울특별시,마포구,89세,2018,360,120,240,50,358,119,239,49.8
서울특별시,마포구,90~94세,2018,802,230,572,40.2,796,228,568,40.1
서울특별시,마포구,90세,2018,279,86,193,44.6,278,86,192,44.8
서울특별시,마포구,91세,2018,204,55,149,36.9,201,54,147,36.7
서울특별시,마포구,92세,2018,134,40,94,42.6,133,39,94,41.5
서울특별시,마포구,93세,2018,105,28,77,36.4,104,28,76,36.8
서울특별시,마포구,94세,2018,80,21,59,35.6,80,21,59,35.6
서울특별시,마포구,95~99세,2018,199,52,147,35.4,196,51,145,35.2
서울특별시,마포구,95세,2018,78,21,57,36.8,77,21,56,37.5
서울특별시,마포구,96세,2018,53,10,43,23.3,53,10,43,23.3
서울특별시,마포구,97세,2018,33,12,21,57.1,31,11,20,55
서울특별시,마포구,98세,2018,23,5,18,27.8,23,5,18,27.8
서울특별시,마포구,99세,2018,12,X,8,50,12,X,8,50
서울특별시,마포구,100세이상,2018,36,7,29,24.1,36,7,29,24.1
서울특별시,마포구,15세미만,2018,40498,20533,19965,102.8,39983,20270,19713,102.8
서울특별시,마포구,15~64세,2018,280104,133590,146514,91.2,268286,128672,139614,92.2
서울특별시,마포구,65세이상,2018,47579,20071,27508,73,47136,19877,27259,72.9
서울특별시,마포구,평균연령,2018,40.7,40.1,41.3,,40.9,40.2,41.6,
서울특별시,마포구,중위연령,2018,39.6,39.4,39.9,,40,39.6,40.5,
서울특별시,양천구,합계,2018,445591,218975,226616,96.6,439910,216381,223529,96.8
서울특별시,양천구,0~4세,2018,14539,7394,7145,103.5,14426,7342,7084,103.6
서울특별시,양천구,0세,2018,2323,1168,1155,101.1,2299,1156,1143,101.1
서울특별시,양천구,1세,2018,2757,1414,1343,105.3,2731,1401,1330,105.3
서울특별시,양천구,2세,2018,3027,1509,1518,99.4,2999,1498,1501,99.8
서울특별시,양천구,3세,2018,3125,1629,1496,108.9,3109,1621,1488,108.9
서울특별시,양천구,4세,2018,3307,1674,1633,102.5,3288,1666,1622,102.7
서울특별시,양천구,5~9세,2018,19416,10061,9355,107.5,19349,10028,9321,107.6
서울특별시,양천구,5세,2018,3439,1798,1641,109.6,3424,1790,1634,109.5
서울특별시,양천구,6세,2018,3825,1944,1881,103.3,3809,1936,1873,103.4
서울특별시,양천구,7세,2018,3999,2075,1924,107.8,3986,2071,1915,108.1
서울특별시,양천구,8세,2018,4067,2094,1973,106.1,4054,2087,1967,106.1
서울특별시,양천구,9세,2018,4086,2150,1936,111.1,4076,2144,1932,111
서울특별시,양천구,10~14세,2018,24014,12552,11462,109.5,23972,12525,11447,109.4
서울특별시,양천구,10세,2018,4572,2346,2226,105.4,4558,2339,2219,105.4
서울특별시,양천구,11세,2018,4835,2508,2327,107.8,4828,2503,2325,107.7
서울특별시,양천구,12세,2018,4591,2384,2207,108,4586,2379,2207,107.8
서울특별시,양천구,13세,2018,4796,2535,2261,112.1,4789,2531,2258,112.1
서울특별시,양천구,14세,2018,5220,2779,2441,113.8,5211,2773,2438,113.7
서울특별시,양천구,15~19세,2018,27484,14310,13174,108.6,27400,14272,13128,108.7
서울특별시,양천구,15세,2018,5196,2673,2523,105.9,5190,2672,2518,106.1
서울특별시,양천구,16세,2018,5203,2707,2496,108.5,5195,2703,2492,108.5
서울특별시,양천구,17세,2018,5799,3030,2769,109.4,5788,3024,2764,109.4
서울특별시,양천구,18세,2018,5899,3095,2804,110.4,5884,3087,2797,110.4
서울특별시,양천구,19세,2018,5387,2805,2582,108.6,5343,2786,2557,109
서울특별시,양천구,20~24세,2018,28227,14732,13495,109.2,27928,14614,13314,109.8
서울특별시,양천구,20세,2018,5288,2802,2486,112.7,5255,2787,2468,112.9
서울특별시,양천구,21세,2018,5607,3049,2558,119.2,5567,3027,2540,119.2
서울특별시,양천구,22세,2018,5690,3019,2671,113,5634,3002,2632,114.1
서울특별시,양천구,23세,2018,5743,2937,2806,104.7,5668,2912,2756,105.7
서울특별시,양천구,24세,2018,5899,2925,2974,98.4,5804,2886,2918,98.9
서울특별시,양천구,25~29세,2018,28660,14255,14405,99,28077,13999,14078,99.4
서울특별시,양천구,25세,2018,5935,2969,2966,100.1,5838,2929,2909,100.7
서울특별시,양천구,26세,2018,5964,2974,2990,99.5,5853,2931,2922,100.3
서울특별시,양천구,27세,2018,5893,2903,2990,97.1,5784,2857,2927,97.6
서울특별시,양천구,28세,2018,5483,2810,2673,105.1,5362,2750,2612,105.3
서울특별시,양천구,29세,2018,5385,2599,2786,93.3,5240,2532,2708,93.5
서울특별시,양천구,30~34세,2018,27097,13486,13611,99.1,26359,13152,13207,99.6
서울특별시,양천구,30세,2018,5298,2633,2665,98.8,5149,2573,2576,99.9
서울특별시,양천구,31세,2018,5223,2540,2683,94.7,5066,2460,2606,94.4
서울특별시,양천구,32세,2018,5369,2683,2686,99.9,5210,2613,2597,100.6
서울특별시,양천구,33세,2018,5401,2690,2711,99.2,5280,2631,2649,99.3
서울특별시,양천구,34세,2018,5806,2940,2866,102.6,5654,2875,2779,103.5
서울특별시,양천구,35~39세,2018,33683,16551,17132,96.6,33133,16276,16857,96.6
서울특별시,양천구,35세,2018,6294,3163,3131,101,6177,3104,3073,101
서울특별시,양천구,36세,2018,6776,3341,3435,97.3,6657,3282,3375,97.2
서울특별시,양천구,37세,2018,6777,3347,3430,97.6,6681,3295,3386,97.3
서울특별시,양천구,38세,2018,6983,3431,3552,96.6,6872,3368,3504,96.1
서울특별시,양천구,39세,2018,6853,3269,3584,91.2,6746,3227,3519,91.7
서울특별시,양천구,40~44세,2018,35517,16770,18747,89.5,35009,16534,18475,89.5
서울특별시,양천구,40세,2018,6362,2970,3392,87.6,6260,2928,3332,87.9
서울특별시,양천구,41세,2018,6695,3133,3562,88,6596,3091,3505,88.2
서울특별시,양천구,42세,2018,6855,3280,3575,91.7,6752,3230,3522,91.7
서울특별시,양천구,43세,2018,7353,3410,3943,86.5,7265,3367,3898,86.4
서울특별시,양천구,44세,2018,8252,3977,4275,93,8136,3918,4218,92.9
서울특별시,양천구,45~49세,2018,44723,21627,23096,93.6,44127,21334,22793,93.6
서울특별시,양천구,45세,2018,8453,3966,4487,88.4,8345,3912,4433,88.2
서울특별시,양천구,46세,2018,8678,4117,4561,90.3,8552,4053,4499,90.1
서울특별시,양천구,47세,2018,9426,4613,4813,95.8,9306,4553,4753,95.8
서울특별시,양천구,48세,2018,9093,4411,4682,94.2,8963,4352,4611,94.4
서울특별시,양천구,49세,2018,9073,4520,4553,99.3,8961,4464,4497,99.3
서울특별시,양천구,50~54세,2018,39002,19356,19646,98.5,38379,19078,19301,98.8
서울특별시,양천구,50세,2018,8636,4277,4359,98.1,8520,4223,4297,98.3
서울특별시,양천구,51세,2018,7891,3866,4025,96,7775,3810,3965,96.1
서울특별시,양천구,52세,2018,7546,3801,3745,101.5,7429,3757,3672,102.3
서울특별시,양천구,53세,2018,7705,3781,3924,96.4,7564,3713,3851,96.4
서울특별시,양천구,54세,2018,7224,3631,3593,101.1,7091,3575,3516,101.7
서울특별시,양천구,55~59세,2018,37226,18354,18872,97.3,36659,18084,18575,97.4
서울특별시,양천구,55세,2018,7448,3741,3707,100.9,7292,3677,3615,101.7
서울특별시,양천구,56세,2018,7410,3748,3662,102.3,7296,3684,3612,102
서울특별시,양천구,57세,2018,7705,3754,3951,95,7629,3718,3911,95.1
서울특별시,양천구,58세,2018,7702,3746,3956,94.7,7575,3688,3887,94.9
서울특별시,양천구,59세,2018,6961,3365,3596,93.6,6867,3317,3550,93.4
서울특별시,양천구,60~64세,2018,30358,14610,15748,92.8,29872,14387,15485,92.9
서울특별시,양천구,60세,2018,6618,3179,3439,92.4,6510,3129,3381,92.5
서울특별시,양천구,61세,2018,6416,3094,3322,93.1,6317,3056,3261,93.7
서울특별시,양천구,62세,2018,5936,2819,3117,90.4,5839,2774,3065,90.5
서울특별시,양천구,63세,2018,6273,3007,3266,92.1,6181,2961,3220,92
서울특별시,양천구,64세,2018,5115,2511,2604,96.4,5025,2467,2558,96.4
서울특별시,양천구,65~69세,2018,20467,9985,10482,95.3,20225,9884,10341,95.6
서울특별시,양천구,65세,2018,4547,2195,2352,93.3,4493,2173,2320,93.7
서울특별시,양천구,66세,2018,4862,2358,2504,94.2,4800,2330,2470,94.3
서울특별시,양천구,67세,2018,3468,1701,1767,96.3,3422,1684,1738,96.9
서울특별시,양천구,68세,2018,3870,1933,1937,99.8,3829,1913,1916,99.8
서울특별시,양천구,69세,2018,3720,1798,1922,93.5,3681,1784,1897,94
서울특별시,양천구,70~74세,2018,14496,6944,7552,91.9,14408,6909,7499,92.1
서울특별시,양천구,70세,2018,3573,1745,1828,95.5,3548,1737,1811,95.9
서울특별시,양천구,71세,2018,3462,1676,1786,93.8,3439,1665,1774,93.9
서울특별시,양천구,72세,2018,2632,1262,1370,92.1,2613,1253,1360,92.1
서울특별시,양천구,73세,2018,2416,1141,1275,89.5,2406,1138,1268,89.7
서울특별시,양천구,74세,2018,2413,1120,1293,86.6,2402,1116,1286,86.8
서울특별시,양천구,75~79세,2018,10468,4663,5805,80.3,10423,4651,5772,80.6
서울특별시,양천구,75세,2018,2357,1125,1232,91.3,2345,1122,1223,91.7
서울특별시,양천구,76세,2018,2555,1144,1411,81.1,2547,1143,1404,81.4
서울특별시,양천구,77세,2018,2068,951,1117,85.1,2060,949,1111,85.4
서울특별시,양천구,78세,2018,1774,734,1040,70.6,1766,732,1034,70.8
서울특별시,양천구,79세,2018,1714,709,1005,70.5,1705,705,1000,70.5
서울특별시,양천구,80~84세,2018,6123,2209,3914,56.4,6086,2200,3886,56.6
서울특별시,양천구,80세,2018,1501,623,878,71,1492,620,872,71.1
서울특별시,양천구,81세,2018,1419,507,912,55.6,1412,505,907,55.7
서울특별시,양천구,82세,2018,1208,422,786,53.7,1198,419,779,53.8
서울특별시,양천구,83세,2018,1089,365,724,50.4,1081,364,717,50.8
서울특별시,양천구,84세,2018,906,292,614,47.6,903,292,611,47.8
서울특별시,양천구,85세이상,2018,4091,1116,2975,37.5,4078,1112,2966,37.5
서울특별시,양천구,85~89세,2018,2884,829,2055,40.3,2874,826,2048,40.3
서울특별시,양천구,85세,2018,800,257,543,47.3,797,256,541,47.3
서울특별시,양천구,86세,2018,681,201,480,41.9,679,201,478,42.1
서울특별시,양천구,87세,2018,520,137,383,35.8,517,135,382,35.3
서울특별시,양천구,88세,2018,488,114,374,30.5,487,114,373,30.6
서울특별시,양천구,89세,2018,395,120,275,43.6,394,120,274,43.8
서울특별시,양천구,90~94세,2018,935,223,712,31.3,932,222,710,31.3
서울특별시,양천구,90세,2018,316,89,227,39.2,314,88,226,38.9
서울특별시,양천구,91세,2018,220,61,159,38.4,220,61,159,38.4
서울특별시,양천구,92세,2018,173,29,144,20.1,172,29,143,20.3
서울특별시,양천구,93세,2018,150,32,118,27.1,150,32,118,27.1
서울특별시,양천구,94세,2018,76,12,64,18.8,76,12,64,18.8
서울특별시,양천구,95~99세,2018,248,61,187,32.6,248,61,187,32.6
서울특별시,양천구,95세,2018,115,30,85,35.3,115,30,85,35.3
서울특별시,양천구,96세,2018,62,9,53,17,62,9,53,17
서울특별시,양천구,97세,2018,30,9,21,42.9,30,9,21,42.9
서울특별시,양천구,98세,2018,23,6,17,35.3,23,6,17,35.3
서울특별시,양천구,99세,2018,18,7,11,63.6,18,7,11,63.6
서울특별시,양천구,100세이상,2018,24,X,21,14.3,24,X,21,14.3
서울특별시,양천구,15세미만,2018,57969,30007,27962,107.3,57747,29895,27852,107.3
서울특별시,양천구,15~64세,2018,331977,164051,167926,97.7,326943,161730,165213,97.9
서울특별시,양천구,65세이상,2018,55645,24917,30728,81.1,55220,24756,30464,81.3
서울특별시,양천구,평균연령,2018,41.2,40.3,42.1,,41.2,40.3,42,
서울특별시,양천구,중위연령,2018,43,42,43.8,,43,42,43.8,
서울특별시,강서구,합계,2018,578539,280629,297910,94.2,569360,276282,293078,94.3
서울특별시,강서구,0~4세,2018,23315,11893,11422,104.1,23078,11775,11303,104.2
서울특별시,강서구,0세,2018,4233,2166,2067,104.8,4188,2144,2044,104.9
서울특별시,강서구,1세,2018,4387,2258,2129,106.1,4331,2230,2101,106.1
서울특별시,강서구,2세,2018,5000,2576,2424,106.3,4946,2551,2395,106.5
서울특별시,강서구,3세,2018,4924,2475,2449,101.1,4881,2452,2429,100.9
서울특별시,강서구,4세,2018,4771,2418,2353,102.8,4732,2398,2334,102.7
서울특별시,강서구,5~9세,2018,22764,11674,11090,105.3,22650,11620,11030,105.3
서울특별시,강서구,5세,2018,4740,2399,2341,102.5,4712,2388,2324,102.8
서울특별시,강서구,6세,2018,5011,2565,2446,104.9,4987,2555,2432,105.1
서울특별시,강서구,7세,2018,4610,2366,2244,105.4,4590,2355,2235,105.4
서울특별시,강서구,8세,2018,4318,2220,2098,105.8,4298,2211,2087,105.9
서울특별시,강서구,9세,2018,4085,2124,1961,108.3,4063,2111,1952,108.1
서울특별시,강서구,10~14세,2018,21486,10956,10530,104,21428,10930,10498,104.1
서울특별시,강서구,10세,2018,4501,2272,2229,101.9,4479,2261,2218,101.9
서울특별시,강서구,11세,2018,4449,2278,2171,104.9,4439,2274,2165,105
서울특별시,강서구,12세,2018,4081,2098,1983,105.8,4069,2094,1975,106
서울특별시,강서구,13세,2018,4003,2034,1969,103.3,3995,2031,1964,103.4
서울특별시,강서구,14세,2018,4452,2274,2178,104.4,4446,2270,2176,104.3
서울특별시,강서구,15~19세,2018,25321,12791,12530,102.1,25190,12729,12461,102.2
서울특별시,강서구,15세,2018,4519,2296,2223,103.3,4510,2293,2217,103.4
서울특별시,강서구,16세,2018,4648,2366,2282,103.7,4632,2358,2274,103.7
서울특별시,강서구,17세,2018,5351,2677,2674,100.1,5333,2671,2662,100.3
서울특별시,강서구,18세,2018,5780,2868,2912,98.5,5747,2859,2888,99
서울특별시,강서구,19세,2018,5023,2584,2439,105.9,4968,2548,2420,105.3
서울특별시,강서구,20~24세,2018,34105,16590,17515,94.7,33659,16395,17264,95
서울특별시,강서구,20세,2018,5622,2945,2677,110,5565,2916,2649,110.1
서울특별시,강서구,21세,2018,6314,3198,3116,102.6,6262,3173,3089,102.7
서울특별시,강서구,22세,2018,6671,3334,3337,99.9,6583,3286,3297,99.7
서울특별시,강서구,23세,2018,7439,3508,3931,89.2,7324,3459,3865,89.5
서울특별시,강서구,24세,2018,8059,3605,4454,80.9,7925,3561,4364,81.6
서울특별시,강서구,25~29세,2018,48326,22579,25747,87.7,47225,22093,25132,87.9
서울특별시,강서구,25세,2018,8982,4099,4883,83.9,8784,4015,4769,84.2
서울특별시,강서구,26세,2018,9766,4460,5306,84.1,9597,4385,5212,84.1
서울특별시,강서구,27세,2018,9956,4595,5361,85.7,9736,4505,5231,86.1
서울특별시,강서구,28세,2018,9916,4730,5186,91.2,9646,4596,5050,91
서울특별시,강서구,29세,2018,9706,4695,5011,93.7,9462,4592,4870,94.3
서울특별시,강서구,30~34세,2018,50103,25012,25091,99.7,48740,24379,24361,100.1
서울특별시,강서구,30세,2018,9859,4771,5088,93.8,9601,4647,4954,93.8
서울특별시,강서구,31세,2018,9815,4835,4980,97.1,9518,4696,4822,97.4
서울특별시,강서구,32세,2018,10094,5022,5072,99,9813,4914,4899,100.3
서울특별시,강서구,33세,2018,10131,5176,4955,104.5,9857,5034,4823,104.4
서울특별시,강서구,34세,2018,10204,5208,4996,104.2,9951,5088,4863,104.6
서울특별시,강서구,35~39세,2018,54561,28126,26435,106.4,53571,27651,25920,106.7
서울특별시,강서구,35세,2018,11024,5683,5341,106.4,10801,5578,5223,106.8
서울특별시,강서구,36세,2018,11361,5791,5570,104,11148,5681,5467,103.9
서울특별시,강서구,37세,2018,11015,5811,5204,111.7,10820,5720,5100,112.2
서울특별시,강서구,38세,2018,10926,5558,5368,103.5,10745,5476,5269,103.9
서울특별시,강서구,39세,2018,10235,5283,4952,106.7,10057,5196,4861,106.9
서울특별시,강서구,40~44세,2018,44626,22495,22131,101.6,43942,22115,21827,101.3
서울특별시,강서구,40세,2018,8802,4496,4306,104.4,8644,4403,4241,103.8
서울특별시,강서구,41세,2018,8948,4520,4428,102.1,8813,4442,4371,101.6
서울특별시,강서구,42세,2018,8495,4291,4204,102.1,8355,4206,4149,101.4
서울특별시,강서구,43세,2018,8823,4445,4378,101.5,8693,4385,4308,101.8
서울특별시,강서구,44세,2018,9558,4743,4815,98.5,9437,4679,4758,98.3
서울특별시,강서구,45~49세,2018,46473,23186,23287,99.6,45653,22773,22880,99.5
서울특별시,강서구,45세,2018,9481,4835,4646,104.1,9320,4751,4569,104
서울특별시,강서구,46세,2018,9254,4652,4602,101.1,9093,4577,4516,101.4
서울특별시,강서구,47세,2018,9536,4734,4802,98.6,9374,4639,4735,98
서울특별시,강서구,48세,2018,9096,4465,4631,96.4,8913,4370,4543,96.2
서울특별시,강서구,49세,2018,9106,4500,4606,97.7,8953,4436,4517,98.2
서울특별시,강서구,50~54세,2018,42051,19982,22069,90.5,41148,19552,21596,90.5
서울특별시,강서구,50세,2018,8972,4324,4648,93,8814,4249,4565,93.1
서울특별시,강서구,51세,2018,8192,3888,4304,90.3,8050,3818,4232,90.2
서울특별시,강서구,52세,2018,8118,3868,4250,91,7928,3785,4143,91.4
서울특별시,강서구,53세,2018,8604,4083,4521,90.3,8402,3980,4422,90
서울특별시,강서구,54세,2018,8165,3819,4346,87.9,7954,3720,4234,87.9
서울특별시,강서구,55~59세,2018,47518,22305,25213,88.5,46587,21846,24741,88.3
서울특별시,강서구,55세,2018,8875,4210,4665,90.2,8632,4097,4535,90.3
서울특별시,강서구,56세,2018,9156,4364,4792,91.1,8936,4256,4680,90.9
서울특별시,강서구,57세,2018,10038,4670,5368,87,9910,4602,5308,86.7
서울특별시,강서구,58세,2018,10041,4619,5422,85.2,9859,4525,5334,84.8
서울특별시,강서구,59세,2018,9408,4442,4966,89.4,9250,4366,4884,89.4
서울특별시,강서구,60~64세,2018,41245,19025,22220,85.6,40451,18665,21786,85.7
서울특별시,강서구,60세,2018,8844,4119,4725,87.2,8681,4049,4632,87.4
서울특별시,강서구,61세,2018,8973,4191,4782,87.6,8787,4104,4683,87.6
서울특별시,강서구,62세,2018,8009,3696,4313,85.7,7853,3622,4231,85.6
서울특별시,강서구,63세,2018,8486,3810,4676,81.5,8332,3740,4592,81.4
서울특별시,강서구,64세,2018,6933,3209,3724,86.2,6798,3150,3648,86.3
서울특별시,강서구,65~69세,2018,28015,13364,14651,91.2,27655,13192,14463,91.2
서울특별시,강서구,65세,2018,6279,3006,3273,91.8,6175,2950,3225,91.5
서울특별시,강서구,66세,2018,6578,3127,3451,90.6,6499,3090,3409,90.6
서울특별시,강서구,67세,2018,4644,2226,2418,92.1,4576,2196,2380,92.3
서울특별시,강서구,68세,2018,5265,2506,2759,90.8,5203,2476,2727,90.8
서울특별시,강서구,69세,2018,5249,2499,2750,90.9,5202,2480,2722,91.1
서울특별시,강서구,70~74세,2018,20283,9852,10431,94.4,20173,9807,10366,94.6
서울특별시,강서구,70세,2018,4924,2397,2527,94.9,4901,2385,2516,94.8
서울특별시,강서구,71세,2018,4971,2401,2570,93.4,4944,2390,2554,93.6
서울특별시,강서구,72세,2018,3667,1788,1879,95.2,3648,1780,1868,95.3
서울특별시,강서구,73세,2018,3449,1675,1774,94.4,3426,1667,1759,94.8
서울특별시,강서구,74세,2018,3272,1591,1681,94.6,3254,1585,1669,95
서울특별시,강서구,75~79세,2018,14312,6264,8048,77.8,14242,6244,7998,78.1
서울특별시,강서구,75세,2018,3094,1409,1685,83.6,3081,1405,1676,83.8
서울특별시,강서구,76세,2018,3536,1633,1903,85.8,3521,1630,1891,86.2
서울특별시,강서구,77세,2018,2728,1166,1562,74.6,2721,1163,1558,74.6
서울특별시,강서구,78세,2018,2541,1104,1437,76.8,2524,1098,1426,77
서울특별시,강서구,79세,2018,2413,952,1461,65.2,2395,948,1447,65.5
서울특별시,강서구,80~84세,2018,8205,2945,5260,56,8167,2932,5235,56
서울특별시,강서구,80세,2018,2048,811,1237,65.6,2042,809,1233,65.6
서울특별시,강서구,81세,2018,1797,634,1163,54.5,1788,632,1156,54.7
서울특별시,강서구,82세,2018,1566,555,1011,54.9,1556,551,1005,54.8
서울특별시,강서구,83세,2018,1565,544,1021,53.3,1559,541,1018,53.1
서울특별시,강서구,84세,2018,1229,401,828,48.4,1222,399,823,48.5
서울특별시,강서구,85세이상,2018,5830,1590,4240,37.5,5801,1584,4217,37.6
서울특별시,강서구,85~89세,2018,4040,1182,2858,41.4,4014,1176,2838,41.4
서울특별시,강서구,85세,2018,1078,363,715,50.8,1069,361,708,51
서울특별시,강서구,86세,2018,919,276,643,42.9,914,276,638,43.3
서울특별시,강서구,87세,2018,738,204,534,38.2,730,201,529,38
서울특별시,강서구,88세,2018,715,190,525,36.2,712,189,523,36.1
서울특별시,강서구,89세,2018,590,149,441,33.8,589,149,440,33.9
서울특별시,강서구,90~94세,2018,1440,325,1115,29.1,1437,325,1112,29.2
서울특별시,강서구,90세,2018,470,98,372,26.3,469,98,371,26.4
서울특별시,강서구,91세,2018,363,86,277,31,363,86,277,31
서울특별시,강서구,92세,2018,241,50,191,26.2,240,50,190,26.3
서울특별시,강서구,93세,2018,200,45,155,29,200,45,155,29
서울특별시,강서구,94세,2018,166,46,120,38.3,165,46,119,38.7
서울특별시,강서구,95~99세,2018,314,76,238,31.9,314,76,238,31.9
서울특별시,강서구,95세,2018,113,25,88,28.4,113,25,88,28.4
서울특별시,강서구,96세,2018,91,21,70,30,91,21,70,30
서울특별시,강서구,97세,2018,50,15,35,42.9,50,15,35,42.9
서울특별시,강서구,98세,2018,35,11,24,45.8,35,11,24,45.8
서울특별시,강서구,99세,2018,25,X,21,19,25,X,21,19
서울특별시,강서구,100세이상,2018,36,7,29,24.1,36,7,29,24.1
서울특별시,강서구,15세미만,2018,67565,34523,33042,104.5,67156,34325,32831,104.6
서울특별시,강서구,15~64세,2018,434329,212091,222238,95.4,426166,208198,217968,95.5
서울특별시,강서구,65세이상,2018,76645,34015,42630,79.8,76038,33759,42279,79.8
서울특별시,강서구,평균연령,2018,41.5,40.6,42.3,,41.5,40.6,42.3,
서울특별시,강서구,중위연령,2018,41.1,40.2,42,,41.1,40.1,42,
서울특별시,구로구,합계,2018,433765,217086,216679,100.2,388079,192022,196057,97.9
서울특별시,구로구,0~4세,2018,16126,8256,7870,104.9,15006,7686,7320,105
서울특별시,구로구,0세,2018,2911,1498,1413,106,2691,1396,1295,107.8
서울특별시,구로구,1세,2018,3094,1586,1508,105.2,2827,1449,1378,105.2
서울특별시,구로구,2세,2018,3342,1740,1602,108.6,3093,1603,1490,107.6
서울특별시,구로구,3세,2018,3465,1727,1738,99.4,3261,1630,1631,99.9
서울특별시,구로구,4세,2018,3314,1705,1609,106,3134,1608,1526,105.4
서울특별시,구로구,5~9세,2018,16501,8336,8165,102.1,15872,8009,7863,101.9
서울특별시,구로구,5세,2018,3415,1727,1688,102.3,3238,1634,1604,101.9
서울특별시,구로구,6세,2018,3488,1752,1736,100.9,3339,1672,1667,100.3
서울특별시,구로구,7세,2018,3314,1672,1642,101.8,3205,1617,1588,101.8
서울특별시,구로구,8세,2018,3244,1662,1582,105.1,3141,1605,1536,104.5
서울특별시,구로구,9세,2018,3040,1523,1517,100.4,2949,1481,1468,100.9
서울특별시,구로구,10~14세,2018,14507,7485,7022,106.6,14133,7296,6837,106.7
서울특별시,구로구,10세,2018,3097,1560,1537,101.5,3009,1514,1495,101.3
서울특별시,구로구,11세,2018,3126,1563,1563,100,3019,1516,1503,100.9
서울특별시,구로구,12세,2018,2808,1471,1337,110,2750,1447,1303,111.1
서울특별시,구로구,13세,2018,2610,1407,1203,117,2550,1370,1180,116.1
서울특별시,구로구,14세,2018,2866,1484,1382,107.4,2805,1449,1356,106.9
서울특별시,구로구,15~19세,2018,17335,9052,8283,109.3,16965,8843,8122,108.9
서울특별시,구로구,15세,2018,2913,1479,1434,103.1,2867,1457,1410,103.3
서울특별시,구로구,16세,2018,3172,1663,1509,110.2,3126,1632,1494,109.2
서울특별시,구로구,17세,2018,3612,1966,1646,119.4,3552,1928,1624,118.7
서울특별시,구로구,18세,2018,3950,2060,1890,109,3846,2004,1842,108.8
서울특별시,구로구,19세,2018,3688,1884,1804,104.4,3574,1822,1752,104
서울특별시,구로구,20~24세,2018,24331,12196,12135,100.5,22920,11521,11399,101.1
서울특별시,구로구,20세,2018,4048,2141,1907,112.3,3845,2045,1800,113.6
서울특별시,구로구,21세,2018,4478,2306,2172,106.2,4231,2182,2049,106.5
서울특별시,구로구,22세,2018,4768,2400,2368,101.4,4529,2272,2257,100.7
서울특별시,구로구,23세,2018,5269,2504,2765,90.6,4947,2370,2577,92
서울특별시,구로구,24세,2018,5768,2845,2923,97.3,5368,2652,2716,97.6
서울특별시,구로구,25~29세,2018,32249,15887,16362,97.1,28832,14116,14716,95.9
서울특별시,구로구,25세,2018,6070,2926,3144,93.1,5645,2726,2919,93.4
서울특별시,구로구,26세,2018,6498,3172,3326,95.4,5897,2864,3033,94.4
서울특별시,구로구,27세,2018,6638,3259,3379,96.4,5943,2889,3054,94.6
서울특별시,구로구,28세,2018,6572,3266,3306,98.8,5740,2829,2911,97.2
서울특별시,구로구,29세,2018,6471,3264,3207,101.8,5607,2808,2799,100.3
서울특별시,구로구,30~34세,2018,33747,17165,16582,103.5,29088,14633,14455,101.2
서울특별시,구로구,30세,2018,6594,3279,3315,98.9,5643,2787,2856,97.6
서울특별시,구로구,31세,2018,6817,3396,3421,99.3,5792,2872,2920,98.4
서울특별시,구로구,32세,2018,6676,3419,3257,105,5674,2867,2807,102.1
서울특별시,구로구,33세,2018,6659,3446,3213,107.3,5827,2979,2848,104.6
서울특별시,구로구,34세,2018,7001,3625,3376,107.4,6152,3128,3024,103.4
서울특별시,구로구,35~39세,2018,37834,19855,17979,110.4,34130,17579,16551,106.2
서울특별시,구로구,35세,2018,7499,3949,3550,111.2,6664,3455,3209,107.7
서울특별시,구로구,36세,2018,7831,4075,3756,108.5,6982,3566,3416,104.4
서울특별시,구로구,37세,2018,7608,3974,3634,109.4,6979,3587,3392,105.7
서울특별시,구로구,38세,2018,7577,3951,3626,109,6929,3556,3373,105.4
서울특별시,구로구,39세,2018,7319,3906,3413,114.4,6576,3415,3161,108
서울특별시,구로구,40~44세,2018,33242,17648,15594,113.2,29886,15485,14401,107.5
서울특별시,구로구,40세,2018,6550,3458,3092,111.8,5859,3035,2824,107.5
서울특별시,구로구,41세,2018,6592,3541,3051,116.1,5959,3126,2833,110.3
서울특별시,구로구,42세,2018,6544,3449,3095,111.4,5888,3020,2868,105.3
서울특별시,구로구,43세,2018,6443,3436,3007,114.3,5792,3007,2785,108
서울특별시,구로구,44세,2018,7113,3764,3349,112.4,6388,3297,3091,106.7
서울특별시,구로구,45~49세,2018,37104,19372,17732,109.2,31901,16282,15619,104.2
서울특별시,구로구,45세,2018,7376,3943,3433,114.9,6468,3355,3113,107.8
서울특별시,구로구,46세,2018,7206,3855,3351,115,6274,3285,2989,109.9
서울특별시,구로구,47세,2018,7628,3957,3671,107.8,6555,3369,3186,105.7
서울특별시,구로구,48세,2018,7483,3846,3637,105.7,6310,3164,3146,100.6
서울특별시,구로구,49세,2018,7411,3771,3640,103.6,6294,3109,3185,97.6
서울특별시,구로구,50~54세,2018,35541,17938,17603,101.9,29271,14417,14854,97.1
서울특별시,구로구,50세,2018,7297,3576,3721,96.1,6146,2930,3216,91.1
서울특별시,구로구,51세,2018,6848,3491,3357,104,5852,2928,2924,100.1
서울특별시,구로구,52세,2018,6834,3511,3323,105.7,5646,2803,2843,98.6
서울특별시,구로구,53세,2018,7375,3741,3634,102.9,5929,2945,2984,98.7
서울특별시,구로구,54세,2018,7187,3619,3568,101.4,5698,2811,2887,97.4
서울특별시,구로구,55~59세,2018,38464,18799,19665,95.6,32213,15461,16752,92.3
서울특별시,구로구,55세,2018,7677,3799,3878,98,5924,2876,3048,94.4
서울특별시,구로구,56세,2018,7660,3836,3824,100.3,6293,3111,3182,97.8
서울특별시,구로구,57세,2018,7566,3693,3873,95.4,6768,3277,3491,93.9
서울특별시,구로구,58세,2018,8290,3972,4318,92,6947,3238,3709,87.3
서울특별시,구로구,59세,2018,7271,3499,3772,92.8,6281,2959,3322,89.1
서울특별시,구로구,60~64세,2018,34056,16367,17689,92.5,28764,13579,15185,89.4
서울특별시,구로구,60세,2018,7277,3569,3708,96.3,6101,2950,3151,93.6
서울특별시,구로구,61세,2018,7309,3531,3778,93.5,6040,2842,3198,88.9
서울특별시,구로구,62세,2018,6701,3150,3551,88.7,5658,2621,3037,86.3
서울특별시,구로구,63세,2018,6874,3325,3549,93.7,5925,2804,3121,89.8
서울특별시,구로구,64세,2018,5895,2792,3103,90,5040,2362,2678,88.2
서울특별시,구로구,65~69세,2018,23267,11176,12091,92.4,20975,9985,10990,90.9
서울특별시,구로구,65세,2018,5272,2515,2757,91.2,4604,2151,2453,87.7
서울특별시,구로구,66세,2018,5235,2507,2728,91.9,4702,2229,2473,90.1
서울특별시,구로구,67세,2018,3994,1928,2066,93.3,3576,1720,1856,92.7
서울특별시,구로구,68세,2018,4431,2142,2289,93.6,4057,1948,2109,92.4
서울특별시,구로구,69세,2018,4335,2084,2251,92.6,4036,1937,2099,92.3
서울특별시,구로구,70~74세,2018,16780,8163,8617,94.7,16131,7897,8234,95.9
서울특별시,구로구,70세,2018,3995,1977,2018,98,3798,1888,1910,98.8
서울특별시,구로구,71세,2018,4117,2037,2080,97.9,3944,1959,1985,98.7
서울특별시,구로구,72세,2018,3016,1436,1580,90.9,2895,1388,1507,92.1
서울특별시,구로구,73세,2018,2873,1375,1498,91.8,2793,1349,1444,93.4
서울특별시,구로구,74세,2018,2779,1338,1441,92.9,2701,1313,1388,94.6
서울특별시,구로구,75~79세,2018,12293,5644,6649,84.9,11915,5553,6362,87.3
서울특별시,구로구,75세,2018,2771,1309,1462,89.5,2687,1289,1398,92.2
서울특별시,구로구,76세,2018,3101,1460,1641,89,3021,1439,1582,91
서울특별시,구로구,77세,2018,2325,1092,1233,88.6,2253,1073,1180,90.9
서울특별시,구로구,78세,2018,2098,902,1196,75.4,2019,887,1132,78.4
서울특별시,구로구,79세,2018,1998,881,1117,78.9,1935,865,1070,80.8
서울특별시,구로구,80~84세,2018,6651,2661,3990,66.7,6429,2611,3818,68.4
서울특별시,구로구,80세,2018,1813,776,1037,74.8,1749,756,993,76.1
서울특별시,구로구,81세,2018,1457,609,848,71.8,1409,602,807,74.6
서울특별시,구로구,82세,2018,1284,523,761,68.7,1237,513,724,70.9
서울특별시,구로구,83세,2018,1184,436,748,58.3,1150,427,723,59.1
서울특별시,구로구,84세,2018,913,317,596,53.2,884,313,571,54.8
서울특별시,구로구,85세이상,2018,3737,1086,2651,41,3648,1069,2579,41.5
서울특별시,구로구,85~89세,2018,2661,860,1801,47.8,2592,848,1744,48.6
서울특별시,구로구,85세,2018,780,299,481,62.2,762,292,470,62.1
서울특별시,구로구,86세,2018,629,204,425,48,609,200,409,48.9
서울특별시,구로구,87세,2018,468,138,330,41.8,455,137,318,43.1
서울특별시,구로구,88세,2018,436,116,320,36.3,426,116,310,37.4
서울특별시,구로구,89세,2018,348,103,245,42,340,103,237,43.5
서울특별시,구로구,90~94세,2018,862,181,681,26.6,844,176,668,26.3
서울특별시,구로구,90세,2018,294,59,235,25.1,288,56,232,24.1
서울특별시,구로구,91세,2018,216,51,165,30.9,211,50,161,31.1
서울특별시,구로구,92세,2018,166,34,132,25.8,162,33,129,25.6
서울특별시,구로구,93세,2018,106,17,89,19.1,105,17,88,19.3
서울특별시,구로구,94세,2018,80,20,60,33.3,78,20,58,34.5
서울특별시,구로구,95~99세,2018,199,43,156,27.6,197,43,154,27.9
서울특별시,구로구,95세,2018,81,19,62,30.6,80,19,61,31.1
서울특별시,구로구,96세,2018,55,11,44,25,55,11,44,25
서울특별시,구로구,97세,2018,33,5,28,17.9,32,5,27,18.5
서울특별시,구로구,98세,2018,24,7,17,41.2,24,7,17,41.2
서울특별시,구로구,99세,2018,6,X,5,20,6,X,5,20
서울특별시,구로구,100세이상,2018,15,X,13,15.4,15,X,13,15.4
서울특별시,구로구,15세미만,2018,47134,24077,23057,104.4,45011,22991,22020,104.4
서울특별시,구로구,15~64세,2018,323903,164279,159624,102.9,283970,141916,142054,99.9
서울특별시,구로구,65세이상,2018,62728,28730,33998,84.5,59098,27115,31983,84.8
서울특별시,구로구,평균연령,2018,42.9,42.2,43.5,,42.5,41.8,43.2,
서울특별시,구로구,중위연령,2018,43.7,43,44.5,,42.9,42.1,43.8,
서울특별시,금천구,합계,2018,249344,127278,122066,104.3,221820,112288,109532,102.5
서울특별시,금천구,0~4세,2018,7877,4068,3809,106.8,7152,3687,3465,106.4
서울특별시,금천구,0세,2018,1450,754,696,108.3,1300,673,627,107.3
서울특별시,금천구,1세,2018,1537,785,752,104.4,1378,701,677,103.5
서울특별시,금천구,2세,2018,1651,861,790,109,1475,765,710,107.7
서울특별시,금천구,3세,2018,1684,859,825,104.1,1562,793,769,103.1
서울특별시,금천구,4세,2018,1555,809,746,108.4,1437,755,682,110.7
서울특별시,금천구,5~9세,2018,7366,3744,3622,103.4,6970,3543,3427,103.4
서울특별시,금천구,5세,2018,1460,742,718,103.3,1368,692,676,102.4
서울특별시,금천구,6세,2018,1645,828,817,101.3,1545,779,766,101.7
서울특별시,금천구,7세,2018,1484,736,748,98.4,1399,694,705,98.4
서울특별시,금천구,8세,2018,1414,746,668,111.7,1351,712,639,111.4
서울특별시,금천구,9세,2018,1363,692,671,103.1,1307,666,641,103.9
서울특별시,금천구,10~14세,2018,7018,3587,3431,104.5,6839,3483,3356,103.8
서울특별시,금천구,10세,2018,1385,730,655,111.5,1334,700,634,110.4
서울특별시,금천구,11세,2018,1432,720,712,101.1,1393,696,697,99.9
서울특별시,금천구,12세,2018,1363,682,681,100.1,1334,666,668,99.7
서울특별시,금천구,13세,2018,1387,721,666,108.3,1350,697,653,106.7
서울특별시,금천구,14세,2018,1451,734,717,102.4,1428,724,704,102.8
서울특별시,금천구,15~19세,2018,9497,4799,4698,102.1,9334,4717,4617,102.2
서울특별시,금천구,15세,2018,1577,796,781,101.9,1553,785,768,102.2
서울특별시,금천구,16세,2018,1702,884,818,108.1,1681,875,806,108.6
서울특별시,금천구,17세,2018,1895,932,963,96.8,1878,921,957,96.2
서울특별시,금천구,18세,2018,2136,1056,1080,97.8,2097,1037,1060,97.8
서울특별시,금천구,19세,2018,2187,1131,1056,107.1,2125,1099,1026,107.1
서울특별시,금천구,20~24세,2018,14895,7548,7347,102.7,14178,7207,6971,103.4
서울특별시,금천구,20세,2018,2418,1272,1146,111,2342,1236,1106,111.8
서울특별시,금천구,21세,2018,2639,1373,1266,108.5,2537,1315,1222,107.6
서울특별시,금천구,22세,2018,3012,1517,1495,101.5,2844,1432,1412,101.4
서울특별시,금천구,23세,2018,3132,1555,1577,98.6,2969,1489,1480,100.6
서울특별시,금천구,24세,2018,3694,1831,1863,98.3,3486,1735,1751,99.1
서울특별시,금천구,25~29세,2018,21268,11212,10056,111.5,19179,10131,9048,112
서울특별시,금천구,25세,2018,4055,2065,1990,103.8,3767,1921,1846,104.1
서울특별시,금천구,26세,2018,4338,2262,2076,109,3986,2078,1908,108.9
서울특별시,금천구,27세,2018,4400,2350,2050,114.6,3975,2123,1852,114.6
서울특별시,금천구,28세,2018,4329,2324,2005,115.9,3802,2045,1757,116.4
서울특별시,금천구,29세,2018,4146,2211,1935,114.3,3649,1964,1685,116.6
서울특별시,금천구,30~34세,2018,19884,10955,8929,122.7,17051,9419,7632,123.4
서울특별시,금천구,30세,2018,3974,2162,1812,119.3,3377,1871,1506,124.2
서울특별시,금천구,31세,2018,4150,2261,1889,119.7,3543,1936,1607,120.5
서울특별시,금천구,32세,2018,4027,2272,1755,129.5,3417,1921,1496,128.4
서울특별시,금천구,33세,2018,3797,2082,1715,121.4,3298,1799,1499,120
서울특별시,금천구,34세,2018,3936,2178,1758,123.9,3416,1892,1524,124.1
서울특별시,금천구,35~39세,2018,19607,10877,8730,124.6,17422,9545,7877,121.2
서울특별시,금천구,35세,2018,3947,2149,1798,119.5,3482,1890,1592,118.7
서울특별시,금천구,36세,2018,4177,2347,1830,128.3,3668,2024,1644,123.1
서울특별시,금천구,37세,2018,3886,2178,1708,127.5,3498,1943,1555,125
서울특별시,금천구,38세,2018,3916,2186,1730,126.4,3520,1941,1579,122.9
서울특별시,금천구,39세,2018,3681,2017,1664,121.2,3254,1747,1507,115.9
서울특별시,금천구,40~44세,2018,17160,9293,7867,118.1,15102,7997,7105,112.6
서울특별시,금천구,40세,2018,3313,1783,1530,116.5,2888,1520,1368,111.1
서울특별시,금천구,41세,2018,3263,1837,1426,128.8,2896,1605,1291,124.3
서울특별시,금천구,42세,2018,3288,1749,1539,113.6,2890,1496,1394,107.3
서울특별시,금천구,43세,2018,3485,1871,1614,115.9,3069,1612,1457,110.6
서울특별시,금천구,44세,2018,3811,2053,1758,116.8,3359,1764,1595,110.6
서울특별시,금천구,45~49세,2018,21571,11206,10365,108.1,18215,9276,8939,103.8
서울특별시,금천구,45세,2018,4049,2150,1899,113.2,3455,1780,1675,106.3
서울특별시,금천구,46세,2018,4090,2138,1952,109.5,3519,1812,1707,106.2
서울특별시,금천구,47세,2018,4468,2342,2126,110.2,3727,1910,1817,105.1
서울특별시,금천구,48세,2018,4464,2296,2168,105.9,3740,1878,1862,100.9
서울특별시,금천구,49세,2018,4500,2280,2220,102.7,3774,1896,1878,101
서울특별시,금천구,50~54세,2018,22910,11588,11322,102.3,19069,9420,9649,97.6
서울특별시,금천구,50세,2018,4645,2350,2295,102.4,3894,1915,1979,96.8
서울특별시,금천구,51세,2018,4242,2067,2175,95,3613,1723,1890,91.2
서울특별시,금천구,52세,2018,4514,2323,2191,106,3765,1902,1863,102.1
서울특별시,금천구,53세,2018,4793,2427,2366,102.6,3964,1951,2013,96.9
서울특별시,금천구,54세,2018,4716,2421,2295,105.5,3833,1929,1904,101.3
서울특별시,금천구,55~59세,2018,24585,12354,12231,101,20770,10327,10443,98.9
서울특별시,금천구,55세,2018,5070,2563,2507,102.2,3969,2008,1961,102.4
서울특별시,금천구,56세,2018,4926,2541,2385,106.5,4077,2065,2012,102.6
서울특별시,금천구,57세,2018,4872,2388,2484,96.1,4404,2141,2263,94.6
서울특별시,금천구,58세,2018,5131,2601,2530,102.8,4314,2166,2148,100.8
서울특별시,금천구,59세,2018,4586,2261,2325,97.2,4006,1947,2059,94.6
서울특별시,금천구,60~64세,2018,19969,9910,10059,98.5,16867,8279,8588,96.4
서울특별시,금천구,60세,2018,4393,2227,2166,102.8,3679,1868,1811,103.1
서울특별시,금천구,61세,2018,4176,2081,2095,99.3,3444,1702,1742,97.7
서울특별시,금천구,62세,2018,3968,2012,1956,102.9,3383,1701,1682,101.1
서울특별시,금천구,63세,2018,3933,1893,2040,92.8,3367,1590,1777,89.5
서울특별시,금천구,64세,2018,3499,1697,1802,94.2,2994,1418,1576,90
서울특별시,금천구,65~69세,2018,13192,6400,6792,94.2,11876,5743,6133,93.6
서울특별시,금천구,65세,2018,2868,1375,1493,92.1,2493,1183,1310,90.3
서울특별시,금천구,66세,2018,3047,1499,1548,96.8,2731,1326,1405,94.4
서울특별시,금천구,67세,2018,2330,1173,1157,101.4,2088,1049,1039,101
서울특별시,금천구,68세,2018,2561,1225,1336,91.7,2353,1139,1214,93.8
서울특별시,금천구,69세,2018,2386,1128,1258,89.7,2211,1046,1165,89.8
서울특별시,금천구,70~74세,2018,9420,4428,4992,88.7,9067,4296,4771,90
서울특별시,금천구,70세,2018,2195,1069,1126,94.9,2083,1022,1061,96.3
서울특별시,금천구,71세,2018,2271,1063,1208,88,2189,1034,1155,89.5
서울특별시,금천구,72세,2018,1683,781,902,86.6,1616,757,859,88.1
서울특별시,금천구,73세,2018,1689,800,889,90,1642,784,858,91.4
서울특별시,금천구,74세,2018,1582,715,867,82.5,1537,699,838,83.4
서울특별시,금천구,75~79세,2018,7215,3268,3947,82.8,6987,3215,3772,85.2
서울특별시,금천구,75세,2018,1597,768,829,92.6,1546,752,794,94.7
서울특별시,금천구,76세,2018,1787,823,964,85.4,1744,809,935,86.5
서울특별시,금천구,77세,2018,1442,643,799,80.5,1394,633,761,83.2
서울특별시,금천구,78세,2018,1219,532,687,77.4,1175,526,649,81
서울특별시,금천구,79세,2018,1170,502,668,75.1,1128,495,633,78.2
서울특별시,금천구,80~84세,2018,3682,1428,2254,63.4,3554,1397,2157,64.8
서울특별시,금천구,80세,2018,963,405,558,72.6,927,396,531,74.6
서울특별시,금천구,81세,2018,793,322,471,68.4,764,317,447,70.9
서울특별시,금천구,82세,2018,715,277,438,63.2,698,271,427,63.5
서울특별시,금천구,83세,2018,668,236,432,54.6,639,227,412,55.1
서울특별시,금천구,84세,2018,543,188,355,53,526,186,340,54.7
서울특별시,금천구,85세이상,2018,2228,613,1615,38,2188,606,1582,38.3
서울특별시,금천구,85~89세,2018,1543,483,1060,45.6,1513,477,1036,46
서울특별시,금천구,85세,2018,423,141,282,50,411,137,274,50
서울특별시,금천구,86세,2018,395,132,263,50.2,389,131,258,50.8
서울특별시,금천구,87세,2018,303,101,202,50,299,100,199,50.3
서울특별시,금천구,88세,2018,254,71,183,38.8,248,71,177,40.1
서울특별시,금천구,89세,2018,168,38,130,29.2,166,38,128,29.7
서울특별시,금천구,90~94세,2018,524,90,434,20.7,515,90,425,21.2
서울특별시,금천구,90세,2018,176,33,143,23.1,172,33,139,23.7
서울특별시,금천구,91세,2018,142,24,118,20.3,141,24,117,20.5
서울특별시,금천구,92세,2018,70,8,62,12.9,68,8,60,13.3
서울특별시,금천구,93세,2018,83,14,69,20.3,82,14,68,20.6
서울특별시,금천구,94세,2018,53,11,42,26.2,52,11,41,26.8
서울특별시,금천구,95~99세,2018,141,37,104,35.6,140,36,104,34.6
서울특별시,금천구,95세,2018,48,16,32,50,48,16,32,50
서울특별시,금천구,96세,2018,39,10,29,34.5,39,10,29,34.5
서울특별시,금천구,97세,2018,23,5,18,27.8,22,X,18,22.2
서울특별시,금천구,98세,2018,24,X,20,20,24,X,20,20
서울특별시,금천구,99세,2018,7,X,5,40,7,X,5,40
서울특별시,금천구,100세이상,2018,20,X,17,17.6,20,X,17,17.6
서울특별시,금천구,15세미만,2018,22261,11399,10862,104.9,20961,10713,10248,104.5
서울특별시,금천구,15~64세,2018,191346,99742,91604,108.9,167187,86318,80869,106.7
서울특별시,금천구,65세이상,2018,35737,16137,19600,82.3,33672,15257,18415,82.9
서울특별시,금천구,평균연령,2018,43.6,42.8,44.5,,43.4,42.5,44.3,
서울특별시,금천구,중위연령,2018,45,43.8,46.3,,44.3,42.9,45.8,
서울특별시,영등포구,합계,2018,395286,198031,197255,100.4,346135,171625,174510,98.3
서울특별시,영등포구,0~4세,2018,14808,7580,7228,104.9,13597,6984,6613,105.6
서울특별시,영등포구,0세,2018,2853,1433,1420,100.9,2610,1301,1309,99.4
서울특별시,영등포구,1세,2018,2783,1440,1343,107.2,2541,1341,1200,111.8
서울특별시,영등포구,2세,2018,3187,1622,1565,103.6,2889,1463,1426,102.6
서울특별시,영등포구,3세,2018,3133,1629,1504,108.3,2909,1510,1399,107.9
서울특별시,영등포구,4세,2018,2852,1456,1396,104.3,2648,1369,1279,107
서울특별시,영등포구,5~9세,2018,12614,6353,6261,101.5,11888,5991,5897,101.6
서울특별시,영등포구,5세,2018,2685,1386,1299,106.7,2504,1296,1208,107.3
서울특별시,영등포구,6세,2018,2781,1365,1416,96.4,2614,1284,1330,96.5
서울특별시,영등포구,7세,2018,2533,1241,1292,96.1,2394,1167,1227,95.1
서울특별시,영등포구,8세,2018,2371,1197,1174,102,2238,1129,1109,101.8
서울특별시,영등포구,9세,2018,2244,1164,1080,107.8,2138,1115,1023,109
서울특별시,영등포구,10~14세,2018,11359,6004,5355,112.1,10888,5753,5135,112
서울특별시,영등포구,10세,2018,2414,1257,1157,108.6,2295,1193,1102,108.3
서울특별시,영등포구,11세,2018,2362,1238,1124,110.1,2270,1194,1076,111
서울특별시,영등포구,12세,2018,2173,1160,1013,114.5,2088,1113,975,114.2
서울특별시,영등포구,13세,2018,2074,1102,972,113.4,1983,1058,925,114.4
서울특별시,영등포구,14세,2018,2336,1247,1089,114.5,2252,1195,1057,113.1
서울특별시,영등포구,15~19세,2018,13400,7050,6350,111,13047,6853,6194,110.6
서울특별시,영등포구,15세,2018,2291,1256,1035,121.4,2235,1223,1012,120.8
서울특별시,영등포구,16세,2018,2409,1288,1121,114.9,2353,1259,1094,115.1
서울특별시,영등포구,17세,2018,2733,1409,1324,106.4,2676,1379,1297,106.3
서울특별시,영등포구,18세,2018,2956,1518,1438,105.6,2872,1469,1403,104.7
서울특별시,영등포구,19세,2018,3011,1579,1432,110.3,2911,1523,1388,109.7
서울특별시,영등포구,20~24세,2018,21689,10329,11360,90.9,20363,9716,10647,91.3
서울특별시,영등포구,20세,2018,3520,1786,1734,103,3332,1693,1639,103.3
서울특별시,영등포구,21세,2018,3800,1927,1873,102.9,3603,1826,1777,102.8
서울특별시,영등포구,22세,2018,4170,1975,2195,90,3920,1864,2056,90.7
서울특별시,영등포구,23세,2018,4831,2172,2659,81.7,4515,2042,2473,82.6
서울특별시,영등포구,24세,2018,5368,2469,2899,85.2,4993,2291,2702,84.8
서울특별시,영등포구,25~29세,2018,34902,16983,17919,94.8,31270,15079,16191,93.1
서울특별시,영등포구,25세,2018,6261,2842,3419,83.1,5768,2603,3165,82.2
서울특별시,영등포구,26세,2018,7048,3377,3671,92,6408,3044,3364,90.5
서울특별시,영등포구,27세,2018,7176,3437,3739,91.9,6471,3065,3406,90
서울특별시,영등포구,28세,2018,7090,3526,3564,98.9,6205,3071,3134,98
서울특별시,영등포구,29세,2018,7327,3801,3526,107.8,6418,3296,3122,105.6
서울특별시,영등포구,30~34세,2018,36596,18890,17706,106.7,31636,16090,15546,103.5
서울특별시,영등포구,30세,2018,7418,3749,3669,102.2,6421,3213,3208,100.2
서울특별시,영등포구,31세,2018,7532,3769,3763,100.2,6357,3116,3241,96.1
서울특별시,영등포구,32세,2018,7308,3782,3526,107.3,6268,3195,3073,104
서울특별시,영등포구,33세,2018,7194,3791,3403,111.4,6306,3279,3027,108.3
서울특별시,영등포구,34세,2018,7144,3799,3345,113.6,6284,3287,2997,109.7
서울특별시,영등포구,35~39세,2018,35290,18777,16513,113.7,31339,16397,14942,109.7
서울특별시,영등포구,35세,2018,7279,3812,3467,110,6411,3300,3111,106.1
서울특별시,영등포구,36세,2018,7513,3959,3554,111.4,6660,3472,3188,108.9
서울특별시,영등포구,37세,2018,7105,3845,3260,117.9,6381,3413,2968,115
서울특별시,영등포구,38세,2018,6873,3654,3219,113.5,6203,3241,2962,109.4
서울특별시,영등포구,39세,2018,6520,3507,3013,116.4,5684,2971,2713,109.5
서울특별시,영등포구,40~44세,2018,28901,15366,13535,113.5,25376,13161,12215,107.7
서울특별시,영등포구,40세,2018,5653,3012,2641,114,4914,2543,2371,107.3
서울특별시,영등포구,41세,2018,5793,3045,2748,110.8,5159,2653,2506,105.9
서울특별시,영등포구,42세,2018,5664,2977,2687,110.8,4984,2562,2422,105.8
서울특별시,영등포구,43세,2018,5661,3020,2641,114.4,5001,2612,2389,109.3
서울특별시,영등포구,44세,2018,6130,3312,2818,117.5,5318,2791,2527,110.4
서울특별시,영등포구,45~49세,2018,33411,17422,15989,109,27680,14131,13549,104.3
서울특별시,영등포구,45세,2018,6375,3387,2988,113.4,5408,2777,2631,105.5
서울특별시,영등포구,46세,2018,6472,3449,3023,114.1,5429,2832,2597,109
서울특별시,영등포구,47세,2018,6958,3612,3346,107.9,5780,2937,2843,103.3
서울특별시,영등포구,48세,2018,6739,3547,3192,111.1,5456,2825,2631,107.4
서울특별시,영등포구,49세,2018,6867,3427,3440,99.6,5607,2760,2847,96.9
서울특별시,영등포구,50~54세,2018,32660,16606,16054,103.4,25795,12959,12836,101
서울특별시,영등포구,50세,2018,6677,3449,3228,106.8,5370,2724,2646,102.9
서울특별시,영등포구,51세,2018,6178,3095,3083,100.4,5106,2502,2604,96.1
서울특별시,영등포구,52세,2018,6318,3248,3070,105.8,4989,2537,2452,103.5
서울특별시,영등포구,53세,2018,6666,3358,3308,101.5,5159,2588,2571,100.7
서울특별시,영등포구,54세,2018,6821,3456,3365,102.7,5171,2608,2563,101.8
서울특별시,영등포구,55~59세,2018,34799,17284,17515,98.7,27737,13666,14071,97.1
서울특별시,영등포구,55세,2018,7272,3766,3506,107.4,5237,2683,2554,105.1
서울특별시,영등포구,56세,2018,6937,3523,3414,103.2,5452,2777,2675,103.8
서울특별시,영등포구,57세,2018,6745,3252,3493,93.1,5819,2789,3030,92
서울특별시,영등포구,58세,2018,7309,3517,3792,92.7,5863,2791,3072,90.9
서울특별시,영등포구,59세,2018,6536,3226,3310,97.5,5366,2626,2740,95.8
서울특별시,영등포구,60~64세,2018,29569,14626,14943,97.9,23933,11673,12260,95.2
서울특별시,영등포구,60세,2018,6458,3224,3234,99.7,5174,2553,2621,97.4
서울특별시,영등포구,61세,2018,6462,3213,3249,98.9,5132,2509,2623,95.7
서울특별시,영등포구,62세,2018,5802,2909,2893,100.6,4690,2330,2360,98.7
서울특별시,영등포구,63세,2018,5941,2877,3064,93.9,4885,2308,2577,89.6
서울특별시,영등포구,64세,2018,4906,2403,2503,96,4052,1973,2079,94.9
서울특별시,영등포구,65~69세,2018,19469,9359,10110,92.6,17107,8155,8952,91.1
서울특별시,영등포구,65세,2018,4272,2055,2217,92.7,3579,1694,1885,89.9
서울특별시,영등포구,66세,2018,4534,2210,2324,95.1,3958,1909,2049,93.2
서울특별시,영등포구,67세,2018,3350,1620,1730,93.6,2900,1386,1514,91.5
서울특별시,영등포구,68세,2018,3665,1711,1954,87.6,3327,1548,1779,87
서울특별시,영등포구,69세,2018,3648,1763,1885,93.5,3343,1618,1725,93.8
서울특별시,영등포구,70~74세,2018,14174,6665,7509,88.8,13565,6447,7118,90.6
서울특별시,영등포구,70세,2018,3385,1629,1756,92.8,3205,1551,1654,93.8
서울특별시,영등포구,71세,2018,3304,1541,1763,87.4,3156,1490,1666,89.4
서울특별시,영등포구,72세,2018,2633,1238,1395,88.7,2498,1191,1307,91.1
서울특별시,영등포구,73세,2018,2471,1192,1279,93.2,2390,1165,1225,95.1
서울특별시,영등포구,74세,2018,2381,1065,1316,80.9,2316,1050,1266,82.9
서울특별시,영등포구,75~79세,2018,11175,4919,6256,78.6,10786,4821,5965,80.8
서울특별시,영등포구,75세,2018,2398,1068,1330,80.3,2328,1045,1283,81.4
서울특별시,영등포구,76세,2018,2800,1233,1567,78.7,2725,1216,1509,80.6
서울특별시,영등포구,77세,2018,2131,944,1187,79.5,2051,925,1126,82.1
서울특별시,영등포구,78세,2018,1940,830,1110,74.8,1864,809,1055,76.7
서울특별시,영등포구,79세,2018,1906,844,1062,79.5,1818,826,992,83.3
서울특별시,영등포구,80~84세,2018,6617,2675,3942,67.9,6380,2621,3759,69.7
서울특별시,영등포구,80세,2018,1619,681,938,72.6,1559,669,890,75.2
서울특별시,영등포구,81세,2018,1494,612,882,69.4,1439,595,844,70.5
서울특별시,영등포구,82세,2018,1317,529,788,67.1,1266,518,748,69.3
서울특별시,영등포구,83세,2018,1222,510,712,71.6,1180,500,680,73.5
서울특별시,영등포구,84세,2018,965,343,622,55.1,936,339,597,56.8
서울특별시,영등포구,85세이상,2018,3853,1143,2710,42.2,3748,1128,2620,43.1
서울특별시,영등포구,85~89세,2018,2721,856,1865,45.9,2640,845,1795,47.1
서울특별시,영등포구,85세,2018,797,261,536,48.7,765,258,507,50.9
서울특별시,영등포구,86세,2018,643,214,429,49.9,626,210,416,50.5
서울특별시,영등포구,87세,2018,506,156,350,44.6,490,154,336,45.8
서울특별시,영등포구,88세,2018,428,129,299,43.1,417,128,289,44.3
서울특별시,영등포구,89세,2018,347,96,251,38.2,342,95,247,38.5
서울특별시,영등포구,90~94세,2018,897,227,670,33.9,877,224,653,34.3
서울특별시,영등포구,90세,2018,293,84,209,40.2,287,83,204,40.7
서울특별시,영등포구,91세,2018,233,56,177,31.6,227,56,171,32.7
서울특별시,영등포구,92세,2018,140,29,111,26.1,137,28,109,25.7
서울특별시,영등포구,93세,2018,129,29,100,29,126,29,97,29.9
서울특별시,영등포구,94세,2018,102,29,73,39.7,100,28,72,38.9
서울특별시,영등포구,95~99세,2018,215,54,161,33.5,211,53,158,33.5
서울특별시,영등포구,95세,2018,93,23,70,32.9,92,22,70,31.4
서울특별시,영등포구,96세,2018,54,16,38,42.1,52,16,36,44.4
서울특별시,영등포구,97세,2018,31,7,24,29.2,31,7,24,29.2
서울특별시,영등포구,98세,2018,27,8,19,42.1,26,8,18,44.4
서울특별시,영등포구,99세,2018,10,X,10,0,10,X,10,0
서울특별시,영등포구,100세이상,2018,20,6,14,42.9,20,6,14,42.9
서울특별시,영등포구,15세미만,2018,38781,19937,18844,105.8,36373,18728,17645,106.1
서울특별시,영등포구,15~64세,2018,301217,153333,147884,103.7,258176,129725,128451,101
서울특별시,영등포구,65세이상,2018,55288,24761,30527,81.1,51586,23172,28414,81.6
서울특별시,영등포구,평균연령,2018,42.8,42.2,43.5,,42.4,41.7,43.1,
서울특별시,영등포구,중위연령,2018,43,42.3,43.7,,41.8,41.2,42.5,
서울특별시,동작구,합계,2018,397980,193713,204267,94.8,380659,185596,195063,95.1
서울특별시,동작구,0~4세,2018,13491,6828,6663,102.5,13258,6708,6550,102.4
서울특별시,동작구,0세,2018,2453,1247,1206,103.4,2394,1220,1174,103.9
서울특별시,동작구,1세,2018,2521,1234,1287,95.9,2474,1206,1268,95.1
서울특별시,동작구,2세,2018,2794,1434,1360,105.4,2744,1405,1339,104.9
서울특별시,동작구,3세,2018,2964,1493,1471,101.5,2926,1478,1448,102.1
서울특별시,동작구,4세,2018,2759,1420,1339,106,2720,1399,1321,105.9
서울특별시,동작구,5~9세,2018,13678,6991,6687,104.5,13553,6931,6622,104.7
서울특별시,동작구,5세,2018,2750,1392,1358,102.5,2709,1376,1333,103.2
서울특별시,동작구,6세,2018,2879,1478,1401,105.5,2859,1466,1393,105.2
서울특별시,동작구,7세,2018,2780,1396,1384,100.9,2751,1381,1370,100.8
서울특별시,동작구,8세,2018,2679,1420,1259,112.8,2662,1410,1252,112.6
서울특별시,동작구,9세,2018,2590,1305,1285,101.6,2572,1298,1274,101.9
서울특별시,동작구,10~14세,2018,12918,6722,6196,108.5,12845,6688,6157,108.6
서울특별시,동작구,10세,2018,2626,1369,1257,108.9,2606,1359,1247,109
서울특별시,동작구,11세,2018,2681,1434,1247,115,2666,1429,1237,115.5
서울특별시,동작구,12세,2018,2499,1287,1212,106.2,2483,1277,1206,105.9
서울특별시,동작구,13세,2018,2452,1253,1199,104.5,2445,1250,1195,104.6
서울특별시,동작구,14세,2018,2660,1379,1281,107.7,2645,1373,1272,107.9
서울특별시,동작구,15~19세,2018,17517,8810,8707,101.2,16976,8612,8364,103
서울특별시,동작구,15세,2018,2658,1370,1288,106.4,2646,1365,1281,106.6
서울특별시,동작구,16세,2018,2737,1387,1350,102.7,2727,1381,1346,102.6
서울특별시,동작구,17세,2018,3093,1597,1496,106.8,3068,1588,1480,107.3
서울특별시,동작구,18세,2018,3842,1916,1926,99.5,3685,1865,1820,102.5
서울특별시,동작구,19세,2018,5187,2540,2647,96,4850,2413,2437,99
서울특별시,동작구,20~24세,2018,33393,15956,17437,91.5,30312,14827,15485,95.8
서울특별시,동작구,20세,2018,5888,2697,3191,84.5,5282,2486,2796,88.9
서울특별시,동작구,21세,2018,5894,2645,3249,81.4,5249,2420,2829,85.5
서울특별시,동작구,22세,2018,6651,3177,3474,91.5,6037,2947,3090,95.4
서울특별시,동작구,23세,2018,7258,3594,3664,98.1,6596,3347,3249,103
서울특별시,동작구,24세,2018,7702,3843,3859,99.6,7148,3627,3521,103
서울특별시,동작구,25~29세,2018,37471,18913,18558,101.9,35501,18055,17446,103.5
서울특별시,동작구,25세,2018,7782,3854,3928,98.1,7331,3700,3631,101.9
서울특별시,동작구,26세,2018,7933,4092,3841,106.5,7534,3917,3617,108.3
서울특별시,동작구,27세,2018,7657,3805,3852,98.8,7305,3643,3662,99.5
서울특별시,동작구,28세,2018,7283,3730,3553,105,6879,3533,3346,105.6
서울특별시,동작구,29세,2018,6816,3432,3384,101.4,6452,3262,3190,102.3
서울특별시,동작구,30~34세,2018,32254,16207,16047,101,30547,15323,15224,100.7
서울특별시,동작구,30세,2018,6774,3422,3352,102.1,6387,3227,3160,102.1
서울특별시,동작구,31세,2018,6546,3316,3230,102.7,6166,3122,3044,102.6
서울특별시,동작구,32세,2018,6357,3156,3201,98.6,6009,2980,3029,98.4
서울특별시,동작구,33세,2018,6321,3155,3166,99.7,6029,2996,3033,98.8
서울특별시,동작구,34세,2018,6256,3158,3098,101.9,5956,2998,2958,101.4
서울특별시,동작구,35~39세,2018,33242,17029,16213,105,32049,16348,15701,104.1
서울특별시,동작구,35세,2018,6782,3436,3346,102.7,6507,3288,3219,102.1
서울특별시,동작구,36세,2018,6835,3475,3360,103.4,6570,3325,3245,102.5
서울특별시,동작구,37세,2018,6588,3459,3129,110.5,6383,3343,3040,110
서울특별시,동작구,38세,2018,6735,3423,3312,103.4,6529,3302,3227,102.3
서울특별시,동작구,39세,2018,6302,3236,3066,105.5,6060,3090,2970,104
서울특별시,동작구,40~44세,2018,28761,14630,14131,103.5,27774,14059,13715,102.5
서울특별시,동작구,40세,2018,5643,2781,2862,97.2,5435,2660,2775,95.9
서울특별시,동작구,41세,2018,5630,2798,2832,98.8,5459,2698,2761,97.7
서울특별시,동작구,42세,2018,5600,2889,2711,106.6,5408,2777,2631,105.5
서울특별시,동작구,43세,2018,5728,2931,2797,104.8,5528,2811,2717,103.5
서울특별시,동작구,44세,2018,6160,3231,2929,110.3,5944,3113,2831,110
서울특별시,동작구,45~49세,2018,31244,15602,15642,99.7,29787,14842,14945,99.3
서울특별시,동작구,45세,2018,6023,3010,3013,99.9,5799,2895,2904,99.7
서울특별시,동작구,46세,2018,6085,3156,2929,107.8,5812,2998,2814,106.5
서울특별시,동작구,47세,2018,6552,3215,3337,96.3,6237,3051,3186,95.8
서울특별시,동작구,48세,2018,6231,3121,3110,100.4,5921,2974,2947,100.9
서울특별시,동작구,49세,2018,6353,3100,3253,95.3,6018,2924,3094,94.5
서울특별시,동작구,50~54세,2018,28793,13710,15083,90.9,27025,12854,14171,90.7
서울특별시,동작구,50세,2018,6105,2877,3228,89.1,5767,2697,3070,87.9
서울특별시,동작구,51세,2018,5635,2662,2973,89.5,5341,2523,2818,89.5
서울특별시,동작구,52세,2018,5511,2664,2847,93.6,5165,2509,2656,94.5
서울특별시,동작구,53세,2018,5733,2705,3028,89.3,5347,2518,2829,89
서울특별시,동작구,54세,2018,5809,2802,3007,93.2,5405,2607,2798,93.2
서울특별시,동작구,55~59세,2018,31104,14646,16458,89,29326,13804,15522,88.9
서울특별시,동작구,55세,2018,6032,2899,3133,92.5,5546,2651,2895,91.6
서울특별시,동작구,56세,2018,6058,2912,3146,92.6,5668,2723,2945,92.5
서울특별시,동작구,57세,2018,6287,2926,3361,87.1,6077,2837,3240,87.6
서울특별시,동작구,58세,2018,6747,3134,3613,86.7,6340,2951,3389,87.1
서울특별시,동작구,59세,2018,5980,2775,3205,86.6,5695,2642,3053,86.5
서울특별시,동작구,60~64세,2018,27076,12599,14477,87,25588,11849,13739,86.2
서울특별시,동작구,60세,2018,5804,2651,3153,84.1,5470,2487,2983,83.4
서울특별시,동작구,61세,2018,5829,2761,3068,90,5448,2565,2883,89
서울특별시,동작구,62세,2018,5259,2440,2819,86.6,4966,2286,2680,85.3
서울특별시,동작구,63세,2018,5554,2593,2961,87.6,5303,2472,2831,87.3
서울특별시,동작구,64세,2018,4630,2154,2476,87,4401,2039,2362,86.3
서울특별시,동작구,65~69세,2018,19061,8669,10392,83.4,18464,8394,10070,83.4
서울특별시,동작구,65세,2018,4134,1919,2215,86.6,3952,1833,2119,86.5
서울특별시,동작구,66세,2018,4356,2011,2345,85.8,4214,1950,2264,86.1
서울특별시,동작구,67세,2018,3344,1488,1856,80.2,3238,1438,1800,79.9
서울특별시,동작구,68세,2018,3608,1680,1928,87.1,3515,1636,1879,87.1
서울특별시,동작구,69세,2018,3619,1571,2048,76.7,3545,1537,2008,76.5
서울특별시,동작구,70~74세,2018,15368,6884,8484,81.1,15224,6825,8399,81.3
서울특별시,동작구,70세,2018,3613,1620,1993,81.3,3570,1604,1966,81.6
서울특별시,동작구,71세,2018,3586,1600,1986,80.6,3557,1590,1967,80.8
서울특별시,동작구,72세,2018,2880,1256,1624,77.3,2851,1239,1612,76.9
서울특별시,동작구,73세,2018,2668,1201,1467,81.9,2648,1192,1456,81.9
서울특별시,동작구,74세,2018,2621,1207,1414,85.4,2598,1200,1398,85.8
서울특별시,동작구,75~79세,2018,11997,5616,6381,88,11907,5593,6314,88.6
서울특별시,동작구,75세,2018,2585,1257,1328,94.7,2561,1247,1314,94.9
서울특별시,동작구,76세,2018,2994,1456,1538,94.7,2974,1452,1522,95.4
서울특별시,동작구,77세,2018,2334,1066,1268,84.1,2314,1062,1252,84.8
서울특별시,동작구,78세,2018,2122,958,1164,82.3,2107,957,1150,83.2
서울특별시,동작구,79세,2018,1962,879,1083,81.2,1951,875,1076,81.3
서울특별시,동작구,80~84세,2018,6649,2691,3958,68,6584,2677,3907,68.5
서울특별시,동작구,80세,2018,1667,729,938,77.7,1653,726,927,78.3
서울특별시,동작구,81세,2018,1503,603,900,67,1487,599,888,67.5
서울특별시,동작구,82세,2018,1316,523,793,66,1296,519,777,66.8
서울특별시,동작구,83세,2018,1167,448,719,62.3,1157,446,711,62.7
서울특별시,동작구,84세,2018,996,388,608,63.8,991,387,604,64.1
서울특별시,동작구,85세이상,2018,3963,1210,2753,44,3939,1207,2732,44.2
서울특별시,동작구,85~89세,2018,2768,907,1861,48.7,2752,905,1847,49
서울특별시,동작구,85세,2018,788,274,514,53.3,780,273,507,53.8
서울특별시,동작구,86세,2018,655,207,448,46.2,653,207,446,46.4
서울특별시,동작구,87세,2018,494,171,323,52.9,494,171,323,52.9
서울특별시,동작구,88세,2018,439,122,317,38.5,436,122,314,38.9
서울특별시,동작구,89세,2018,392,133,259,51.4,389,132,257,51.4
서울특별시,동작구,90~94세,2018,943,241,702,34.3,939,240,699,34.3
서울특별시,동작구,90세,2018,314,84,230,36.5,313,83,230,36.1
서울특별시,동작구,91세,2018,234,56,178,31.5,232,56,176,31.8
서울특별시,동작구,92세,2018,167,43,124,34.7,167,43,124,34.7
서울특별시,동작구,93세,2018,123,27,96,28.1,122,27,95,28.4
서울특별시,동작구,94세,2018,105,31,74,41.9,105,31,74,41.9
서울특별시,동작구,95~99세,2018,227,56,171,32.7,223,56,167,33.5
서울특별시,동작구,95세,2018,87,23,64,35.9,86,23,63,36.5
서울특별시,동작구,96세,2018,50,12,38,31.6,50,12,38,31.6
서울특별시,동작구,97세,2018,35,8,27,29.6,34,8,26,30.8
서울특별시,동작구,98세,2018,34,9,25,36,34,9,25,36
서울특별시,동작구,99세,2018,21,X,17,23.5,19,X,15,26.7
서울특별시,동작구,100세이상,2018,25,6,19,31.6,25,6,19,31.6
서울특별시,동작구,15세미만,2018,40087,20541,19546,105.1,39656,20327,19329,105.2
서울특별시,동작구,15~64세,2018,300855,148102,152753,97,284885,140573,144312,97.4
서울특별시,동작구,65세이상,2018,57038,25070,31968,78.4,56118,24696,31422,78.6
서울특별시,동작구,평균연령,2018,41.7,40.8,42.6,,41.8,40.8,42.7,
서울특별시,동작구,중위연령,2018,40.9,39.8,42,,41,39.8,42.2,
서울특별시,관악구,합계,2018,510303,255687,254616,100.4,484885,243815,241070,101.1
서울특별시,관악구,0~4세,2018,13933,7190,6743,106.6,13390,6926,6464,107.1
서울특별시,관악구,0세,2018,2573,1385,1188,116.6,2462,1333,1129,118.1
서울특별시,관악구,1세,2018,2694,1392,1302,106.9,2583,1328,1255,105.8
서울특별시,관악구,2세,2018,2862,1449,1413,102.5,2738,1390,1348,103.1
서울특별시,관악구,3세,2018,2970,1532,1438,106.5,2866,1486,1380,107.7
서울특별시,관악구,4세,2018,2834,1432,1402,102.1,2741,1389,1352,102.7
서울특별시,관악구,5~9세,2018,13488,6925,6563,105.5,13199,6777,6422,105.5
서울특별시,관악구,5세,2018,2738,1400,1338,104.6,2656,1365,1291,105.7
서울특별시,관악구,6세,2018,2832,1454,1378,105.5,2766,1418,1348,105.2
서울특별시,관악구,7세,2018,2768,1418,1350,105,2731,1396,1335,104.6
서울특별시,관악구,8세,2018,2643,1343,1300,103.3,2594,1314,1280,102.7
서울특별시,관악구,9세,2018,2507,1310,1197,109.4,2452,1284,1168,109.9
서울특별시,관악구,10~14세,2018,13309,6840,6469,105.7,13122,6757,6365,106.2
서울특별시,관악구,10세,2018,2679,1388,1291,107.5,2636,1366,1270,107.6
서울특별시,관악구,11세,2018,2744,1397,1347,103.7,2706,1381,1325,104.2
서울특별시,관악구,12세,2018,2555,1340,1215,110.3,2518,1325,1193,111.1
서울특별시,관악구,13세,2018,2547,1271,1276,99.6,2513,1254,1259,99.6
서울특별시,관악구,14세,2018,2784,1444,1340,107.8,2749,1431,1318,108.6
서울특별시,관악구,15~19세,2018,19137,9712,9425,103,18775,9570,9205,104
서울특별시,관악구,15세,2018,2831,1437,1394,103.1,2811,1427,1384,103.1
서울특별시,관악구,16세,2018,3102,1548,1554,99.6,3076,1537,1539,99.9
서울특별시,관악구,17세,2018,3452,1700,1752,97,3426,1685,1741,96.8
서울특별시,관악구,18세,2018,4336,2256,2080,108.5,4236,2226,2010,110.7
서울특별시,관악구,19세,2018,5416,2771,2645,104.8,5226,2695,2531,106.5
서울특별시,관악구,20~24세,2018,42323,19510,22813,85.5,40413,18882,21531,87.7
서울특별시,관악구,20세,2018,6184,3021,3163,95.5,5936,2937,2999,97.9
서울특별시,관악구,21세,2018,6634,2933,3701,79.2,6363,2847,3516,81
서울특별시,관악구,22세,2018,7987,3627,4360,83.2,7636,3518,4118,85.4
서울특별시,관악구,23세,2018,9627,4415,5212,84.7,9147,4261,4886,87.2
서울특별시,관악구,24세,2018,11891,5514,6377,86.5,11331,5319,6012,88.5
서울특별시,관악구,25~29세,2018,66369,34237,32132,106.6,63039,32895,30144,109.1
서울특별시,관악구,25세,2018,12941,6244,6697,93.2,12335,6026,6309,95.5
서울특별시,관악구,26세,2018,14335,7210,7125,101.2,13722,6985,6737,103.7
서울특별시,관악구,27세,2018,13719,7175,6544,109.6,13027,6902,6125,112.7
서울특별시,관악구,28세,2018,13002,6910,6092,113.4,12318,6602,5716,115.5
서울특별시,관악구,29세,2018,12372,6698,5674,118,11637,6380,5257,121.4
서울특별시,관악구,30~34세,2018,49870,27248,22622,120.4,46874,25771,21103,122.1
서울특별시,관악구,30세,2018,11334,6129,5205,117.8,10661,5822,4839,120.3
서울특별시,관악구,31세,2018,10543,5738,4805,119.4,9872,5395,4477,120.5
서울특별시,관악구,32세,2018,9959,5492,4467,122.9,9309,5164,4145,124.6
서울특별시,관악구,33세,2018,9069,5012,4057,123.5,8542,4749,3793,125.2
서울특별시,관악구,34세,2018,8965,4877,4088,119.3,8490,4641,3849,120.6
서울특별시,관악구,35~39세,2018,43258,23531,19727,119.3,41209,22383,18826,118.9
서울특별시,관악구,35세,2018,8893,4854,4039,120.2,8426,4587,3839,119.5
서울특별시,관악구,36세,2018,9380,5064,4316,117.3,8885,4802,4083,117.6
서울특별시,관악구,37세,2018,8688,4797,3891,123.3,8343,4593,3750,122.5
서울특별시,관악구,38세,2018,8583,4614,3969,116.3,8255,4439,3816,116.3
서울특별시,관악구,39세,2018,7714,4202,3512,119.6,7300,3962,3338,118.7
서울특별시,관악구,40~44세,2018,34539,18627,15912,117.1,32913,17720,15193,116.6
서울특별시,관악구,40세,2018,6864,3646,3218,113.3,6557,3476,3081,112.8
서울특별시,관악구,41세,2018,6794,3640,3154,115.4,6474,3457,3017,114.6
서울특별시,관악구,42세,2018,6721,3732,2989,124.9,6396,3551,2845,124.8
서울특별시,관악구,43세,2018,6821,3683,3138,117.4,6519,3509,3010,116.6
서울특별시,관악구,44세,2018,7339,3926,3413,115,6967,3727,3240,115
서울특별시,관악구,45~49세,2018,37672,19802,17870,110.8,35306,18613,16693,111.5
서울특별시,관악구,45세,2018,7369,4013,3356,119.6,6986,3802,3184,119.4
서울특별시,관악구,46세,2018,7537,4032,3505,115,7079,3792,3287,115.4
서울특별시,관악구,47세,2018,7910,4154,3756,110.6,7426,3924,3502,112.1
서울특별시,관악구,48세,2018,7490,3878,3612,107.4,6968,3619,3349,108.1
서울특별시,관악구,49세,2018,7366,3725,3641,102.3,6847,3476,3371,103.1
서울특별시,관악구,50~54세,2018,34930,17210,17720,97.1,32066,15870,16196,98
서울특별시,관악구,50세,2018,7294,3576,3718,96.2,6765,3315,3450,96.1
서울특별시,관악구,51세,2018,6756,3232,3524,91.7,6281,3022,3259,92.7
서울특별시,관악구,52세,2018,6780,3487,3293,105.9,6231,3212,3019,106.4
서울특별시,관악구,53세,2018,7256,3528,3728,94.6,6631,3258,3373,96.6
서울특별시,관악구,54세,2018,6844,3387,3457,98,6158,3063,3095,99
서울특별시,관악구,55~59세,2018,38056,18020,20036,89.9,35073,16587,18486,89.7
서울특별시,관악구,55세,2018,7459,3616,3843,94.1,6605,3211,3394,94.6
서울특별시,관악구,56세,2018,7467,3599,3868,93,6826,3300,3526,93.6
서울특별시,관악구,57세,2018,7638,3621,4017,90.1,7243,3426,3817,89.8
서울특별시,관악구,58세,2018,8141,3768,4373,86.2,7535,3482,4053,85.9
서울특별시,관악구,59세,2018,7351,3416,3935,86.8,6864,3168,3696,85.7
서울특별시,관악구,60~64세,2018,33145,15389,17756,86.7,30796,14244,16552,86.1
서울특별시,관악구,60세,2018,7038,3387,3651,92.8,6501,3114,3387,91.9
서울특별시,관악구,61세,2018,6795,3130,3665,85.4,6257,2866,3391,84.5
서울특별시,관악구,62세,2018,6649,3058,3591,85.2,6194,2855,3339,85.5
서울특별시,관악구,63세,2018,6822,3106,3716,83.6,6377,2886,3491,82.7
서울특별시,관악구,64세,2018,5841,2708,3133,86.4,5467,2523,2944,85.7
서울특별시,관악구,65~69세,2018,24639,11353,13286,85.5,23684,10919,12765,85.5
서울특별시,관악구,65세,2018,5153,2284,2869,79.6,4885,2159,2726,79.2
서울특별시,관악구,66세,2018,5665,2646,3019,87.6,5440,2547,2893,88
서울특별시,관악구,67세,2018,4339,1988,2351,84.6,4139,1898,2241,84.7
서울특별시,관악구,68세,2018,4660,2216,2444,90.7,4537,2160,2377,90.9
서울특별시,관악구,69세,2018,4822,2219,2603,85.2,4683,2155,2528,85.2
서울특별시,관악구,70~74세,2018,19464,8924,10540,84.7,19158,8811,10347,85.2
서울특별시,관악구,70세,2018,4595,2102,2493,84.3,4495,2060,2435,84.6
서울특별시,관악구,71세,2018,4557,2071,2486,83.3,4488,2046,2442,83.8
서울특별시,관악구,72세,2018,3516,1581,1935,81.7,3462,1559,1903,81.9
서울특별시,관악구,73세,2018,3414,1595,1819,87.7,3368,1579,1789,88.3
서울특별시,관악구,74세,2018,3382,1575,1807,87.2,3345,1567,1778,88.1
서울특별시,관악구,75~79세,2018,14871,6931,7940,87.3,14711,6889,7822,88.1
서울특별시,관악구,75세,2018,3375,1575,1800,87.5,3335,1560,1775,87.9
서울특별시,관악구,76세,2018,3763,1767,1996,88.5,3733,1757,1976,88.9
서울특별시,관악구,77세,2018,2912,1389,1523,91.2,2883,1383,1500,92.2
서울특별시,관악구,78세,2018,2432,1084,1348,80.4,2400,1078,1322,81.5
서울특별시,관악구,79세,2018,2389,1116,1273,87.7,2360,1111,1249,89
서울특별시,관악구,80~84세,2018,7270,3042,4228,71.9,7179,3017,4162,72.5
서울특별시,관악구,80세,2018,1992,894,1098,81.4,1965,887,1078,82.3
서울특별시,관악구,81세,2018,1648,694,954,72.7,1629,687,942,72.9
서울특별시,관악구,82세,2018,1386,582,804,72.4,1368,575,793,72.5
서울특별시,관악구,83세,2018,1287,495,792,62.5,1272,492,780,63.1
서울특별시,관악구,84세,2018,957,377,580,65,945,376,569,66.1
서울특별시,관악구,85세이상,2018,4030,1196,2834,42.2,3978,1184,2794,42.4
서울특별시,관악구,85~89세,2018,2846,928,1918,48.4,2808,918,1890,48.6
서울특별시,관악구,85세,2018,785,281,504,55.8,774,279,495,56.4
서울특별시,관악구,86세,2018,666,237,429,55.2,659,234,425,55.1
서울특별시,관악구,87세,2018,529,162,367,44.1,521,160,361,44.3
서울특별시,관악구,88세,2018,490,148,342,43.3,481,146,335,43.6
서울특별시,관악구,89세,2018,376,100,276,36.2,373,99,274,36.1
서울특별시,관악구,90~94세,2018,921,210,711,29.5,907,208,699,29.8
서울특별시,관악구,90세,2018,301,78,223,35,296,76,220,34.5
서울특별시,관악구,91세,2018,245,62,183,33.9,242,62,180,34.4
서울특별시,관악구,92세,2018,178,27,151,17.9,176,27,149,18.1
서울특별시,관악구,93세,2018,110,23,87,26.4,109,23,86,26.7
서울특별시,관악구,94세,2018,87,20,67,29.9,84,20,64,31.3
서울특별시,관악구,95~99세,2018,225,53,172,30.8,225,53,172,30.8
서울특별시,관악구,95세,2018,102,22,80,27.5,102,22,80,27.5
서울특별시,관악구,96세,2018,52,15,37,40.5,52,15,37,40.5
서울특별시,관악구,97세,2018,38,9,29,31,38,9,29,31
서울특별시,관악구,98세,2018,25,6,19,31.6,25,6,19,31.6
서울특별시,관악구,99세,2018,8,X,7,14.3,8,X,7,14.3
서울특별시,관악구,100세이상,2018,38,5,33,15.2,38,5,33,15.2
서울특별시,관악구,15세미만,2018,40730,20955,19775,106,39711,20460,19251,106.3
서울특별시,관악구,15~64세,2018,399299,203286,196013,103.7,376464,192535,183929,104.7
서울특별시,관악구,65세이상,2018,70274,31446,38828,81,68710,30820,37890,81.3
서울특별시,관악구,평균연령,2018,41.5,40.7,42.3,,41.5,40.6,42.3,
서울특별시,관악구,중위연령,2018,39.2,38.3,40.3,,39,38.1,40.2,
서울특별시,서초구,합계,2018,409491,196064,213427,91.9,402348,192460,209888,91.7
서울특별시,서초구,0~4세,2018,15481,7943,7538,105.4,15186,7787,7399,105.2
서울특별시,서초구,0세,2018,2749,1467,1282,114.4,2705,1440,1265,113.8
서울특별시,서초구,1세,2018,2814,1413,1401,100.9,2730,1373,1357,101.2
서울특별시,서초구,2세,2018,3103,1556,1547,100.6,3045,1525,1520,100.3
서울특별시,서초구,3세,2018,3321,1685,1636,103,3270,1655,1615,102.5
서울특별시,서초구,4세,2018,3494,1822,1672,109,3436,1794,1642,109.3
서울특별시,서초구,5~9세,2018,20054,10370,9684,107.1,19832,10252,9580,107
서울특별시,서초구,5세,2018,3724,1935,1789,108.2,3685,1920,1765,108.8
서울특별시,서초구,6세,2018,4083,2126,1957,108.6,4026,2090,1936,108
서울특별시,서초구,7세,2018,4236,2216,2020,109.7,4188,2190,1998,109.6
서울특별시,서초구,8세,2018,4042,2069,1973,104.9,4012,2051,1961,104.6
서울특별시,서초구,9세,2018,3969,2024,1945,104.1,3921,2001,1920,104.2
서울특별시,서초구,10~14세,2018,20960,10674,10286,103.8,20787,10586,10201,103.8
서울특별시,서초구,10세,2018,4200,2132,2068,103.1,4154,2110,2044,103.2
서울특별시,서초구,11세,2018,4305,2143,2162,99.1,4260,2120,2140,99.1
서울특별시,서초구,12세,2018,4001,2053,1948,105.4,3967,2039,1928,105.8
서울특별시,서초구,13세,2018,3948,2061,1887,109.2,3927,2048,1879,109
서울특별시,서초구,14세,2018,4506,2285,2221,102.9,4479,2269,2210,102.7
서울특별시,서초구,15~19세,2018,21730,10894,10836,100.5,21558,10796,10762,100.3
서울특별시,서초구,15세,2018,4167,2121,2046,103.7,4148,2112,2036,103.7
서울특별시,서초구,16세,2018,4048,2052,1996,102.8,4019,2034,1985,102.5
서울특별시,서초구,17세,2018,4355,2209,2146,102.9,4336,2203,2133,103.3
서울특별시,서초구,18세,2018,4691,2345,2346,100,4663,2333,2330,100.1
서울특별시,서초구,19세,2018,4469,2167,2302,94.1,4392,2114,2278,92.8
서울특별시,서초구,20~24세,2018,23991,11721,12270,95.5,23443,11414,12029,94.9
서울특별시,서초구,20세,2018,4682,2342,2340,100.1,4587,2280,2307,98.8
서울특별시,서초구,21세,2018,4630,2327,2303,101,4558,2289,2269,100.9
서울특별시,서초구,22세,2018,4771,2342,2429,96.4,4656,2283,2373,96.2
서울특별시,서초구,23세,2018,4774,2274,2500,91,4657,2203,2454,89.8
서울특별시,서초구,24세,2018,5134,2436,2698,90.3,4985,2359,2626,89.8
서울특별시,서초구,25~29세,2018,29094,13581,15513,87.5,28205,13107,15098,86.8
서울특별시,서초구,25세,2018,5481,2527,2954,85.5,5308,2433,2875,84.6
서울특별시,서초구,26세,2018,5854,2752,3102,88.7,5695,2655,3040,87.3
서울특별시,서초구,27세,2018,5939,2754,3185,86.5,5773,2671,3102,86.1
서울특별시,서초구,28세,2018,5834,2793,3041,91.8,5651,2685,2966,90.5
서울특별시,서초구,29세,2018,5986,2755,3231,85.3,5778,2663,3115,85.5
서울특별시,서초구,30~34세,2018,29766,13844,15922,86.9,28803,13306,15497,85.9
서울특별시,서초구,30세,2018,5864,2730,3134,87.1,5654,2626,3028,86.7
서울특별시,서초구,31세,2018,5941,2709,3232,83.8,5744,2590,3154,82.1
서울특별시,서초구,32세,2018,5898,2772,3126,88.7,5701,2663,3038,87.7
서울특별시,서초구,33세,2018,5906,2753,3153,87.3,5722,2645,3077,86
서울특별시,서초구,34세,2018,6157,2880,3277,87.9,5982,2782,3200,86.9
서울특별시,서초구,35~39세,2018,35650,16564,19086,86.8,34759,16065,18694,85.9
서울특별시,서초구,35세,2018,6743,3146,3597,87.5,6551,3035,3516,86.3
서울특별시,서초구,36세,2018,7147,3361,3786,88.8,6962,3258,3704,88
서울특별시,서초구,37세,2018,7218,3297,3921,84.1,7014,3190,3824,83.4
서울특별시,서초구,38세,2018,7387,3410,3977,85.7,7244,3330,3914,85.1
서울특별시,서초구,39세,2018,7155,3350,3805,88,6988,3252,3736,87
서울특별시,서초구,40~44세,2018,35293,16413,18880,86.9,34614,16062,18552,86.6
서울특별시,서초구,40세,2018,6510,3010,3500,86,6367,2945,3422,86.1
서울특별시,서초구,41세,2018,7045,3249,3796,85.6,6900,3165,3735,84.7
서울특별시,서초구,42세,2018,6933,3101,3832,80.9,6800,3038,3762,80.8
서울특별시,서초구,43세,2018,7054,3415,3639,93.8,6927,3350,3577,93.7
서울특별시,서초구,44세,2018,7751,3638,4113,88.5,7620,3564,4056,87.9
서울특별시,서초구,45~49세,2018,39893,19511,20382,95.7,39259,19196,20063,95.7
서울특별시,서초구,45세,2018,7937,3797,4140,91.7,7808,3723,4085,91.1
서울특별시,서초구,46세,2018,8044,3902,4142,94.2,7913,3835,4078,94
서울특별시,서초구,47세,2018,8265,4016,4249,94.5,8131,3948,4183,94.4
서울특별시,서초구,48세,2018,8010,3960,4050,97.8,7868,3892,3976,97.9
서울특별시,서초구,49세,2018,7637,3836,3801,100.9,7539,3798,3741,101.5
서울특별시,서초구,50~54세,2018,31132,15254,15878,96.1,30628,15060,15568,96.7
서울특별시,서초구,50세,2018,7093,3473,3620,95.9,6996,3437,3559,96.6
서울특별시,서초구,51세,2018,6411,3122,3289,94.9,6300,3074,3226,95.3
서울특별시,서초구,52세,2018,5664,2831,2833,99.9,5564,2792,2772,100.7
서울특별시,서초구,53세,2018,6107,2994,3113,96.2,6005,2954,3051,96.8
서울특별시,서초구,54세,2018,5857,2834,3023,93.7,5763,2803,2960,94.7
서울특별시,서초구,55~59세,2018,28972,13744,15228,90.3,28508,13549,14959,90.6
서울특별시,서초구,55세,2018,5866,2839,3027,93.8,5759,2795,2964,94.3
서울특별시,서초구,56세,2018,5628,2708,2920,92.7,5526,2662,2864,92.9
서울특별시,서초구,57세,2018,5895,2792,3103,90,5810,2756,3054,90.2
서울특별시,서초구,58세,2018,5951,2826,3125,90.4,5859,2790,3069,90.9
서울특별시,서초구,59세,2018,5632,2579,3053,84.5,5554,2546,3008,84.6
서울특별시,서초구,60~64세,2018,25746,11952,13794,86.6,25357,11797,13560,87
서울특별시,서초구,60세,2018,5545,2659,2886,92.1,5458,2630,2828,93
서울특별시,서초구,61세,2018,5453,2492,2961,84.2,5363,2458,2905,84.6
서울특별시,서초구,62세,2018,5004,2347,2657,88.3,4927,2314,2613,88.6
서울특별시,서초구,63세,2018,5331,2396,2935,81.6,5261,2365,2896,81.7
서울특별시,서초구,64세,2018,4413,2058,2355,87.4,4348,2030,2318,87.6
서울특별시,서초구,65~69세,2018,18376,8429,9947,84.7,18215,8365,9850,84.9
서울특별시,서초구,65세,2018,4189,1877,2312,81.2,4149,1864,2285,81.6
서울특별시,서초구,66세,2018,4211,1934,2277,84.9,4171,1921,2250,85.4
서울특별시,서초구,67세,2018,3036,1446,1590,90.9,3005,1431,1574,90.9
서울특별시,서초구,68세,2018,3434,1582,1852,85.4,3401,1569,1832,85.6
서울특별시,서초구,69세,2018,3506,1590,1916,83,3489,1580,1909,82.8
서울특별시,서초구,70~74세,2018,14447,6857,7590,90.3,14366,6830,7536,90.6
서울특별시,서초구,70세,2018,3489,1646,1843,89.3,3464,1639,1825,89.8
서울특별시,서초구,71세,2018,3322,1539,1783,86.3,3306,1534,1772,86.6
서울특별시,서초구,72세,2018,2819,1334,1485,89.8,2805,1329,1476,90
서울특별시,서초구,73세,2018,2480,1183,1297,91.2,2468,1180,1288,91.6
서울특별시,서초구,74세,2018,2337,1155,1182,97.7,2323,1148,1175,97.7
서울특별시,서초구,75~79세,2018,9669,4788,4881,98.1,9635,4777,4858,98.3
서울특별시,서초구,75세,2018,2284,1131,1153,98.1,2279,1130,1149,98.3
서울특별시,서초구,76세,2018,2318,1189,1129,105.3,2311,1186,1125,105.4
서울특별시,서초구,77세,2018,1914,944,970,97.3,1903,942,961,98
서울특별시,서초구,78세,2018,1665,807,858,94.1,1658,803,855,93.9
서울특별시,서초구,79세,2018,1488,717,771,93,1484,716,768,93.2
서울특별시,서초구,80~84세,2018,5438,2345,3093,75.8,5413,2338,3075,76
서울특별시,서초구,80세,2018,1348,635,713,89.1,1340,634,706,89.8
서울특별시,서초구,81세,2018,1260,532,728,73.1,1252,528,724,72.9
서울특별시,서초구,82세,2018,1028,461,567,81.3,1026,461,565,81.6
서울특별시,서초구,83세,2018,1018,425,593,71.7,1013,423,590,71.7
서울특별시,서초구,84세,2018,784,292,492,59.3,782,292,490,59.6
서울특별시,서초구,85세이상,2018,3799,1180,2619,45.1,3780,1173,2607,45
서울특별시,서초구,85~89세,2018,2490,861,1629,52.9,2481,859,1622,53
서울특별시,서초구,85세,2018,641,236,405,58.3,639,235,404,58.2
서울특별시,서초구,86세,2018,621,242,379,63.9,619,241,378,63.8
서울특별시,서초구,87세,2018,428,148,280,52.9,428,148,280,52.9
서울특별시,서초구,88세,2018,416,118,298,39.6,414,118,296,39.9
서울특별시,서초구,89세,2018,384,117,267,43.8,381,117,264,44.3
서울특별시,서초구,90~94세,2018,1027,252,775,32.5,1021,249,772,32.3
서울특별시,서초구,90세,2018,350,78,272,28.7,348,77,271,28.4
서울특별시,서초구,91세,2018,249,61,188,32.4,248,60,188,31.9
서울특별시,서초구,92세,2018,164,51,113,45.1,164,51,113,45.1
서울특별시,서초구,93세,2018,152,36,116,31,151,35,116,30.2
서울특별시,서초구,94세,2018,112,26,86,30.2,110,26,84,31
서울특별시,서초구,95~99세,2018,253,59,194,30.4,249,57,192,29.7
서울특별시,서초구,95세,2018,106,31,75,41.3,105,31,74,41.9
서울특별시,서초구,96세,2018,67,11,56,19.6,67,11,56,19.6
서울특별시,서초구,97세,2018,34,5,29,17.2,34,5,29,17.2
서울특별시,서초구,98세,2018,26,9,17,52.9,24,8,16,50
서울특별시,서초구,99세,2018,20,X,17,17.6,19,X,17,11.8
서울특별시,서초구,100세이상,2018,29,8,21,38.1,29,8,21,38.1
서울특별시,서초구,15세미만,2018,56495,28987,27508,105.4,55805,28625,27180,105.3
서울특별시,서초구,15~64세,2018,301267,143478,157789,90.9,295134,140352,154782,90.7
서울특별시,서초구,65세이상,2018,51729,23599,28130,83.9,51409,23483,27926,84.1
서울특별시,서초구,평균연령,2018,40.5,39.9,41.1,,40.6,40,41.1,
서울특별시,서초구,중위연령,2018,41.2,40.8,41.5,,41.3,41,41.6,
서울특별시,강남구,합계,2018,507810,243579,264231,92.2,498996,238956,260040,91.9
서울특별시,강남구,0~4세,2018,15849,8125,7724,105.2,15638,8008,7630,105
서울특별시,강남구,0세,2018,2796,1508,1288,117.1,2761,1485,1276,116.4
서울특별시,강남구,1세,2018,2905,1472,1433,102.7,2856,1441,1415,101.8
서울특별시,강남구,2세,2018,3215,1579,1636,96.5,3164,1552,1612,96.3
서울특별시,강남구,3세,2018,3353,1697,1656,102.5,3316,1682,1634,102.9
서울특별시,강남구,4세,2018,3580,1869,1711,109.2,3541,1848,1693,109.2
서울특별시,강남구,5~9세,2018,20727,10732,9995,107.4,20589,10650,9939,107.2
서울특별시,강남구,5세,2018,3843,1963,1880,104.4,3814,1943,1871,103.8
서울특별시,강남구,6세,2018,4153,2155,1998,107.9,4119,2138,1981,107.9
서울특별시,강남구,7세,2018,4334,2275,2059,110.5,4307,2257,2050,110.1
서울특별시,강남구,8세,2018,4180,2155,2025,106.4,4157,2140,2017,106.1
서울특별시,강남구,9세,2018,4217,2184,2033,107.4,4192,2172,2020,107.5
서울특별시,강남구,10~14세,2018,25240,13218,12022,109.9,25142,13168,11974,110
서울특별시,강남구,10세,2018,4793,2512,2281,110.1,4769,2499,2270,110.1
서울특별시,강남구,11세,2018,5013,2547,2466,103.3,4992,2540,2452,103.6
서울특별시,강남구,12세,2018,4914,2596,2318,112,4895,2588,2307,112.2
서울특별시,강남구,13세,2018,5032,2649,2383,111.2,5020,2640,2380,110.9
서울특별시,강남구,14세,2018,5488,2914,2574,113.2,5466,2901,2565,113.1
서울특별시,강남구,15~19세,2018,29662,15460,14202,108.9,29446,15329,14117,108.6
서울특별시,강남구,15세,2018,5551,2897,2654,109.2,5531,2887,2644,109.2
서울특별시,강남구,16세,2018,5411,2829,2582,109.6,5379,2812,2567,109.5
서울특별시,강남구,17세,2018,6258,3218,3040,105.9,6233,3205,3028,105.8
서울특별시,강남구,18세,2018,6710,3514,3196,109.9,6683,3502,3181,110.1
서울특별시,강남구,19세,2018,5732,3002,2730,110,5620,2923,2697,108.4
서울특별시,강남구,20~24세,2018,30354,14964,15390,97.2,29540,14548,14992,97
서울특별시,강남구,20세,2018,5776,3000,2776,108.1,5648,2917,2731,106.8
서울특별시,강남구,21세,2018,5704,2878,2826,101.8,5591,2818,2773,101.6
서울특별시,강남구,22세,2018,6026,3048,2978,102.4,5856,2969,2887,102.8
서울특별시,강남구,23세,2018,6147,2944,3203,91.9,5974,2851,3123,91.3
서울특별시,강남구,24세,2018,6701,3094,3607,85.8,6471,2993,3478,86.1
서울특별시,강남구,25~29세,2018,38489,18035,20454,88.2,37109,17315,19794,87.5
서울특별시,강남구,25세,2018,7152,3362,3790,88.7,6902,3226,3676,87.8
서울특별시,강남구,26세,2018,7837,3609,4228,85.4,7586,3476,4110,84.6
서울특별시,강남구,27세,2018,7670,3615,4055,89.1,7374,3462,3912,88.5
서울특별시,강남구,28세,2018,7789,3656,4133,88.5,7516,3520,3996,88.1
서울특별시,강남구,29세,2018,8041,3793,4248,89.3,7731,3631,4100,88.6
서울특별시,강남구,30~34세,2018,38874,18030,20844,86.5,37390,17193,20197,85.1
서울특별시,강남구,30세,2018,7744,3543,4201,84.3,7436,3381,4055,83.4
서울특별시,강남구,31세,2018,7620,3502,4118,85,7301,3342,3959,84.4
서울특별시,강남구,32세,2018,7734,3575,4159,86,7453,3405,4048,84.1
서울특별시,강남구,33세,2018,7762,3674,4088,89.9,7462,3491,3971,87.9
서울특별시,강남구,34세,2018,8014,3736,4278,87.3,7738,3574,4164,85.8
서울특별시,강남구,35~39세,2018,44043,20326,23717,85.7,42937,19706,23231,84.8
서울특별시,강남구,35세,2018,8382,3887,4495,86.5,8144,3752,4392,85.4
서울특별시,강남구,36세,2018,8917,4066,4851,83.8,8664,3933,4731,83.1
서울특별시,강남구,37세,2018,9092,4228,4864,86.9,8901,4128,4773,86.5
서울특별시,강남구,38세,2018,8829,4130,4699,87.9,8622,4006,4616,86.8
서울특별시,강남구,39세,2018,8823,4015,4808,83.5,8606,3887,4719,82.4
서울특별시,강남구,40~44세,2018,42509,19625,22884,85.8,41707,19160,22547,85
서울특별시,강남구,40세,2018,7989,3765,4224,89.1,7815,3650,4165,87.6
서울특별시,강남구,41세,2018,8319,3803,4516,84.2,8150,3711,4439,83.6
서울특별시,강남구,42세,2018,8163,3778,4385,86.2,8014,3699,4315,85.7
서울특별시,강남구,43세,2018,8696,3987,4709,84.7,8549,3904,4645,84
서울특별시,강남구,44세,2018,9342,4292,5050,85,9179,4196,4983,84.2
서울특별시,강남구,45~49세,2018,50800,24348,26452,92,50102,23965,26137,91.7
서울특별시,강남구,45세,2018,9519,4392,5127,85.7,9381,4312,5069,85.1
서울특별시,강남구,46세,2018,10080,4735,5345,88.6,9922,4652,5270,88.3
서울특별시,강남구,47세,2018,10745,5247,5498,95.4,10598,5159,5439,94.9
서울특별시,강남구,48세,2018,10373,4999,5374,93,10242,4930,5312,92.8
서울특별시,강남구,49세,2018,10083,4975,5108,97.4,9959,4912,5047,97.3
서울특별시,강남구,50~54세,2018,40644,20282,20362,99.6,40105,20034,20071,99.8
서울특별시,강남구,50세,2018,9264,4593,4671,98.3,9169,4544,4625,98.2
서울특별시,강남구,51세,2018,8401,4112,4289,95.9,8282,4055,4227,95.9
서울특별시,강남구,52세,2018,7545,3899,3646,106.9,7424,3845,3579,107.4
서울특별시,강남구,53세,2018,7993,3994,3999,99.9,7883,3945,3938,100.2
서울특별시,강남구,54세,2018,7441,3684,3757,98.1,7347,3645,3702,98.5
서울특별시,강남구,55~59세,2018,35867,17287,18580,93,35336,17069,18267,93.4
서울특별시,강남구,55세,2018,7544,3728,3816,97.7,7416,3676,3740,98.3
서울특별시,강남구,56세,2018,7032,3530,3502,100.8,6917,3472,3445,100.8
서울특별시,강남구,57세,2018,7309,3459,3850,89.8,7228,3425,3803,90.1
서울특별시,강남구,58세,2018,7288,3431,3857,89,7174,3387,3787,89.4
서울특별시,강남구,59세,2018,6694,3139,3555,88.3,6601,3109,3492,89
서울특별시,강남구,60~64세,2018,31583,14473,17110,84.6,31165,14312,16853,84.9
서울특별시,강남구,60세,2018,6618,3056,3562,85.8,6529,3027,3502,86.4
서울특별시,강남구,61세,2018,6731,3145,3586,87.7,6622,3100,3522,88
서울특별시,강남구,62세,2018,6201,2876,3325,86.5,6118,2841,3277,86.7
서울특별시,강남구,63세,2018,6488,2857,3631,78.7,6410,2822,3588,78.7
서울특별시,강남구,64세,2018,5545,2539,3006,84.5,5486,2522,2964,85.1
서울특별시,강남구,65~69세,2018,22725,10459,12266,85.3,22555,10396,12159,85.5
서울특별시,강남구,65세,2018,5127,2325,2802,83,5079,2306,2773,83.2
서울특별시,강남구,66세,2018,5326,2408,2918,82.5,5274,2388,2886,82.7
서울특별시,강남구,67세,2018,3640,1704,1936,88,3613,1695,1918,88.4
서울특별시,강남구,68세,2018,4273,1974,2299,85.9,4255,1965,2290,85.8
서울특별시,강남구,69세,2018,4359,2048,2311,88.6,4334,2042,2292,89.1
서울특별시,강남구,70~74세,2018,17687,8453,9234,91.5,17595,8402,9193,91.4
서울특별시,강남구,70세,2018,4281,2061,2220,92.8,4260,2051,2209,92.8
서울특별시,강남구,71세,2018,4150,1888,2262,83.5,4122,1873,2249,83.3
서울특별시,강남구,72세,2018,3404,1624,1780,91.2,3385,1613,1772,91
서울특별시,강남구,73세,2018,3016,1478,1538,96.1,3001,1468,1533,95.8
서울특별시,강남구,74세,2018,2836,1402,1434,97.8,2827,1397,1430,97.7
서울특별시,강남구,75~79세,2018,11615,5662,5953,95.1,11562,5633,5929,95
서울특별시,강남구,75세,2018,2687,1307,1380,94.7,2677,1304,1373,95
서울특별시,강남구,76세,2018,2808,1428,1380,103.5,2794,1419,1375,103.2
서울특별시,강남구,77세,2018,2352,1127,1225,92,2338,1120,1218,92
서울특별시,강남구,78세,2018,2014,951,1063,89.5,2008,948,1060,89.4
서울특별시,강남구,79세,2018,1754,849,905,93.8,1745,842,903,93.2
서울특별시,강남구,80~84세,2018,6458,2746,3712,74,6421,2728,3693,73.9
서울특별시,강남구,80세,2018,1634,740,894,82.8,1625,736,889,82.8
서울특별시,강남구,81세,2018,1467,658,809,81.3,1459,654,805,81.2
서울특별시,강남구,82세,2018,1233,543,690,78.7,1227,540,687,78.6
서울특별시,강남구,83세,2018,1148,446,702,63.5,1141,440,701,62.8
서울특별시,강남구,84세,2018,976,359,617,58.2,969,358,611,58.6
서울특별시,강남구,85세이상,2018,4684,1354,3330,40.7,4657,1340,3317,40.4
서울특별시,강남구,85~89세,2018,3110,970,2140,45.3,3094,962,2132,45.1
서울특별시,강남구,85세,2018,798,267,531,50.3,793,267,526,50.8
서울특별시,강남구,86세,2018,758,271,487,55.6,756,269,487,55.2
서울특별시,강남구,87세,2018,562,156,406,38.4,560,154,406,37.9
서울특별시,강남구,88세,2018,525,142,383,37.1,521,139,382,36.4
서울특별시,강남구,89세,2018,467,134,333,40.2,464,133,331,40.2
서울특별시,강남구,90~94세,2018,1227,304,923,32.9,1219,299,920,32.5
서울특별시,강남구,90세,2018,368,89,279,31.9,365,87,278,31.3
서울특별시,강남구,91세,2018,307,76,231,32.9,304,74,230,32.2
서울특별시,강남구,92세,2018,215,50,165,30.3,215,50,165,30.3
서울특별시,강남구,93세,2018,197,57,140,40.7,196,57,139,41
서울특별시,강남구,94세,2018,140,32,108,29.6,139,31,108,28.7
서울특별시,강남구,95~99세,2018,312,72,240,30,311,71,240,29.6
서울특별시,강남구,95세,2018,112,23,89,25.8,112,23,89,25.8
서울특별시,강남구,96세,2018,76,17,59,28.8,75,16,59,27.1
서울특별시,강남구,97세,2018,56,18,38,47.4,56,18,38,47.4
서울특별시,강남구,98세,2018,49,10,39,25.6,49,10,39,25.6
서울특별시,강남구,99세,2018,19,X,15,26.7,19,X,15,26.7
서울특별시,강남구,100세이상,2018,35,8,27,29.6,33,8,25,32
서울특별시,강남구,15세미만,2018,61816,32075,29741,107.8,61369,31826,29543,107.7
서울특별시,강남구,15~64세,2018,382825,182830,199995,91.4,374837,178631,196206,91
서울특별시,강남구,65세이상,2018,63169,28674,34495,83.1,62790,28499,34291,83.1
서울특별시,강남구,평균연령,2018,40.8,40.1,41.5,,40.9,40.2,41.5,
서울특별시,강남구,중위연령,2018,41.3,40.8,41.8,,41.5,41,41.9,
서울특별시,송파구,합계,2018,638167,309442,328725,94.1,628044,304505,323539,94.1
서울특별시,송파구,0~4세,2018,25091,13060,12031,108.6,24852,12936,11916,108.6
서울특별시,송파구,0세,2018,4532,2371,2161,109.7,4496,2349,2147,109.4
서울특별시,송파구,1세,2018,4780,2479,2301,107.7,4732,2456,2276,107.9
서울특별시,송파구,2세,2018,5382,2826,2556,110.6,5315,2786,2529,110.2
서울특별시,송파구,3세,2018,5310,2761,2549,108.3,5262,2737,2525,108.4
서울특별시,송파구,4세,2018,5087,2623,2464,106.5,5047,2608,2439,106.9
서울특별시,송파구,5~9세,2018,26769,13731,13038,105.3,26618,13656,12962,105.4
서울특별시,송파구,5세,2018,5118,2622,2496,105,5079,2602,2477,105
서울특별시,송파구,6세,2018,5630,2851,2779,102.6,5600,2839,2761,102.8
서울특별시,송파구,7세,2018,5439,2854,2585,110.4,5404,2834,2570,110.3
서울특별시,송파구,8세,2018,5428,2781,2647,105.1,5402,2767,2635,105
서울특별시,송파구,9세,2018,5154,2623,2531,103.6,5133,2614,2519,103.8
서울특별시,송파구,10~14세,2018,27312,14072,13240,106.3,27227,14030,13197,106.3
서울특별시,송파구,10세,2018,5430,2814,2616,107.6,5409,2809,2600,108
서울특별시,송파구,11세,2018,5608,2901,2707,107.2,5588,2891,2697,107.2
서울특별시,송파구,12세,2018,5313,2696,2617,103,5297,2684,2613,102.7
서울특별시,송파구,13세,2018,5268,2731,2537,107.6,5254,2723,2531,107.6
서울특별시,송파구,14세,2018,5693,2930,2763,106,5679,2923,2756,106.1
서울특별시,송파구,15~19세,2018,31890,16411,15479,106,31719,16307,15412,105.8
서울특별시,송파구,15세,2018,5698,2949,2749,107.3,5687,2943,2744,107.3
서울특별시,송파구,16세,2018,5787,2996,2791,107.3,5771,2989,2782,107.4
서울특별시,송파구,17세,2018,6608,3401,3207,106,6592,3391,3201,105.9
서울특별시,송파구,18세,2018,7186,3667,3519,104.2,7162,3652,3510,104
서울특별시,송파구,19세,2018,6611,3398,3213,105.8,6507,3332,3175,104.9
서울특별시,송파구,20~24세,2018,38997,19433,19564,99.3,38431,19157,19274,99.4
서울특별시,송파구,20세,2018,6855,3561,3294,108.1,6754,3515,3239,108.5
서울특별시,송파구,21세,2018,7384,3894,3490,111.6,7304,3846,3458,111.2
서울특별시,송파구,22세,2018,7680,3861,3819,101.1,7587,3815,3772,101.1
서울특별시,송파구,23세,2018,8202,3910,4292,91.1,8075,3851,4224,91.2
서울특별시,송파구,24세,2018,8876,4207,4669,90.1,8711,4130,4581,90.2
서울특별시,송파구,25~29세,2018,49515,23337,26178,89.1,48442,22822,25620,89.1
서울특별시,송파구,25세,2018,9385,4371,5014,87.2,9230,4306,4924,87.4
서울특별시,송파구,26세,2018,10075,4666,5409,86.3,9876,4565,5311,86
서울특별시,송파구,27세,2018,9919,4704,5215,90.2,9704,4586,5118,89.6
서울특별시,송파구,28세,2018,10011,4761,5250,90.7,9765,4652,5113,91
서울특별시,송파구,29세,2018,10125,4835,5290,91.4,9867,4713,5154,91.4
서울특별시,송파구,30~34세,2018,51955,24959,26996,92.5,50560,24266,26294,92.3
서울특별시,송파구,30세,2018,10104,4839,5265,91.9,9826,4701,5125,91.7
서울특별시,송파구,31세,2018,10326,4903,5423,90.4,10026,4750,5276,90
서울특별시,송파구,32세,2018,10494,5030,5464,92.1,10216,4892,5324,91.9
서울특별시,송파구,33세,2018,10456,5010,5446,92,10175,4870,5305,91.8
서울특별시,송파구,34세,2018,10575,5177,5398,95.9,10317,5053,5264,96
서울특별시,송파구,35~39세,2018,57567,27811,29756,93.5,56526,27247,29279,93.1
서울특별시,송파구,35세,2018,11503,5537,5966,92.8,11262,5406,5856,92.3
서울특별시,송파구,36세,2018,11918,5845,6073,96.2,11686,5721,5965,95.9
서울특별시,송파구,37세,2018,11664,5722,5942,96.3,11463,5610,5853,95.8
서울특별시,송파구,38세,2018,11556,5521,6035,91.5,11380,5427,5953,91.2
서울특별시,송파구,39세,2018,10926,5186,5740,90.3,10735,5083,5652,89.9
서울특별시,송파구,40~44세,2018,49710,24289,25421,95.5,48902,23869,25033,95.4
서울특별시,송파구,40세,2018,9566,4659,4907,94.9,9406,4571,4835,94.5
서울특별시,송파구,41세,2018,9855,4754,5101,93.2,9706,4676,5030,93
서울특별시,송파구,42세,2018,9652,4802,4850,99,9502,4723,4779,98.8
서울특별시,송파구,43세,2018,10016,4898,5118,95.7,9845,4815,5030,95.7
서울특별시,송파구,44세,2018,10621,5176,5445,95.1,10443,5084,5359,94.9
서울특별시,송파구,45~49세,2018,55709,26931,28778,93.6,54698,26407,28291,93.3
서울특별시,송파구,45세,2018,10662,5042,5620,89.7,10501,4952,5549,89.2
서울특별시,송파구,46세,2018,11078,5387,5691,94.7,10866,5266,5600,94
서울특별시,송파구,47세,2018,11747,5615,6132,91.6,11550,5516,6034,91.4
서울특별시,송파구,48세,2018,10979,5420,5559,97.5,10762,5311,5451,97.4
서울특별시,송파구,49세,2018,11243,5467,5776,94.7,11019,5362,5657,94.8
서울특별시,송파구,50~54세,2018,49760,24004,25756,93.2,48656,23505,25151,93.5
서울특별시,송파구,50세,2018,10815,5107,5708,89.5,10565,5004,5561,90
서울특별시,송파구,51세,2018,9864,4755,5109,93.1,9682,4669,5013,93.1
서울특별시,송파구,52세,2018,9562,4739,4823,98.3,9355,4647,4708,98.7
서울특별시,송파구,53세,2018,9959,4796,5163,92.9,9736,4689,5047,92.9
서울특별시,송파구,54세,2018,9560,4607,4953,93,9318,4496,4822,93.2
서울특별시,송파구,55~59세,2018,51488,24336,27152,89.6,50509,23913,26596,89.9
서울특별시,송파구,55세,2018,10089,4845,5244,92.4,9833,4725,5108,92.5
서울특별시,송파구,56세,2018,9917,4773,5144,92.8,9716,4684,5032,93.1
서울특별시,송파구,57세,2018,10630,4947,5683,87,10481,4887,5594,87.4
서울특별시,송파구,58세,2018,10897,5008,5889,85,10687,4920,5767,85.3
서울특별시,송파구,59세,2018,9955,4763,5192,91.7,9792,4697,5095,92.2
서울특별시,송파구,60~64세,2018,44615,21009,23606,89,43770,20607,23163,89
서울특별시,송파구,60세,2018,9635,4588,5047,90.9,9450,4498,4952,90.8
서울특별시,송파구,61세,2018,9525,4431,5094,87,9331,4333,4998,86.7
서울특별시,송파구,62세,2018,8617,4062,4555,89.2,8455,3990,4465,89.4
서울특별시,송파구,63세,2018,9292,4366,4926,88.6,9111,4282,4829,88.7
서울특별시,송파구,64세,2018,7546,3562,3984,89.4,7423,3504,3919,89.4
서울특별시,송파구,65~69세,2018,29867,14658,15209,96.4,29476,14475,15001,96.5
서울특별시,송파구,65세,2018,6868,3299,3569,92.4,6769,3248,3521,92.2
서울특별시,송파구,66세,2018,7225,3570,3655,97.7,7139,3524,3615,97.5
서울특별시,송파구,67세,2018,4980,2454,2526,97.1,4898,2421,2477,97.7
서울특별시,송파구,68세,2018,5437,2704,2733,98.9,5370,2670,2700,98.9
서울특별시,송파구,69세,2018,5357,2631,2726,96.5,5300,2612,2688,97.2
서울특별시,송파구,70~74세,2018,20791,10281,10510,97.8,20655,10226,10429,98.1
서울특별시,송파구,70세,2018,4991,2481,2510,98.8,4958,2470,2488,99.3
서울특별시,송파구,71세,2018,5143,2549,2594,98.3,5109,2534,2575,98.4
서울특별시,송파구,72세,2018,3815,1872,1943,96.3,3783,1859,1924,96.6
서울특별시,송파구,73세,2018,3505,1729,1776,97.4,3479,1717,1762,97.4
서울특별시,송파구,74세,2018,3337,1650,1687,97.8,3326,1646,1680,98
서울특별시,송파구,75~79세,2018,13771,6492,7279,89.2,13708,6472,7236,89.4
서울특별시,송파구,75세,2018,3169,1556,1613,96.5,3158,1551,1607,96.5
서울특별시,송파구,76세,2018,3451,1661,1790,92.8,3434,1656,1778,93.1
서울특별시,송파구,77세,2018,2653,1227,1426,86,2639,1223,1416,86.4
서울특별시,송파구,78세,2018,2333,1074,1259,85.3,2317,1069,1248,85.7
서울특별시,송파구,79세,2018,2165,974,1191,81.8,2160,973,1187,82
서울특별시,송파구,80~84세,2018,7743,3096,4647,66.6,7700,3085,4615,66.8
서울특별시,송파구,80세,2018,1874,810,1064,76.1,1863,808,1055,76.6
서울특별시,송파구,81세,2018,1757,737,1020,72.3,1748,735,1013,72.6
서울특별시,송파구,82세,2018,1533,589,944,62.4,1519,584,935,62.5
서울특별시,송파구,83세,2018,1420,538,882,61,1417,536,881,60.8
서울특별시,송파구,84세,2018,1159,422,737,57.3,1153,422,731,57.7
서울특별시,송파구,85세이상,2018,5617,1532,4085,37.5,5595,1525,4070,37.5
서울특별시,송파구,85~89세,2018,3847,1112,2735,40.7,3830,1106,2724,40.6
서울특별시,송파구,85세,2018,1060,318,742,42.9,1053,316,737,42.9
서울특별시,송파구,86세,2018,925,284,641,44.3,923,284,639,44.4
서울특별시,송파구,87세,2018,691,206,485,42.5,688,204,484,42.1
서울특별시,송파구,88세,2018,612,163,449,36.3,610,163,447,36.5
서울특별시,송파구,89세,2018,559,141,418,33.7,556,139,417,33.3
서울특별시,송파구,90~94세,2018,1405,336,1069,31.4,1401,335,1066,31.4
서울특별시,송파구,90세,2018,452,126,326,38.7,452,126,326,38.7
서울특별시,송파구,91세,2018,372,85,287,29.6,369,84,285,29.5
서울특별시,송파구,92세,2018,250,50,200,25,250,50,200,25
서울특별시,송파구,93세,2018,193,39,154,25.3,192,39,153,25.5
서울특별시,송파구,94세,2018,138,36,102,35.3,138,36,102,35.3
서울특별시,송파구,95~99세,2018,329,79,250,31.6,328,79,249,31.7
서울특별시,송파구,95세,2018,133,30,103,29.1,133,30,103,29.1
서울특별시,송파구,96세,2018,75,16,59,27.1,75,16,59,27.1
서울특별시,송파구,97세,2018,57,15,42,35.7,57,15,42,35.7
서울특별시,송파구,98세,2018,39,9,30,30,38,9,29,31
서울특별시,송파구,99세,2018,25,9,16,56.3,25,9,16,56.3
서울특별시,송파구,100세이상,2018,36,5,31,16.1,36,5,31,16.1
서울특별시,송파구,15세미만,2018,79172,40863,38309,106.7,78697,40622,38075,106.7
서울특별시,송파구,15~64세,2018,481206,232520,248686,93.5,472213,228100,244113,93.4
서울특별시,송파구,65세이상,2018,77789,36059,41730,86.4,77134,35783,41351,86.5
서울특별시,송파구,평균연령,2018,40.9,40.2,41.5,,40.9,40.2,41.5,
서울특별시,송파구,중위연령,2018,41,40.4,41.6,,41,40.4,41.6,
서울특별시,강동구,합계,2018,414231,204752,209479,97.7,407847,201718,206129,97.9
서울특별시,강동구,0~4세,2018,14963,7684,7279,105.6,14837,7625,7212,105.7
서울특별시,강동구,0세,2018,2614,1337,1277,104.7,2595,1330,1265,105.1
서울특별시,강동구,1세,2018,2774,1417,1357,104.4,2746,1405,1341,104.8
서울특별시,강동구,2세,2018,3100,1608,1492,107.8,3072,1595,1477,108
서울특별시,강동구,3세,2018,3189,1637,1552,105.5,3163,1620,1543,105
서울특별시,강동구,4세,2018,3286,1685,1601,105.2,3261,1675,1586,105.6
서울특별시,강동구,5~9세,2018,16280,8467,7813,108.4,16210,8432,7778,108.4
서울특별시,강동구,5세,2018,3018,1541,1477,104.3,3004,1532,1472,104.1
서울특별시,강동구,6세,2018,3441,1803,1638,110.1,3426,1798,1628,110.4
서울특별시,강동구,7세,2018,3306,1742,1564,111.4,3294,1735,1559,111.3
서울특별시,강동구,8세,2018,3365,1778,1587,112,3345,1769,1576,112.2
서울특별시,강동구,9세,2018,3150,1603,1547,103.6,3141,1598,1543,103.6
서울특별시,강동구,10~14세,2018,16906,8995,7911,113.7,16860,8974,7886,113.8
서울특별시,강동구,10세,2018,3480,1874,1606,116.7,3469,1869,1600,116.8
서울특별시,강동구,11세,2018,3490,1880,1610,116.8,3478,1875,1603,117
서울특별시,강동구,12세,2018,3238,1708,1530,111.6,3234,1705,1529,111.5
서울특별시,강동구,13세,2018,3109,1659,1450,114.4,3098,1655,1443,114.7
서울특별시,강동구,14세,2018,3589,1874,1715,109.3,3581,1870,1711,109.3
서울특별시,강동구,15~19세,2018,20252,10726,9526,112.6,20176,10690,9486,112.7
서울특별시,강동구,15세,2018,3639,1915,1724,111.1,3632,1912,1720,111.2
서울특별시,강동구,16세,2018,3738,2014,1724,116.8,3725,2012,1713,117.5
서울특별시,강동구,17세,2018,4248,2283,1965,116.2,4237,2278,1959,116.3
서울특별시,강동구,18세,2018,4591,2400,2191,109.5,4577,2395,2182,109.8
서울특별시,강동구,19세,2018,4036,2114,1922,110,4005,2093,1912,109.5
서울특별시,강동구,20~24세,2018,24746,12736,12010,106,24430,12582,11848,106.2
서울특별시,강동구,20세,2018,4380,2276,2104,108.2,4339,2258,2081,108.5
서울특별시,강동구,21세,2018,4707,2547,2160,117.9,4656,2524,2132,118.4
서울특별시,강동구,22세,2018,4965,2573,2392,107.6,4907,2542,2365,107.5
서울특별시,강동구,23세,2018,5325,2723,2602,104.7,5228,2675,2553,104.8
서울특별시,강동구,24세,2018,5369,2617,2752,95.1,5300,2583,2717,95.1
서울특별시,강동구,25~29세,2018,30099,15094,15005,100.6,29469,14790,14679,100.8
서울특별시,강동구,25세,2018,5940,2943,2997,98.2,5831,2885,2946,97.9
서울특별시,강동구,26세,2018,6284,3151,3133,100.6,6167,3091,3076,100.5
서울특별시,강동구,27세,2018,6072,3038,3034,100.1,5945,2973,2972,100
서울특별시,강동구,28세,2018,5977,3042,2935,103.6,5842,2984,2858,104.4
서울특별시,강동구,29세,2018,5826,2920,2906,100.5,5684,2857,2827,101.1
서울특별시,강동구,30~34세,2018,30130,15144,14986,101.1,29365,14752,14613,101
서울특별시,강동구,30세,2018,5949,3008,2941,102.3,5798,2931,2867,102.2
서울특별시,강동구,31세,2018,5831,2881,2950,97.7,5674,2800,2874,97.4
서울특별시,강동구,32세,2018,5889,2929,2960,99,5720,2838,2882,98.5
서울특별시,강동구,33세,2018,6062,3059,3003,101.9,5922,2987,2935,101.8
서울특별시,강동구,34세,2018,6399,3267,3132,104.3,6251,3196,3055,104.6
서울특별시,강동구,35~39세,2018,35417,17863,17554,101.8,34789,17561,17228,101.9
서울특별시,강동구,35세,2018,6673,3359,3314,101.4,6555,3304,3251,101.6
서울특별시,강동구,36세,2018,7242,3634,3608,100.7,7097,3569,3528,101.2
서울특별시,강동구,37세,2018,7305,3708,3597,103.1,7195,3656,3539,103.3
서울특별시,강동구,38세,2018,7229,3691,3538,104.3,7102,3624,3478,104.2
서울특별시,강동구,39세,2018,6968,3471,3497,99.3,6840,3408,3432,99.3
서울특별시,강동구,40~44세,2018,31287,15758,15529,101.5,30772,15490,15282,101.4
서울특별시,강동구,40세,2018,6196,3122,3074,101.6,6081,3054,3027,100.9
서울특별시,강동구,41세,2018,6228,3112,3116,99.9,6119,3055,3064,99.7
서울특별시,강동구,42세,2018,6048,3124,2924,106.8,5941,3072,2869,107.1
서울특별시,강동구,43세,2018,6167,3054,3113,98.1,6083,3015,3068,98.3
서울특별시,강동구,44세,2018,6648,3346,3302,101.3,6548,3294,3254,101.2
서울특별시,강동구,45~49세,2018,35355,17480,17875,97.8,34663,17141,17522,97.8
서울특별시,강동구,45세,2018,6878,3370,3508,96.1,6759,3311,3448,96
서울특별시,강동구,46세,2018,7030,3527,3503,100.7,6903,3460,3443,100.5
서울특별시,강동구,47세,2018,7281,3670,3611,101.6,7122,3599,3523,102.2
서울특별시,강동구,48세,2018,7065,3445,3620,95.2,6919,3375,3544,95.2
서울특별시,강동구,49세,2018,7101,3468,3633,95.5,6960,3396,3564,95.3
서울특별시,강동구,50~54세,2018,33184,16077,17107,94,32526,15787,16739,94.3
서울특별시,강동구,50세,2018,7210,3532,3678,96,7080,3472,3608,96.2
서울특별시,강동구,51세,2018,6483,3077,3406,90.3,6374,3037,3337,91
서울특별시,강동구,52세,2018,6352,3197,3155,101.3,6220,3145,3075,102.3
서울특별시,강동구,53세,2018,6556,3114,3442,90.5,6421,3057,3364,90.9
서울특별시,강동구,54세,2018,6583,3157,3426,92.1,6431,3076,3355,91.7
서울특별시,강동구,55~59세,2018,36716,17470,19246,90.8,35964,17137,18827,91
서울특별시,강동구,55세,2018,6812,3313,3499,94.7,6620,3231,3389,95.3
서울특별시,강동구,56세,2018,7222,3532,3690,95.7,7058,3461,3597,96.2
서울특별시,강동구,57세,2018,7666,3591,4075,88.1,7557,3549,4008,88.5
서울특별시,강동구,58세,2018,7845,3654,4191,87.2,7686,3572,4114,86.8
서울특별시,강동구,59세,2018,7171,3380,3791,89.2,7043,3324,3719,89.4
서울특별시,강동구,60~64세,2018,31925,15139,16786,90.2,31265,14824,16441,90.2
서울특별시,강동구,60세,2018,6819,3275,3544,92.4,6662,3206,3456,92.8
서울특별시,강동구,61세,2018,6817,3261,3556,91.7,6675,3185,3490,91.3
서울특별시,강동구,62세,2018,6291,2947,3344,88.1,6153,2883,3270,88.2
서울특별시,강동구,63세,2018,6492,3033,3459,87.7,6367,2976,3391,87.8
서울특별시,강동구,64세,2018,5506,2623,2883,91,5408,2574,2834,90.8
서울특별시,강동구,65~69세,2018,21413,10431,10982,95,21133,10298,10835,95
서울특별시,강동구,65세,2018,4824,2340,2484,94.2,4735,2295,2440,94.1
서울특별시,강동구,66세,2018,5171,2488,2683,92.7,5106,2461,2645,93
서울특별시,강동구,67세,2018,3530,1736,1794,96.8,3474,1705,1769,96.4
서울특별시,강동구,68세,2018,3896,1918,1978,97,3849,1894,1955,96.9
서울특별시,강동구,69세,2018,3992,1949,2043,95.4,3969,1943,2026,95.9
서울특별시,강동구,70~74세,2018,15286,7554,7732,97.7,15197,7519,7678,97.9
서울특별시,강동구,70세,2018,3837,1949,1888,103.2,3809,1935,1874,103.3
서울특별시,강동구,71세,2018,3625,1711,1914,89.4,3602,1705,1897,89.9
서울특별시,강동구,72세,2018,2736,1378,1358,101.5,2720,1371,1349,101.6
서울특별시,강동구,73세,2018,2588,1301,1287,101.1,2581,1299,1282,101.3
서울특별시,강동구,74세,2018,2500,1215,1285,94.6,2485,1209,1276,94.7
서울특별시,강동구,75~79세,2018,10307,4877,5430,89.8,10264,4866,5398,90.1
서울특별시,강동구,75세,2018,2379,1159,1220,95,2365,1156,1209,95.6
서울특별시,강동구,76세,2018,2565,1237,1328,93.1,2556,1234,1322,93.3
서울특별시,강동구,77세,2018,2045,982,1063,92.4,2040,980,1060,92.5
서울특별시,강동구,78세,2018,1701,792,909,87.1,1691,790,901,87.7
서울특별시,강동구,79세,2018,1617,707,910,77.7,1612,706,906,77.9
서울특별시,강동구,80~84세,2018,5728,2159,3569,60.5,5705,2156,3549,60.7
서울특별시,강동구,80세,2018,1413,611,802,76.2,1404,610,794,76.8
서울특별시,강동구,81세,2018,1271,498,773,64.4,1266,496,770,64.4
서울특별시,강동구,82세,2018,1110,429,681,63,1109,429,680,63.1
서울특별시,강동구,83세,2018,1058,348,710,49,1053,348,705,49.4
서울특별시,강동구,84세,2018,876,273,603,45.3,873,273,600,45.5
서울특별시,강동구,85세이상,2018,4237,1098,3139,35,4222,1094,3128,35
서울특별시,강동구,85~89세,2018,2831,815,2016,40.4,2819,812,2007,40.5
서울특별시,강동구,85세,2018,713,236,477,49.5,707,234,473,49.5
서울특별시,강동구,86세,2018,646,186,460,40.4,642,186,456,40.8
서울특별시,강동구,87세,2018,504,136,368,37,502,135,367,36.8
서울특별시,강동구,88세,2018,525,140,385,36.4,525,140,385,36.4
서울특별시,강동구,89세,2018,443,117,326,35.9,443,117,326,35.9
서울특별시,강동구,90~94세,2018,1103,220,883,24.9,1101,220,881,25
서울특별시,강동구,90세,2018,364,77,287,26.8,364,77,287,26.8
서울특별시,강동구,91세,2018,275,52,223,23.3,275,52,223,23.3
서울특별시,강동구,92세,2018,205,42,163,25.8,204,42,162,25.9
서울특별시,강동구,93세,2018,158,20,138,14.5,157,20,137,14.6
서울특별시,강동구,94세,2018,101,29,72,40.3,101,29,72,40.3
서울특별시,강동구,95~99세,2018,270,59,211,28,269,58,211,27.5
서울특별시,강동구,95세,2018,110,24,86,27.9,109,23,86,26.7
서울특별시,강동구,96세,2018,63,14,49,28.6,63,14,49,28.6
서울특별시,강동구,97세,2018,40,10,30,33.3,40,10,30,33.3
서울특별시,강동구,98세,2018,34,6,28,21.4,34,6,28,21.4
서울특별시,강동구,99세,2018,23,5,18,27.8,23,5,18,27.8
서울특별시,강동구,100세이상,2018,33,X,29,13.8,33,X,29,13.8
서울특별시,강동구,15세미만,2018,48149,25146,23003,109.3,47907,25031,22876,109.4
서울특별시,강동구,15~64세,2018,309111,153487,155624,98.6,303419,150754,152665,98.7
서울특별시,강동구,65세이상,2018,56971,26119,30852,84.7,56521,25933,30588,84.8
서울특별시,강동구,평균연령,2018,42.2,41.2,43.1,,42.2,41.2,43.1,
서울특별시,강동구,중위연령,2018,43,41.8,44.1,,42.9,41.8,44.1,
경기도,수원시장안구,합계,2018,288719,146009,142710,102.3,278897,140769,138128,101.9
경기도,수원시장안구,0~4세,2018,9952,5177,4775,108.4,9676,5033,4643,108.4
경기도,수원시장안구,0세,2018,1597,828,769,107.7,1531,800,731,109.4
경기도,수원시장안구,1세,2018,1793,953,840,113.5,1723,915,808,113.2
경기도,수원시장안구,2세,2018,2033,1027,1006,102.1,1978,995,983,101.2
경기도,수원시장안구,3세,2018,2290,1200,1090,110.1,2252,1179,1073,109.9
경기도,수원시장안구,4세,2018,2239,1169,1070,109.3,2192,1144,1048,109.2
경기도,수원시장안구,5~9세,2018,12615,6520,6095,107,12464,6446,6018,107.1
경기도,수원시장안구,5세,2018,2349,1235,1114,110.9,2299,1212,1087,111.5
경기도,수원시장안구,6세,2018,2549,1292,1257,102.8,2517,1280,1237,103.5
경기도,수원시장안구,7세,2018,2627,1382,1245,111,2606,1373,1233,111.4
경기도,수원시장안구,8세,2018,2509,1297,1212,107,2485,1281,1204,106.4
경기도,수원시장안구,9세,2018,2581,1314,1267,103.7,2557,1300,1257,103.4
경기도,수원시장안구,10~14세,2018,13942,7203,6739,106.9,13888,7186,6702,107.2
경기도,수원시장안구,10세,2018,2839,1466,1373,106.8,2823,1461,1362,107.3
경기도,수원시장안구,11세,2018,2899,1493,1406,106.2,2888,1489,1399,106.4
경기도,수원시장안구,12세,2018,2666,1356,1310,103.5,2658,1354,1304,103.8
경기도,수원시장안구,13세,2018,2634,1341,1293,103.7,2625,1339,1286,104.1
경기도,수원시장안구,14세,2018,2904,1547,1357,114,2894,1543,1351,114.2
경기도,수원시장안구,15~19세,2018,18200,9849,8351,117.9,17905,9717,8188,118.7
경기도,수원시장안구,15세,2018,3069,1584,1485,106.7,3062,1581,1481,106.8
경기도,수원시장안구,16세,2018,3122,1654,1468,112.7,3111,1649,1462,112.8
경기도,수원시장안구,17세,2018,3765,2090,1675,124.8,3759,2086,1673,124.7
경기도,수원시장안구,18세,2018,4026,2143,1883,113.8,3975,2122,1853,114.5
경기도,수원시장안구,19세,2018,4218,2378,1840,129.2,3998,2279,1719,132.6
경기도,수원시장안구,20~24세,2018,24013,13311,10702,124.4,22787,12591,10196,123.5
경기도,수원시장안구,20세,2018,4655,2567,2088,122.9,4439,2448,1991,123
경기도,수원시장안구,21세,2018,4791,2672,2119,126.1,4530,2519,2011,125.3
경기도,수원시장안구,22세,2018,4754,2585,2169,119.2,4513,2436,2077,117.3
경기도,수원시장안구,23세,2018,4908,2751,2157,127.5,4653,2597,2056,126.3
경기도,수원시장안구,24세,2018,4905,2736,2169,126.1,4652,2591,2061,125.7
경기도,수원시장안구,25~29세,2018,21933,12027,9906,121.4,20595,11287,9308,121.3
경기도,수원시장안구,25세,2018,4947,2712,2235,121.3,4673,2557,2116,120.8
경기도,수원시장안구,26세,2018,4832,2665,2167,123,4550,2495,2055,121.4
경기도,수원시장안구,27세,2018,4385,2404,1981,121.4,4136,2269,1867,121.5
경기도,수원시장안구,28세,2018,4033,2207,1826,120.9,3752,2051,1701,120.6
경기도,수원시장안구,29세,2018,3736,2039,1697,120.2,3484,1915,1569,122.1
경기도,수원시장안구,30~34세,2018,16924,8865,8059,110,15726,8222,7504,109.6
경기도,수원시장안구,30세,2018,3421,1818,1603,113.4,3152,1683,1469,114.6
경기도,수원시장안구,31세,2018,3324,1790,1534,116.7,3074,1643,1431,114.8
경기도,수원시장안구,32세,2018,3330,1755,1575,111.4,3084,1625,1459,111.4
경기도,수원시장안구,33세,2018,3422,1788,1634,109.4,3202,1674,1528,109.6
경기도,수원시장안구,34세,2018,3427,1714,1713,100.1,3214,1597,1617,98.8
경기도,수원시장안구,35~39세,2018,21238,10667,10571,100.9,20423,10192,10231,99.6
경기도,수원시장안구,35세,2018,3832,1984,1848,107.4,3651,1877,1774,105.8
경기도,수원시장안구,36세,2018,4205,2102,2103,100,4030,2000,2030,98.5
경기도,수원시장안구,37세,2018,4338,2176,2162,100.6,4192,2091,2101,99.5
경기도,수원시장안구,38세,2018,4430,2236,2194,101.9,4279,2149,2130,100.9
경기도,수원시장안구,39세,2018,4433,2169,2264,95.8,4271,2075,2196,94.5
경기도,수원시장안구,40~44세,2018,22560,11284,11276,100.1,21898,10894,11004,99
경기도,수원시장안구,40세,2018,4107,2105,2002,105.1,3940,2008,1932,103.9
경기도,수원시장안구,41세,2018,4330,2122,2208,96.1,4198,2049,2149,95.3
경기도,수원시장안구,42세,2018,4385,2216,2169,102.2,4260,2135,2125,100.5
경기도,수원시장안구,43세,2018,4585,2273,2312,98.3,4482,2215,2267,97.7
경기도,수원시장안구,44세,2018,5153,2568,2585,99.3,5018,2487,2531,98.3
경기도,수원시장안구,45~49세,2018,27677,13651,14026,97.3,26813,13178,13635,96.6
경기도,수원시장안구,45세,2018,5293,2554,2739,93.2,5120,2465,2655,92.8
경기도,수원시장안구,46세,2018,5245,2657,2588,102.7,5086,2555,2531,100.9
경기도,수원시장안구,47세,2018,5634,2789,2845,98,5460,2700,2760,97.8
경기도,수원시장안구,48세,2018,5649,2841,2808,101.2,5466,2731,2735,99.9
경기도,수원시장안구,49세,2018,5856,2810,3046,92.3,5681,2727,2954,92.3
경기도,수원시장안구,50~54세,2018,25994,12870,13124,98.1,25081,12402,12679,97.8
경기도,수원시장안구,50세,2018,5775,2771,3004,92.2,5586,2672,2914,91.7
경기도,수원시장안구,51세,2018,5288,2547,2741,92.9,5130,2463,2667,92.4
경기도,수원시장안구,52세,2018,5152,2610,2542,102.7,4982,2531,2451,103.3
경기도,수원시장안구,53세,2018,5091,2579,2512,102.7,4892,2468,2424,101.8
경기도,수원시장안구,54세,2018,4688,2363,2325,101.6,4491,2268,2223,102
경기도,수원시장안구,55~59세,2018,24143,12249,11894,103,23268,11834,11434,103.5
경기도,수원시장안구,55세,2018,5074,2625,2449,107.2,4817,2505,2312,108.3
경기도,수원시장안구,56세,2018,4846,2479,2367,104.7,4668,2397,2271,105.5
경기도,수원시장안구,57세,2018,5141,2551,2590,98.5,5035,2505,2530,99
경기도,수원시장안구,58세,2018,4853,2467,2386,103.4,4664,2369,2295,103.2
경기도,수원시장안구,59세,2018,4229,2127,2102,101.2,4084,2058,2026,101.6
경기도,수원시장안구,60~64세,2018,16567,8295,8272,100.3,15918,7962,7956,100.1
경기도,수원시장안구,60세,2018,3921,2012,1909,105.4,3766,1922,1844,104.2
경기도,수원시장안구,61세,2018,3500,1793,1707,105,3360,1720,1640,104.9
경기도,수원시장안구,62세,2018,3239,1628,1611,101.1,3133,1570,1563,100.4
경기도,수원시장안구,63세,2018,3232,1540,1692,91,3094,1471,1623,90.6
경기도,수원시장안구,64세,2018,2675,1322,1353,97.7,2565,1279,1286,99.5
경기도,수원시장안구,65~69세,2018,10455,5006,5449,91.9,10162,4862,5300,91.7
경기도,수원시장안구,65세,2018,2327,1105,1222,90.4,2240,1061,1179,90
경기도,수원시장안구,66세,2018,2532,1239,1293,95.8,2466,1200,1266,94.8
경기도,수원시장안구,67세,2018,1721,811,910,89.1,1664,786,878,89.5
경기도,수원시장안구,68세,2018,1982,936,1046,89.5,1933,913,1020,89.5
경기도,수원시장안구,69세,2018,1893,915,978,93.6,1859,902,957,94.3
경기도,수원시장안구,70~74세,2018,8175,3696,4479,82.5,8072,3651,4421,82.6
경기도,수원시장안구,70세,2018,1885,906,979,92.5,1861,892,969,92.1
경기도,수원시장안구,71세,2018,1908,863,1045,82.6,1882,852,1030,82.7
경기도,수원시장안구,72세,2018,1461,672,789,85.2,1442,663,779,85.1
경기도,수원시장안구,73세,2018,1486,631,855,73.8,1466,622,844,73.7
경기도,수원시장안구,74세,2018,1435,624,811,76.9,1421,622,799,77.8
경기도,수원시장안구,75~79세,2018,6799,2868,3931,73,6740,2855,3885,73.5
경기도,수원시장안구,75세,2018,1479,636,843,75.4,1469,634,835,75.9
경기도,수원시장안구,76세,2018,1625,682,943,72.3,1605,678,927,73.1
경기도,수원시장안구,77세,2018,1320,583,737,79.1,1309,581,728,79.8
경기도,수원시장안구,78세,2018,1199,486,713,68.2,1190,484,706,68.6
경기도,수원시장안구,79세,2018,1176,481,695,69.2,1167,478,689,69.4
경기도,수원시장안구,80~84세,2018,4444,1623,2821,57.5,4409,1613,2796,57.7
경기도,수원시장안구,80세,2018,1061,445,616,72.2,1053,442,611,72.3
경기도,수원시장안구,81세,2018,1011,390,621,62.8,1001,387,614,63
경기도,수원시장안구,82세,2018,907,298,609,48.9,901,296,605,48.9
경기도,수원시장안구,83세,2018,813,268,545,49.2,807,267,540,49.4
경기도,수원시장안구,84세,2018,652,222,430,51.6,647,221,426,51.9
경기도,수원시장안구,85세이상,2018,3088,848,2240,37.9,3072,844,2228,37.9
경기도,수원시장안구,85~89세,2018,2120,610,1510,40.4,2109,607,1502,40.4
경기도,수원시장안구,85세,2018,549,162,387,41.9,544,160,384,41.7
경기도,수원시장안구,86세,2018,502,153,349,43.8,499,152,347,43.8
경기도,수원시장안구,87세,2018,377,114,263,43.3,375,114,261,43.7
경기도,수원시장안구,88세,2018,376,97,279,34.8,376,97,279,34.8
경기도,수원시장안구,89세,2018,316,84,232,36.2,315,84,231,36.4
경기도,수원시장안구,90~94세,2018,768,197,571,34.5,764,196,568,34.5
경기도,수원시장안구,90세,2018,247,74,173,42.8,245,73,172,42.4
경기도,수원시장안구,91세,2018,203,43,160,26.9,201,43,158,27.2
경기도,수원시장안구,92세,2018,132,31,101,30.7,132,31,101,30.7
경기도,수원시장안구,93세,2018,108,25,83,30.1,108,25,83,30.1
경기도,수원시장안구,94세,2018,78,24,54,44.4,78,24,54,44.4
경기도,수원시장안구,95~99세,2018,180,39,141,27.7,179,39,140,27.9
경기도,수원시장안구,95세,2018,66,19,47,40.4,65,19,46,41.3
경기도,수원시장안구,96세,2018,58,8,50,16,58,8,50,16
경기도,수원시장안구,97세,2018,29,6,23,26.1,29,6,23,26.1
경기도,수원시장안구,98세,2018,16,X,15,6.7,16,X,15,6.7
경기도,수원시장안구,99세,2018,11,5,6,83.3,11,5,6,83.3
경기도,수원시장안구,100세이상,2018,20,X,18,11.1,20,X,18,11.1
경기도,수원시장안구,15세미만,2018,36509,18900,17609,107.3,36028,18665,17363,107.5
경기도,수원시장안구,15~64세,2018,219249,113068,106181,106.5,210414,108279,102135,106
경기도,수원시장안구,65세이상,2018,32961,14041,18920,74.2,32455,13825,18630,74.2
경기도,수원시장안구,평균연령,2018,40.3,39.1,41.5,,40.3,39.1,41.6,
경기도,수원시장안구,중위연령,2018,41.3,39.7,42.9,,41.5,39.9,43,
경기도,수원시권선구,합계,2018,379834,191697,188137,101.9,365133,184151,180982,101.8
경기도,수원시권선구,0~4세,2018,18940,9764,9176,106.4,18407,9488,8919,106.4
경기도,수원시권선구,0세,2018,3268,1680,1588,105.8,3133,1612,1521,106
경기도,수원시권선구,1세,2018,3577,1841,1736,106,3461,1776,1685,105.4
경기도,수원시권선구,2세,2018,4028,2126,1902,111.8,3908,2060,1848,111.5
경기도,수원시권선구,3세,2018,4071,2100,1971,106.5,3985,2053,1932,106.3
경기도,수원시권선구,4세,2018,3996,2017,1979,101.9,3920,1987,1933,102.8
경기도,수원시권선구,5~9세,2018,18506,9451,9055,104.4,18300,9355,8945,104.6
경기도,수원시권선구,5세,2018,3826,1947,1879,103.6,3767,1925,1842,104.5
경기도,수원시권선구,6세,2018,4102,2115,1987,106.4,4055,2090,1965,106.4
경기도,수원시권선구,7세,2018,3806,1956,1850,105.7,3767,1935,1832,105.6
경기도,수원시권선구,8세,2018,3455,1731,1724,100.4,3423,1714,1709,100.3
경기도,수원시권선구,9세,2018,3317,1702,1615,105.4,3288,1691,1597,105.9
경기도,수원시권선구,10~14세,2018,16332,8487,7845,108.2,16224,8443,7781,108.5
경기도,수원시권선구,10세,2018,3426,1790,1636,109.4,3399,1776,1623,109.4
경기도,수원시권선구,11세,2018,3517,1818,1699,107,3491,1807,1684,107.3
경기도,수원시권선구,12세,2018,3094,1602,1492,107.4,3074,1594,1480,107.7
경기도,수원시권선구,13세,2018,2945,1496,1449,103.2,2929,1492,1437,103.8
경기도,수원시권선구,14세,2018,3350,1781,1569,113.5,3331,1774,1557,113.9
경기도,수원시권선구,15~19세,2018,18517,9671,8846,109.3,18400,9626,8774,109.7
경기도,수원시권선구,15세,2018,3365,1792,1573,113.9,3348,1785,1563,114.2
경기도,수원시권선구,16세,2018,3336,1733,1603,108.1,3315,1729,1586,109
경기도,수원시권선구,17세,2018,3893,2053,1840,111.6,3870,2041,1829,111.6
경기도,수원시권선구,18세,2018,4081,2103,1978,106.3,4066,2097,1969,106.5
경기도,수원시권선구,19세,2018,3842,1990,1852,107.5,3801,1974,1827,108
경기도,수원시권선구,20~24세,2018,25035,12917,12118,106.6,24524,12646,11878,106.5
경기도,수원시권선구,20세,2018,4345,2353,1992,118.1,4289,2325,1964,118.4
경기도,수원시권선구,21세,2018,4790,2468,2322,106.3,4717,2432,2285,106.4
경기도,수원시권선구,22세,2018,5080,2612,2468,105.8,4979,2567,2412,106.4
경기도,수원시권선구,23세,2018,5311,2670,2641,101.1,5185,2596,2589,100.3
경기도,수원시권선구,24세,2018,5509,2814,2695,104.4,5354,2726,2628,103.7
경기도,수원시권선구,25~29세,2018,29788,15445,14343,107.7,28391,14762,13629,108.3
경기도,수원시권선구,25세,2018,5911,3080,2831,108.8,5702,2972,2730,108.9
경기도,수원시권선구,26세,2018,6246,3219,3027,106.3,6010,3101,2909,106.6
경기도,수원시권선구,27세,2018,6103,3161,2942,107.4,5822,3022,2800,107.9
경기도,수원시권선구,28세,2018,5686,2963,2723,108.8,5392,2827,2565,110.2
경기도,수원시권선구,29세,2018,5842,3022,2820,107.2,5465,2840,2625,108.2
경기도,수원시권선구,30~34세,2018,30300,15751,14549,108.3,28201,14625,13576,107.7
경기도,수원시권선구,30세,2018,5697,2995,2702,110.8,5286,2791,2495,111.9
경기도,수원시권선구,31세,2018,6017,3115,2902,107.3,5546,2851,2695,105.8
경기도,수원시권선구,32세,2018,5954,3028,2926,103.5,5534,2814,2720,103.5
경기도,수원시권선구,33세,2018,6178,3166,3012,105.1,5763,2946,2817,104.6
경기도,수원시권선구,34세,2018,6454,3447,3007,114.6,6072,3223,2849,113.1
경기도,수원시권선구,35~39세,2018,36390,19020,17370,109.5,34860,18169,16691,108.9
경기도,수원시권선구,35세,2018,6950,3614,3336,108.3,6602,3431,3171,108.2
경기도,수원시권선구,36세,2018,7500,3884,3616,107.4,7158,3692,3466,106.5
경기도,수원시권선구,37세,2018,7609,3941,3668,107.4,7329,3793,3536,107.3
경기도,수원시권선구,38세,2018,7388,3934,3454,113.9,7124,3779,3345,113
경기도,수원시권선구,39세,2018,6943,3647,3296,110.6,6647,3474,3173,109.5
경기도,수원시권선구,40~44세,2018,30522,16034,14488,110.7,29330,15338,13992,109.6
경기도,수원시권선구,40세,2018,6117,3230,2887,111.9,5870,3099,2771,111.8
경기도,수원시권선구,41세,2018,6113,3234,2879,112.3,5886,3102,2784,111.4
경기도,수원시권선구,42세,2018,5915,3158,2757,114.5,5676,3007,2669,112.7
경기도,수원시권선구,43세,2018,6019,3118,2901,107.5,5779,2978,2801,106.3
경기도,수원시권선구,44세,2018,6358,3294,3064,107.5,6119,3152,2967,106.2
경기도,수원시권선구,45~49세,2018,33234,16599,16635,99.8,31732,15826,15906,99.5
경기도,수원시권선구,45세,2018,6457,3291,3166,103.9,6211,3161,3050,103.6
경기도,수원시권선구,46세,2018,6417,3284,3133,104.8,6117,3120,2997,104.1
경기도,수원시권선구,47세,2018,6936,3556,3380,105.2,6623,3382,3241,104.4
경기도,수원시권선구,48세,2018,6426,3161,3265,96.8,6125,3018,3107,97.1
경기도,수원시권선구,49세,2018,6998,3307,3691,89.6,6656,3145,3511,89.6
경기도,수원시권선구,50~54세,2018,32620,15985,16635,96.1,30965,15130,15835,95.5
경기도,수원시권선구,50세,2018,6962,3309,3653,90.6,6615,3133,3482,90
경기도,수원시권선구,51세,2018,6492,3137,3355,93.5,6238,3005,3233,92.9
경기도,수원시권선구,52세,2018,6323,3161,3162,100,6013,3001,3012,99.6
경기도,수원시권선구,53세,2018,6683,3269,3414,95.8,6311,3078,3233,95.2
경기도,수원시권선구,54세,2018,6160,3109,3051,101.9,5788,2913,2875,101.3
경기도,수원시권선구,55~59세,2018,31748,15924,15824,100.6,30107,15139,14968,101.1
경기도,수원시권선구,55세,2018,6391,3235,3156,102.5,5900,3011,2889,104.2
경기도,수원시권선구,56세,2018,6315,3161,3154,100.2,5966,3005,2961,101.5
경기도,수원시권선구,57세,2018,6840,3371,3469,97.2,6611,3257,3354,97.1
경기도,수원시권선구,58세,2018,6503,3294,3209,102.6,6177,3131,3046,102.8
경기도,수원시권선구,59세,2018,5699,2863,2836,101,5453,2735,2718,100.6
경기도,수원시권선구,60~64세,2018,21630,10798,10832,99.7,20333,10140,10193,99.5
경기도,수원시권선구,60세,2018,5067,2560,2507,102.1,4775,2415,2360,102.3
경기도,수원시권선구,61세,2018,4687,2353,2334,100.8,4357,2182,2175,100.3
경기도,수원시권선구,62세,2018,4271,2150,2121,101.4,4025,2022,2003,100.9
경기도,수원시권선구,63세,2018,4215,2084,2131,97.8,3987,1974,2013,98.1
경기도,수원시권선구,64세,2018,3390,1651,1739,94.9,3189,1547,1642,94.2
경기도,수원시권선구,65~69세,2018,12977,6344,6633,95.6,12399,6062,6337,95.7
경기도,수원시권선구,65세,2018,3056,1478,1578,93.7,2893,1392,1501,92.7
경기도,수원시권선구,66세,2018,3217,1612,1605,100.4,3073,1545,1528,101.1
경기도,수원시권선구,67세,2018,2138,1030,1108,93,2027,975,1052,92.7
경기도,수원시권선구,68세,2018,2297,1110,1187,93.5,2204,1069,1135,94.2
경기도,수원시권선구,69세,2018,2269,1114,1155,96.5,2202,1081,1121,96.4
경기도,수원시권선구,70~74세,2018,9247,4347,4900,88.7,9078,4286,4792,89.4
경기도,수원시권선구,70세,2018,2188,1047,1141,91.8,2141,1028,1113,92.4
경기도,수원시권선구,71세,2018,2269,1089,1180,92.3,2221,1071,1150,93.1
경기도,수원시권선구,72세,2018,1632,758,874,86.7,1603,750,853,87.9
경기도,수원시권선구,73세,2018,1571,745,826,90.2,1547,736,811,90.8
경기도,수원시권선구,74세,2018,1587,708,879,80.5,1566,701,865,81
경기도,수원시권선구,75~79세,2018,6920,2874,4046,71,6830,2851,3979,71.7
경기도,수원시권선구,75세,2018,1472,639,833,76.7,1455,634,821,77.2
경기도,수원시권선구,76세,2018,1654,733,921,79.6,1637,725,912,79.5
경기도,수원시권선구,77세,2018,1381,568,813,69.9,1357,563,794,70.9
경기도,수원시권선구,78세,2018,1195,457,738,61.9,1177,454,723,62.8
경기도,수원시권선구,79세,2018,1218,477,741,64.4,1204,475,729,65.2
경기도,수원시권선구,80~84세,2018,4322,1559,2763,56.4,4261,1541,2720,56.7
경기도,수원시권선구,80세,2018,1061,414,647,64,1044,410,634,64.7
경기도,수원시권선구,81세,2018,971,349,622,56.1,956,343,613,56
경기도,수원시권선구,82세,2018,854,310,544,57,842,306,536,57.1
경기도,수원시권선구,83세,2018,760,255,505,50.5,754,254,500,50.8
경기도,수원시권선구,84세,2018,676,231,445,51.9,665,228,437,52.2
경기도,수원시권선구,85세이상,2018,2806,727,2079,35,2791,724,2067,35
경기도,수원시권선구,85~89세,2018,1993,560,1433,39.1,1981,557,1424,39.1
경기도,수원시권선구,85세,2018,561,167,394,42.4,554,165,389,42.4
경기도,수원시권선구,86세,2018,466,141,325,43.4,465,141,324,43.5
경기도,수원시권선구,87세,2018,338,95,243,39.1,336,95,241,39.4
경기도,수원시권선구,88세,2018,341,82,259,31.7,340,81,259,31.3
경기도,수원시권선구,89세,2018,287,75,212,35.4,286,75,211,35.5
경기도,수원시권선구,90~94세,2018,640,140,500,28,637,140,497,28.2
경기도,수원시권선구,90세,2018,215,50,165,30.3,214,50,164,30.5
경기도,수원시권선구,91세,2018,156,41,115,35.7,156,41,115,35.7
경기도,수원시권선구,92세,2018,115,24,91,26.4,114,24,90,26.7
경기도,수원시권선구,93세,2018,99,12,87,13.8,99,12,87,13.8
경기도,수원시권선구,94세,2018,55,13,42,31,54,13,41,31.7
경기도,수원시권선구,95~99세,2018,157,25,132,18.9,157,25,132,18.9
경기도,수원시권선구,95세,2018,58,9,49,18.4,58,9,49,18.4
경기도,수원시권선구,96세,2018,41,8,33,24.2,41,8,33,24.2
경기도,수원시권선구,97세,2018,33,X,30,10,33,X,30,10
경기도,수원시권선구,98세,2018,12,X,11,9.1,12,X,11,9.1
경기도,수원시권선구,99세,2018,13,X,9,44.4,13,X,9,44.4
경기도,수원시권선구,100세이상,2018,16,X,14,14.3,16,X,14,14.3
경기도,수원시권선구,15세미만,2018,53778,27702,26076,106.2,52931,27286,25645,106.4
경기도,수원시권선구,15~64세,2018,289784,148144,141640,104.6,276843,141401,135442,104.4
경기도,수원시권선구,65세이상,2018,36272,15851,20421,77.6,35359,15464,19895,77.7
경기도,수원시권선구,평균연령,2018,39.2,38.4,40,,39.1,38.3,39.9,
경기도,수원시권선구,중위연령,2018,39.4,38.7,40.3,,39.3,38.6,40.1,
경기도,수원시팔달구,합계,2018,194299,98496,95803,102.8,174315,87626,86689,101.1
경기도,수원시팔달구,0~4세,2018,6067,3059,3008,101.7,5478,2764,2714,101.8
경기도,수원시팔달구,0세,2018,1093,542,551,98.4,965,480,485,99
경기도,수원시팔달구,1세,2018,1115,560,555,100.9,1006,505,501,100.8
경기도,수원시팔달구,2세,2018,1298,633,665,95.2,1160,563,597,94.3
경기도,수원시팔달구,3세,2018,1277,661,616,107.3,1164,595,569,104.6
경기도,수원시팔달구,4세,2018,1284,663,621,106.8,1183,621,562,110.5
경기도,수원시팔달구,5~9세,2018,6351,3302,3049,108.3,6049,3154,2895,108.9
경기도,수원시팔달구,5세,2018,1249,641,608,105.4,1173,605,568,106.5
경기도,수원시팔달구,6세,2018,1321,674,647,104.2,1251,637,614,103.7
경기도,수원시팔달구,7세,2018,1251,643,608,105.8,1192,617,575,107.3
경기도,수원시팔달구,8세,2018,1301,672,629,106.8,1258,649,609,106.6
경기도,수원시팔달구,9세,2018,1229,672,557,120.6,1175,646,529,122.1
경기도,수원시팔달구,10~14세,2018,6810,3463,3347,103.5,6662,3392,3270,103.7
경기도,수원시팔달구,10세,2018,1392,734,658,111.6,1353,712,641,111.1
경기도,수원시팔달구,11세,2018,1365,695,670,103.7,1335,681,654,104.1
경기도,수원시팔달구,12세,2018,1270,644,626,102.9,1233,631,602,104.8
경기도,수원시팔달구,13세,2018,1279,636,643,98.9,1259,628,631,99.5
경기도,수원시팔달구,14세,2018,1504,754,750,100.5,1482,740,742,99.7
경기도,수원시팔달구,15~19세,2018,8783,4582,4201,109.1,8622,4495,4127,108.9
경기도,수원시팔달구,15세,2018,1495,793,702,113,1479,786,693,113.4
경기도,수원시팔달구,16세,2018,1580,807,773,104.4,1560,797,763,104.5
경기도,수원시팔달구,17세,2018,1859,982,877,112,1835,966,869,111.2
경기도,수원시팔달구,18세,2018,1984,1032,952,108.4,1938,1012,926,109.3
경기도,수원시팔달구,19세,2018,1865,968,897,107.9,1810,934,876,106.6
경기도,수원시팔달구,20~24세,2018,12542,6345,6197,102.4,12007,6073,5934,102.3
경기도,수원시팔달구,20세,2018,2077,1051,1026,102.4,2010,1017,993,102.4
경기도,수원시팔달구,21세,2018,2281,1178,1103,106.8,2195,1127,1068,105.5
경기도,수원시팔달구,22세,2018,2517,1304,1213,107.5,2405,1249,1156,108
경기도,수원시팔달구,23세,2018,2753,1335,1418,94.1,2627,1276,1351,94.4
경기도,수원시팔달구,24세,2018,2914,1477,1437,102.8,2770,1404,1366,102.8
경기도,수원시팔달구,25~29세,2018,16287,8753,7534,116.2,14622,7850,6772,115.9
경기도,수원시팔달구,25세,2018,3195,1714,1481,115.7,2957,1586,1371,115.7
경기도,수원시팔달구,26세,2018,3374,1800,1574,114.4,3108,1648,1460,112.9
경기도,수원시팔달구,27세,2018,3294,1771,1523,116.3,2998,1599,1399,114.3
경기도,수원시팔달구,28세,2018,3184,1718,1466,117.2,2768,1500,1268,118.3
경기도,수원시팔달구,29세,2018,3240,1750,1490,117.4,2791,1517,1274,119.1
경기도,수원시팔달구,30~34세,2018,14709,8011,6698,119.6,12415,6684,5731,116.6
경기도,수원시팔달구,30세,2018,3084,1654,1430,115.7,2624,1397,1227,113.9
경기도,수원시팔달구,31세,2018,2963,1605,1358,118.2,2509,1329,1180,112.6
경기도,수원시팔달구,32세,2018,2959,1649,1310,125.9,2439,1354,1085,124.8
경기도,수원시팔달구,33세,2018,2807,1501,1306,114.9,2370,1254,1116,112.4
경기도,수원시팔달구,34세,2018,2896,1602,1294,123.8,2473,1350,1123,120.2
경기도,수원시팔달구,35~39세,2018,15585,8363,7222,115.8,13698,7211,6487,111.2
경기도,수원시팔달구,35세,2018,3061,1666,1395,119.4,2649,1429,1220,117.1
경기도,수원시팔달구,36세,2018,3209,1707,1502,113.6,2766,1440,1326,108.6
경기도,수원시팔달구,37세,2018,3174,1700,1474,115.3,2841,1485,1356,109.5
경기도,수원시팔달구,38세,2018,3158,1712,1446,118.4,2809,1497,1312,114.1
경기도,수원시팔달구,39세,2018,2983,1578,1405,112.3,2633,1360,1273,106.8
경기도,수원시팔달구,40~44세,2018,14774,7726,7048,109.6,13145,6771,6374,106.2
경기도,수원시팔달구,40세,2018,2786,1478,1308,113,2442,1276,1166,109.4
경기도,수원시팔달구,41세,2018,2863,1469,1394,105.4,2539,1289,1250,103.1
경기도,수원시팔달구,42세,2018,2823,1484,1339,110.8,2516,1294,1222,105.9
경기도,수원시팔달구,43세,2018,3011,1573,1438,109.4,2698,1387,1311,105.8
경기도,수원시팔달구,44세,2018,3291,1722,1569,109.8,2950,1525,1425,107
경기도,수원시팔달구,45~49세,2018,17717,9177,8540,107.5,15379,7868,7511,104.8
경기도,수원시팔달구,45세,2018,3340,1717,1623,105.8,2974,1514,1460,103.7
경기도,수원시팔달구,46세,2018,3380,1800,1580,113.9,2898,1518,1380,110
경기도,수원시팔달구,47세,2018,3716,1910,1806,105.8,3199,1620,1579,102.6
경기도,수원시팔달구,48세,2018,3638,1915,1723,111.1,3146,1646,1500,109.7
경기도,수원시팔달구,49세,2018,3643,1835,1808,101.5,3162,1570,1592,98.6
경기도,수원시팔달구,50~54세,2018,17568,8929,8639,103.4,14908,7487,7421,100.9
경기도,수원시팔달구,50세,2018,3749,1810,1939,93.3,3301,1564,1737,90
경기도,수원시팔달구,51세,2018,3313,1686,1627,103.6,2897,1464,1433,102.2
경기도,수원시팔달구,52세,2018,3428,1759,1669,105.4,2859,1459,1400,104.2
경기도,수원시팔달구,53세,2018,3539,1838,1701,108.1,2918,1507,1411,106.8
경기도,수원시팔달구,54세,2018,3539,1836,1703,107.8,2933,1493,1440,103.7
경기도,수원시팔달구,55~59세,2018,17998,9110,8888,102.5,15486,7766,7720,100.6
경기도,수원시팔달구,55세,2018,3815,1931,1884,102.5,3053,1505,1548,97.2
경기도,수원시팔달구,56세,2018,3548,1810,1738,104.1,2993,1527,1466,104.2
경기도,수원시팔달구,57세,2018,3706,1844,1862,99,3389,1694,1695,99.9
경기도,수원시팔달구,58세,2018,3672,1859,1813,102.5,3175,1587,1588,99.9
경기도,수원시팔달구,59세,2018,3257,1666,1591,104.7,2876,1453,1423,102.1
경기도,수원시팔달구,60~64세,2018,13814,6784,7030,96.5,11890,5803,6087,95.3
경기도,수원시팔달구,60세,2018,3088,1568,1520,103.2,2659,1348,1311,102.8
경기도,수원시팔달구,61세,2018,2987,1477,1510,97.8,2500,1246,1254,99.4
경기도,수원시팔달구,62세,2018,2692,1322,1370,96.5,2328,1134,1194,95
경기도,수원시팔달구,63세,2018,2711,1287,1424,90.4,2363,1097,1266,86.7
경기도,수원시팔달구,64세,2018,2336,1130,1206,93.7,2040,978,1062,92.1
경기도,수원시팔달구,65~69세,2018,8700,4187,4513,92.8,7852,3765,4087,92.1
경기도,수원시팔달구,65세,2018,1909,893,1016,87.9,1686,783,903,86.7
경기도,수원시팔달구,66세,2018,2153,1048,1105,94.8,1961,947,1014,93.4
경기도,수원시팔달구,67세,2018,1475,721,754,95.6,1291,631,660,95.6
경기도,수원시팔달구,68세,2018,1611,772,839,92,1483,709,774,91.6
경기도,수원시팔달구,69세,2018,1552,753,799,94.2,1431,695,736,94.4
경기도,수원시팔달구,70~74세,2018,6526,2947,3579,82.3,6273,2841,3432,82.8
경기도,수원시팔달구,70세,2018,1591,737,854,86.3,1514,697,817,85.3
경기도,수원시팔달구,71세,2018,1517,645,872,74,1447,614,833,73.7
경기도,수원시팔달구,72세,2018,1161,555,606,91.6,1120,536,584,91.8
경기도,수원시팔달구,73세,2018,1118,523,595,87.9,1092,515,577,89.3
경기도,수원시팔달구,74세,2018,1139,487,652,74.7,1100,479,621,77.1
경기도,수원시팔달구,75~79세,2018,5137,2156,2981,72.3,5003,2119,2884,73.5
경기도,수원시팔달구,75세,2018,1128,480,648,74.1,1099,473,626,75.6
경기도,수원시팔달구,76세,2018,1257,558,699,79.8,1232,552,680,81.2
경기도,수원시팔달구,77세,2018,1020,415,605,68.6,987,407,580,70.2
경기도,수원시팔달구,78세,2018,866,354,512,69.1,842,343,499,68.7
경기도,수원시팔달구,79세,2018,866,349,517,67.5,843,344,499,68.9
경기도,수원시팔달구,80~84세,2018,3011,1121,1890,59.3,2939,1106,1833,60.3
경기도,수원시팔달구,80세,2018,746,306,440,69.5,729,300,429,69.9
경기도,수원시팔달구,81세,2018,657,247,410,60.2,642,244,398,61.3
경기도,수원시팔달구,82세,2018,627,211,416,50.7,606,209,397,52.6
경기도,수원시팔달구,83세,2018,544,204,340,60,535,202,333,60.7
경기도,수원시팔달구,84세,2018,437,153,284,53.9,427,151,276,54.7
경기도,수원시팔달구,85세이상,2018,1920,481,1439,33.4,1887,477,1410,33.8
경기도,수원시팔달구,85~89세,2018,1331,355,976,36.4,1301,352,949,37.1
경기도,수원시팔달구,85세,2018,358,113,245,46.1,351,112,239,46.9
경기도,수원시팔달구,86세,2018,341,92,249,36.9,334,91,243,37.4
경기도,수원시팔달구,87세,2018,234,55,179,30.7,231,54,177,30.5
경기도,수원시팔달구,88세,2018,196,53,143,37.1,187,53,134,39.6
경기도,수원시팔달구,89세,2018,202,42,160,26.3,198,42,156,26.9
경기도,수원시팔달구,90~94세,2018,440,91,349,26.1,438,90,348,25.9
경기도,수원시팔달구,90세,2018,139,29,110,26.4,139,29,110,26.4
경기도,수원시팔달구,91세,2018,118,27,91,29.7,116,26,90,28.9
경기도,수원시팔달구,92세,2018,74,17,57,29.8,74,17,57,29.8
경기도,수원시팔달구,93세,2018,63,5,58,8.6,63,5,58,8.6
경기도,수원시팔달구,94세,2018,46,13,33,39.4,46,13,33,39.4
경기도,수원시팔달구,95~99세,2018,142,35,107,32.7,141,35,106,33
경기도,수원시팔달구,95세,2018,53,17,36,47.2,53,17,36,47.2
경기도,수원시팔달구,96세,2018,42,10,32,31.3,42,10,32,31.3
경기도,수원시팔달구,97세,2018,28,6,22,27.3,28,6,22,27.3
경기도,수원시팔달구,98세,2018,14,X,13,7.7,13,X,12,8.3
경기도,수원시팔달구,99세,2018,5,X,X,25,5,X,X,25
경기도,수원시팔달구,100세이상,2018,7,X,7,0,7,X,7,0
경기도,수원시팔달구,15세미만,2018,19228,9824,9404,104.5,18189,9310,8879,104.9
경기도,수원시팔달구,15~64세,2018,149777,77780,71997,108,132172,68008,64164,106
경기도,수원시팔달구,65세이상,2018,25294,10892,14402,75.6,23954,10308,13646,75.5
경기도,수원시팔달구,평균연령,2018,42.5,41.5,43.5,,42.3,41.2,43.3,
경기도,수원시팔달구,중위연령,2018,43.5,42.3,44.7,,43,41.7,44.3,
경기도,수원시영통구,합계,2018,355991,180038,175953,102.3,346809,175049,171760,101.9
경기도,수원시영통구,0~4세,2018,18319,9413,8906,105.7,17956,9234,8722,105.9
경기도,수원시영통구,0세,2018,3248,1657,1591,104.1,3177,1623,1554,104.4
경기도,수원시영통구,1세,2018,3325,1741,1584,109.9,3253,1705,1548,110.1
경기도,수원시영통구,2세,2018,3759,1942,1817,106.9,3679,1904,1775,107.3
경기도,수원시영통구,3세,2018,4163,2114,2049,103.2,4085,2078,2007,103.5
경기도,수원시영통구,4세,2018,3824,1959,1865,105,3762,1924,1838,104.7
경기도,수원시영통구,5~9세,2018,20191,10460,9731,107.5,19940,10320,9620,107.3
경기도,수원시영통구,5세,2018,3938,2057,1881,109.4,3871,2020,1851,109.1
경기도,수원시영통구,6세,2018,4297,2205,2092,105.4,4237,2178,2059,105.8
경기도,수원시영통구,7세,2018,4130,2127,2003,106.2,4082,2101,1981,106.1
경기도,수원시영통구,8세,2018,3973,2087,1886,110.7,3940,2063,1877,109.9
경기도,수원시영통구,9세,2018,3853,1984,1869,106.2,3810,1958,1852,105.7
경기도,수원시영통구,10~14세,2018,19952,10192,9760,104.4,19855,10142,9713,104.4
경기도,수원시영통구,10세,2018,4108,2083,2025,102.9,4086,2069,2017,102.6
경기도,수원시영통구,11세,2018,4238,2198,2040,107.7,4214,2186,2028,107.8
경기도,수원시영통구,12세,2018,3785,1942,1843,105.4,3764,1937,1827,106
경기도,수원시영통구,13세,2018,3728,1876,1852,101.3,3712,1866,1846,101.1
경기도,수원시영통구,14세,2018,4093,2093,2000,104.7,4079,2084,1995,104.5
경기도,수원시영통구,15~19세,2018,23345,12026,11319,106.2,23045,11893,11152,106.6
경기도,수원시영통구,15세,2018,4162,2106,2056,102.4,4150,2100,2050,102.4
경기도,수원시영통구,16세,2018,4029,2056,1973,104.2,4013,2048,1965,104.2
경기도,수원시영통구,17세,2018,4601,2421,2180,111.1,4585,2415,2170,111.3
경기도,수원시영통구,18세,2018,5233,2684,2549,105.3,5166,2665,2501,106.6
경기도,수원시영통구,19세,2018,5320,2759,2561,107.7,5131,2665,2466,108.1
경기도,수원시영통구,20~24세,2018,27581,14197,13384,106.1,26274,13537,12737,106.3
경기도,수원시영통구,20세,2018,5286,2688,2598,103.5,4951,2529,2422,104.4
경기도,수원시영통구,21세,2018,5001,2598,2403,108.1,4777,2472,2305,107.2
경기도,수원시영통구,22세,2018,5397,2807,2590,108.4,5175,2708,2467,109.8
경기도,수원시영통구,23세,2018,5878,3029,2849,106.3,5623,2920,2703,108
경기도,수원시영통구,24세,2018,6019,3075,2944,104.4,5748,2908,2840,102.4
경기도,수원시영통구,25~29세,2018,31363,16947,14416,117.6,29938,16136,13802,116.9
경기도,수원시영통구,25세,2018,6352,3341,3011,111,6078,3180,2898,109.7
경기도,수원시영통구,26세,2018,6588,3609,2979,121.1,6285,3439,2846,120.8
경기도,수원시영통구,27세,2018,6260,3445,2815,122.4,5990,3292,2698,122
경기도,수원시영통구,28세,2018,6031,3270,2761,118.4,5736,3092,2644,116.9
경기도,수원시영통구,29세,2018,6132,3282,2850,115.2,5849,3133,2716,115.4
경기도,수원시영통구,30~34세,2018,29343,15293,14050,108.8,27934,14474,13460,107.5
경기도,수원시영통구,30세,2018,5952,3141,2811,111.7,5638,2962,2676,110.7
경기도,수원시영통구,31세,2018,5899,3109,2790,111.4,5590,2927,2663,109.9
경기도,수원시영통구,32세,2018,5756,3048,2708,112.6,5485,2879,2606,110.5
경기도,수원시영통구,33세,2018,5956,3049,2907,104.9,5684,2911,2773,105
경기도,수원시영통구,34세,2018,5780,2946,2834,104,5537,2795,2742,101.9
경기도,수원시영통구,35~39세,2018,34396,17275,17121,100.9,33386,16671,16715,99.7
경기도,수원시영통구,35세,2018,6470,3344,3126,107,6239,3219,3020,106.6
경기도,수원시영통구,36세,2018,7132,3600,3532,101.9,6892,3451,3441,100.3
경기도,수원시영통구,37세,2018,7051,3501,3550,98.6,6877,3390,3487,97.2
경기도,수원시영통구,38세,2018,7030,3465,3565,97.2,6835,3354,3481,96.4
경기도,수원시영통구,39세,2018,6713,3365,3348,100.5,6543,3257,3286,99.1
경기도,수원시영통구,40~44세,2018,31920,15722,16198,97.1,31245,15293,15952,95.9
경기도,수원시영통구,40세,2018,6158,3100,3058,101.4,6009,3009,3000,100.3
경기도,수원시영통구,41세,2018,6491,3202,3289,97.4,6339,3105,3234,96
경기도,수원시영통구,42세,2018,6317,3137,3180,98.6,6178,3048,3130,97.4
경기도,수원시영통구,43세,2018,6289,3108,3181,97.7,6179,3044,3135,97.1
경기도,수원시영통구,44세,2018,6665,3175,3490,91,6540,3087,3453,89.4
경기도,수원시영통구,45~49세,2018,33936,16885,17051,99,33266,16499,16767,98.4
경기도,수원시영통구,45세,2018,6844,3310,3534,93.7,6695,3224,3471,92.9
경기도,수원시영통구,46세,2018,6762,3369,3393,99.3,6623,3291,3332,98.8
경기도,수원시영통구,47세,2018,7041,3547,3494,101.5,6909,3468,3441,100.8
경기도,수원시영통구,48세,2018,6642,3362,3280,102.5,6504,3279,3225,101.7
경기도,수원시영통구,49세,2018,6647,3297,3350,98.4,6535,3237,3298,98.2
경기도,수원시영통구,50~54세,2018,26901,13376,13525,98.9,26364,13103,13261,98.8
경기도,수원시영통구,50세,2018,6238,3062,3176,96.4,6126,3000,3126,96
경기도,수원시영통구,51세,2018,5491,2698,2793,96.6,5406,2654,2752,96.4
경기도,수원시영통구,52세,2018,5127,2567,2560,100.3,5012,2508,2504,100.2
경기도,수원시영통구,53세,2018,5277,2659,2618,101.6,5159,2601,2558,101.7
경기도,수원시영통구,54세,2018,4768,2390,2378,100.5,4661,2340,2321,100.8
경기도,수원시영통구,55~59세,2018,22568,11786,10782,109.3,22096,11562,10534,109.8
경기도,수원시영통구,55세,2018,4974,2589,2385,108.6,4838,2525,2313,109.2
경기도,수원시영통구,56세,2018,4759,2455,2304,106.6,4639,2406,2233,107.7
경기도,수원시영통구,57세,2018,4731,2433,2298,105.9,4663,2401,2262,106.1
경기도,수원시영통구,58세,2018,4433,2345,2088,112.3,4348,2299,2049,112.2
경기도,수원시영통구,59세,2018,3671,1964,1707,115.1,3608,1931,1677,115.1
경기도,수원시영통구,60~64세,2018,13659,6925,6734,102.8,13280,6751,6529,103.4
경기도,수원시영통구,60세,2018,3401,1758,1643,107,3306,1715,1591,107.8
경기도,수원시영통구,61세,2018,3010,1547,1463,105.7,2918,1502,1416,106.1
경기도,수원시영통구,62세,2018,2631,1361,1270,107.2,2550,1319,1231,107.1
경기도,수원시영통구,63세,2018,2584,1260,1324,95.2,2512,1234,1278,96.6
경기도,수원시영통구,64세,2018,2033,999,1034,96.6,1994,981,1013,96.8
경기도,수원시영통구,65~69세,2018,7858,3767,4091,92.1,7680,3700,3980,93
경기도,수원시영통구,65세,2018,1760,830,930,89.2,1711,815,896,91
경기도,수원시영통구,66세,2018,1940,957,983,97.4,1907,941,966,97.4
경기도,수원시영통구,67세,2018,1293,628,665,94.4,1244,611,633,96.5
경기도,수원시영통구,68세,2018,1454,688,766,89.8,1429,678,751,90.3
경기도,수원시영통구,69세,2018,1411,664,747,88.9,1389,655,734,89.2
경기도,수원시영통구,70~74세,2018,5565,2527,3038,83.2,5506,2499,3007,83.1
경기도,수원시영통구,70세,2018,1340,620,720,86.1,1321,610,711,85.8
경기도,수원시영통구,71세,2018,1276,597,679,87.9,1261,589,672,87.6
경기도,수원시영통구,72세,2018,1030,491,539,91.1,1017,485,532,91.2
경기도,수원시영통구,73세,2018,972,430,542,79.3,966,428,538,79.6
경기도,수원시영통구,74세,2018,947,389,558,69.7,941,387,554,69.9
경기도,수원시영통구,75~79세,2018,4393,1777,2616,67.9,4371,1772,2599,68.2
경기도,수원시영통구,75세,2018,952,390,562,69.4,946,389,557,69.8
경기도,수원시영통구,76세,2018,1067,446,621,71.8,1064,445,619,71.9
경기도,수원시영통구,77세,2018,888,347,541,64.1,881,346,535,64.7
경기도,수원시영통구,78세,2018,766,325,441,73.7,763,324,439,73.8
경기도,수원시영통구,79세,2018,720,269,451,59.6,717,268,449,59.7
경기도,수원시영통구,80~84세,2018,2802,957,1845,51.9,2783,952,1831,52
경기도,수원시영통구,80세,2018,689,252,437,57.7,687,251,436,57.6
경기도,수원시영통구,81세,2018,613,214,399,53.6,607,213,394,54.1
경기도,수원시영통구,82세,2018,538,181,357,50.7,535,180,355,50.7
경기도,수원시영통구,83세,2018,525,170,355,47.9,520,168,352,47.7
경기도,수원시영통구,84세,2018,437,140,297,47.1,434,140,294,47.6
경기도,수원시영통구,85세이상,2018,1899,513,1386,37,1890,511,1379,37.1
경기도,수원시영통구,85~89세,2018,1328,383,945,40.5,1320,381,939,40.6
경기도,수원시영통구,85세,2018,358,109,249,43.8,354,108,246,43.9
경기도,수원시영통구,86세,2018,313,97,216,44.9,310,96,214,44.9
경기도,수원시영통구,87세,2018,231,61,170,35.9,231,61,170,35.9
경기도,수원시영통구,88세,2018,239,59,180,32.8,238,59,179,33
경기도,수원시영통구,89세,2018,187,57,130,43.8,187,57,130,43.8
경기도,수원시영통구,90~94세,2018,455,104,351,29.6,454,104,350,29.7
경기도,수원시영통구,90세,2018,155,32,123,26,155,32,123,26
경기도,수원시영통구,91세,2018,116,35,81,43.2,116,35,81,43.2
경기도,수원시영통구,92세,2018,82,12,70,17.1,81,12,69,17.4
경기도,수원시영통구,93세,2018,58,17,41,41.5,58,17,41,41.5
경기도,수원시영통구,94세,2018,44,8,36,22.2,44,8,36,22.2
경기도,수원시영통구,95~99세,2018,106,25,81,30.9,106,25,81,30.9
경기도,수원시영통구,95세,2018,39,10,29,34.5,39,10,29,34.5
경기도,수원시영통구,96세,2018,31,6,25,24,31,6,25,24
경기도,수원시영통구,97세,2018,14,X,10,40,14,X,10,40
경기도,수원시영통구,98세,2018,13,X,10,30,13,X,10,30
경기도,수원시영통구,99세,2018,9,X,7,28.6,9,X,7,28.6
경기도,수원시영통구,100세이상,2018,10,X,9,11.1,10,X,9,11.1
경기도,수원시영통구,15세미만,2018,58462,30065,28397,105.9,57751,29696,28055,105.8
경기도,수원시영통구,15~64세,2018,275012,140432,134580,104.3,266828,135919,130909,103.8
경기도,수원시영통구,65세이상,2018,22517,9541,12976,73.5,22230,9434,12796,73.7
경기도,수원시영통구,평균연령,2018,35.9,35.3,36.6,,35.9,35.3,36.6,
경기도,수원시영통구,중위연령,2018,36.2,35.4,36.9,,36.3,35.6,37.1,
경상남도,진주시,합계,2018,352333,176228,176105,100.1,345841,172192,173649,99.2
경상남도,진주시,0~4세,2018,13564,7030,6534,107.6,13506,6998,6508,107.5
경상남도,진주시,0세,2018,2196,1153,1043,110.5,2187,1150,1037,110.9
경상남도,진주시,1세,2018,2423,1234,1189,103.8,2412,1226,1186,103.4
경상남도,진주시,2세,2018,2778,1461,1317,110.9,2766,1454,1312,110.8
경상남도,진주시,3세,2018,3010,1540,1470,104.8,2998,1534,1464,104.8
경상남도,진주시,4세,2018,3157,1642,1515,108.4,3143,1634,1509,108.3
경상남도,진주시,5~9세,2018,16285,8624,7661,112.6,16260,8611,7649,112.6
경상남도,진주시,5세,2018,3035,1629,1406,115.9,3029,1626,1403,115.9
경상남도,진주시,6세,2018,3377,1738,1639,106,3371,1735,1636,106.1
경상남도,진주시,7세,2018,3422,1832,1590,115.2,3415,1828,1587,115.2
경상남도,진주시,8세,2018,3293,1762,1531,115.1,3289,1760,1529,115.1
경상남도,진주시,9세,2018,3158,1663,1495,111.2,3156,1662,1494,111.2
경상남도,진주시,10~14세,2018,16785,8785,8000,109.8,16770,8775,7995,109.8
경상남도,진주시,10세,2018,3428,1778,1650,107.8,3423,1775,1648,107.7
경상남도,진주시,11세,2018,3475,1748,1727,101.2,3473,1746,1727,101.1
경상남도,진주시,12세,2018,3202,1687,1515,111.4,3199,1686,1513,111.4
경상남도,진주시,13세,2018,3126,1646,1480,111.2,3124,1645,1479,111.2
경상남도,진주시,14세,2018,3554,1926,1628,118.3,3551,1923,1628,118.1
경상남도,진주시,15~19세,2018,21926,11664,10262,113.7,21749,11571,10178,113.7
경상남도,진주시,15세,2018,3543,1849,1694,109.1,3539,1848,1691,109.3
경상남도,진주시,16세,2018,3733,2061,1672,123.3,3724,2056,1668,123.3
경상남도,진주시,17세,2018,4302,2313,1989,116.3,4278,2301,1977,116.4
경상남도,진주시,18세,2018,4904,2605,2299,113.3,4854,2576,2278,113.1
경상남도,진주시,19세,2018,5444,2836,2608,108.7,5354,2790,2564,108.8
경상남도,진주시,20~24세,2018,28373,15738,12635,124.6,27267,15125,12142,124.6
경상남도,진주시,20세,2018,5653,2770,2883,96.1,5467,2681,2786,96.2
경상남도,진주시,21세,2018,5691,2925,2766,105.7,5514,2836,2678,105.9
경상남도,진주시,22세,2018,6040,3489,2551,136.8,5830,3367,2463,136.7
경상남도,진주시,23세,2018,5667,3399,2268,149.9,5431,3265,2166,150.7
경상남도,진주시,24세,2018,5322,3155,2167,145.6,5025,2976,2049,145.2
경상남도,진주시,25~29세,2018,21516,12155,9361,129.8,20064,11200,8864,126.4
경상남도,진주시,25세,2018,4874,2828,2046,138.2,4583,2643,1940,136.2
경상남도,진주시,26세,2018,4478,2531,1947,130,4208,2361,1847,127.8
경상남도,진주시,27세,2018,4092,2308,1784,129.4,3806,2114,1692,124.9
경상남도,진주시,28세,2018,4032,2235,1797,124.4,3702,2017,1685,119.7
경상남도,진주시,29세,2018,4040,2253,1787,126.1,3765,2065,1700,121.5
경상남도,진주시,30~34세,2018,19790,10415,9375,111.1,18552,9557,8995,106.2
경상남도,진주시,30세,2018,3729,2027,1702,119.1,3477,1859,1618,114.9
경상남도,진주시,31세,2018,3988,2067,1921,107.6,3716,1881,1835,102.5
경상남도,진주시,32세,2018,3986,2127,1859,114.4,3735,1945,1790,108.7
경상남도,진주시,33세,2018,3880,2067,1813,114,3632,1891,1741,108.6
경상남도,진주시,34세,2018,4207,2127,2080,102.3,3992,1981,2011,98.5
경상남도,진주시,35~39세,2018,25193,12740,12453,102.3,24334,12148,12186,99.7
경상남도,진주시,35세,2018,4624,2310,2314,99.8,4409,2150,2259,95.2
경상남도,진주시,36세,2018,5008,2538,2470,102.8,4825,2405,2420,99.4
경상남도,진주시,37세,2018,5085,2560,2525,101.4,4899,2438,2461,99.1
경상남도,진주시,38세,2018,5319,2693,2626,102.6,5167,2591,2576,100.6
경상남도,진주시,39세,2018,5157,2639,2518,104.8,5034,2564,2470,103.8
경상남도,진주시,40~44세,2018,25633,12761,12872,99.1,25146,12451,12695,98.1
경상남도,진주시,40세,2018,4838,2437,2401,101.5,4731,2358,2373,99.4
경상남도,진주시,41세,2018,4849,2395,2454,97.6,4749,2326,2423,96
경상남도,진주시,42세,2018,5036,2511,2525,99.4,4919,2441,2478,98.5
경상남도,진주시,43세,2018,5190,2597,2593,100.2,5105,2551,2554,99.9
경상남도,진주시,44세,2018,5720,2821,2899,97.3,5642,2775,2867,96.8
경상남도,진주시,45~49세,2018,30439,15242,15197,100.3,30076,15042,15034,100.1
경상남도,진주시,45세,2018,5986,3000,2986,100.5,5927,2970,2957,100.4
경상남도,진주시,46세,2018,5688,2898,2790,103.9,5601,2851,2750,103.7
경상남도,진주시,47세,2018,6129,3072,3057,100.5,6051,3026,3025,100
경상남도,진주시,48세,2018,6313,3135,3178,98.6,6250,3096,3154,98.2
경상남도,진주시,49세,2018,6323,3137,3186,98.5,6247,3099,3148,98.4
경상남도,진주시,50~54세,2018,27464,13707,13757,99.6,27159,13548,13611,99.5
경상남도,진주시,50세,2018,6150,3087,3063,100.8,6088,3050,3038,100.4
경상남도,진주시,51세,2018,5663,2771,2892,95.8,5588,2735,2853,95.9
경상남도,진주시,52세,2018,5489,2857,2632,108.5,5431,2825,2606,108.4
경상남도,진주시,53세,2018,5452,2687,2765,97.2,5405,2662,2743,97
경상남도,진주시,54세,2018,4710,2305,2405,95.8,4647,2276,2371,96
경상남도,진주시,55~59세,2018,29232,14361,14871,96.6,29035,14263,14772,96.6
경상남도,진주시,55세,2018,5370,2714,2656,102.2,5314,2688,2626,102.4
경상남도,진주시,56세,2018,5830,2909,2921,99.6,5784,2887,2897,99.7
경상남도,진주시,57세,2018,6683,3253,3430,94.8,6649,3235,3414,94.8
경상남도,진주시,58세,2018,6155,2920,3235,90.3,6117,2902,3215,90.3
경상남도,진주시,59세,2018,5194,2565,2629,97.6,5171,2551,2620,97.4
경상남도,진주시,60~64세,2018,23758,11690,12068,96.9,23635,11629,12006,96.9
경상남도,진주시,60세,2018,5214,2554,2660,96,5178,2534,2644,95.8
경상남도,진주시,61세,2018,5034,2527,2507,100.8,5005,2513,2492,100.8
경상남도,진주시,62세,2018,4633,2327,2306,100.9,4609,2314,2295,100.8
경상남도,진주시,63세,2018,4755,2206,2549,86.5,4739,2196,2543,86.4
경상남도,진주시,64세,2018,4122,2076,2046,101.5,4104,2072,2032,102
경상남도,진주시,65~69세,2018,16451,7686,8765,87.7,16399,7660,8739,87.7
경상남도,진주시,65세,2018,3457,1626,1831,88.8,3444,1619,1825,88.7
경상남도,진주시,66세,2018,3712,1738,1974,88,3701,1732,1969,88
경상남도,진주시,67세,2018,2942,1393,1549,89.9,2930,1385,1545,89.6
경상남도,진주시,68세,2018,3206,1502,1704,88.1,3196,1501,1695,88.6
경상남도,진주시,69세,2018,3134,1427,1707,83.6,3128,1423,1705,83.5
경상남도,진주시,70~74세,2018,12827,5849,6978,83.8,12806,5839,6967,83.8
경상남도,진주시,70세,2018,3093,1430,1663,86,3088,1429,1659,86.1
경상남도,진주시,71세,2018,2904,1359,1545,88,2899,1357,1542,88
경상남도,진주시,72세,2018,2239,1030,1209,85.2,2236,1028,1208,85.1
경상남도,진주시,73세,2018,2251,1019,1232,82.7,2248,1018,1230,82.8
경상남도,진주시,74세,2018,2340,1011,1329,76.1,2335,1007,1328,75.8
경상남도,진주시,75~79세,2018,11156,4426,6730,65.8,11148,4422,6726,65.7
경상남도,진주시,75세,2018,2338,983,1355,72.5,2338,983,1355,72.5
경상남도,진주시,76세,2018,2524,1025,1499,68.4,2521,1024,1497,68.4
경상남도,진주시,77세,2018,2242,917,1325,69.2,2241,916,1325,69.1
경상남도,진주시,78세,2018,2100,791,1309,60.4,2099,790,1309,60.4
경상남도,진주시,79세,2018,1952,710,1242,57.2,1949,709,1240,57.2
경상남도,진주시,80~84세,2018,7174,2316,4858,47.7,7169,2314,4855,47.7
경상남도,진주시,80세,2018,1693,587,1106,53.1,1692,587,1105,53.1
경상남도,진주시,81세,2018,1566,545,1021,53.4,1565,545,1020,53.4
경상남도,진주시,82세,2018,1473,463,1010,45.8,1470,461,1009,45.7
경상남도,진주시,83세,2018,1318,392,926,42.3,1318,392,926,42.3
경상남도,진주시,84세,2018,1124,329,795,41.4,1124,329,795,41.4
경상남도,진주시,85세이상,2018,4767,1039,3728,27.9,4766,1039,3727,27.9
경상남도,진주시,85~89세,2018,3408,781,2627,29.7,3407,781,2626,29.7
경상남도,진주시,85세,2018,897,220,677,32.5,896,220,676,32.5
경상남도,진주시,86세,2018,835,206,629,32.8,835,206,629,32.8
경상남도,진주시,87세,2018,649,154,495,31.1,649,154,495,31.1
경상남도,진주시,88세,2018,568,102,466,21.9,568,102,466,21.9
경상남도,진주시,89세,2018,459,99,360,27.5,459,99,360,27.5
경상남도,진주시,90~94세,2018,1107,222,885,25.1,1107,222,885,25.1
경상남도,진주시,90세,2018,366,81,285,28.4,366,81,285,28.4
경상남도,진주시,91세,2018,272,52,220,23.6,272,52,220,23.6
경상남도,진주시,92세,2018,189,35,154,22.7,189,35,154,22.7
경상남도,진주시,93세,2018,185,32,153,20.9,185,32,153,20.9
경상남도,진주시,94세,2018,95,22,73,30.1,95,22,73,30.1
경상남도,진주시,95~99세,2018,226,31,195,15.9,226,31,195,15.9
경상남도,진주시,95세,2018,76,11,65,16.9,76,11,65,16.9
경상남도,진주시,96세,2018,73,11,62,17.7,73,11,62,17.7
경상남도,진주시,97세,2018,42,5,37,13.5,42,5,37,13.5
경상남도,진주시,98세,2018,25,X,23,8.7,25,X,23,8.7
경상남도,진주시,99세,2018,10,X,8,25,10,X,8,25
경상남도,진주시,100세이상,2018,26,5,21,23.8,26,5,21,23.8
경상남도,진주시,15세미만,2018,46634,24439,22195,110.1,46536,24384,22152,110.1
경상남도,진주시,15~64세,2018,253324,130473,122851,106.2,247017,126534,120483,105
경상남도,진주시,65세이상,2018,52375,21316,31059,68.6,52288,21274,31014,68.6
경상남도,진주시,평균연령,2018,41.5,39.8,43.3,,41.7,39.9,43.4,
경상남도,진주시,중위연령,2018,42.6,40.4,44.6,,43,40.9,44.9,
경상남도,창원시의창구,합계,2018,251931,128682,123249,104.4,246857,125652,121205,103.7
경상남도,창원시의창구,0~4세,2018,10117,5241,4876,107.5,10041,5209,4832,107.8
경상남도,창원시의창구,0세,2018,1677,871,806,108.1,1649,859,790,108.7
경상남도,창원시의창구,1세,2018,1918,1003,915,109.6,1903,997,906,110
경상남도,창원시의창구,2세,2018,2051,1049,1002,104.7,2038,1043,995,104.8
경상남도,창원시의창구,3세,2018,2254,1152,1102,104.5,2246,1148,1098,104.6
경상남도,창원시의창구,4세,2018,2217,1166,1051,110.9,2205,1162,1043,111.4
경상남도,창원시의창구,5~9세,2018,11166,5731,5435,105.4,11129,5709,5420,105.3
경상남도,창원시의창구,5세,2018,2167,1101,1066,103.3,2155,1095,1060,103.3
경상남도,창원시의창구,6세,2018,2392,1225,1167,105,2387,1222,1165,104.9
경상남도,창원시의창구,7세,2018,2286,1200,1086,110.5,2278,1195,1083,110.3
경상남도,창원시의창구,8세,2018,2191,1124,1067,105.3,2182,1118,1064,105.1
경상남도,창원시의창구,9세,2018,2130,1081,1049,103.1,2127,1079,1048,103
경상남도,창원시의창구,10~14세,2018,10430,5476,4954,110.5,10408,5470,4938,110.8
경상남도,창원시의창구,10세,2018,2148,1126,1022,110.2,2143,1122,1021,109.9
경상남도,창원시의창구,11세,2018,2152,1125,1027,109.5,2150,1124,1026,109.6
경상남도,창원시의창구,12세,2018,1951,1000,951,105.2,1947,1000,947,105.6
경상남도,창원시의창구,13세,2018,1961,1064,897,118.6,1957,1064,893,119.1
경상남도,창원시의창구,14세,2018,2218,1161,1057,109.8,2211,1160,1051,110.4
경상남도,창원시의창구,15~19세,2018,13758,7478,6280,119.1,13697,7455,6242,119.4
경상남도,창원시의창구,15세,2018,2233,1184,1049,112.9,2231,1183,1048,112.9
경상남도,창원시의창구,16세,2018,2389,1323,1066,124.1,2382,1319,1063,124.1
경상남도,창원시의창구,17세,2018,2786,1455,1331,109.3,2780,1454,1326,109.7
경상남도,창원시의창구,18세,2018,3253,1790,1463,122.4,3244,1786,1458,122.5
경상남도,창원시의창구,19세,2018,3097,1726,1371,125.9,3060,1713,1347,127.2
경상남도,창원시의창구,20~24세,2018,18456,10401,8055,129.1,17965,10137,7828,129.5
경상남도,창원시의창구,20세,2018,3302,1849,1453,127.3,3239,1819,1420,128.1
경상남도,창원시의창구,21세,2018,3655,2035,1620,125.6,3565,1994,1571,126.9
경상남도,창원시의창구,22세,2018,3805,2173,1632,133.1,3715,2127,1588,133.9
경상남도,창원시의창구,23세,2018,3860,2198,1662,132.3,3751,2128,1623,131.1
경상남도,창원시의창구,24세,2018,3834,2146,1688,127.1,3695,2069,1626,127.2
경상남도,창원시의창구,25~29세,2018,17488,9753,7735,126.1,16564,9139,7425,123.1
경상남도,창원시의창구,25세,2018,3764,2074,1690,122.7,3604,1979,1625,121.8
경상남도,창원시의창구,26세,2018,3720,2080,1640,126.8,3557,1970,1587,124.1
경상남도,창원시의창구,27세,2018,3527,1932,1595,121.1,3359,1811,1548,117
경상남도,창원시의창구,28세,2018,3362,1905,1457,130.7,3147,1755,1392,126.1
경상남도,창원시의창구,29세,2018,3115,1762,1353,130.2,2897,1624,1273,127.6
경상남도,창원시의창구,30~34세,2018,15933,8711,7222,120.6,14963,8059,6904,116.7
경상남도,창원시의창구,30세,2018,3045,1646,1399,117.7,2848,1520,1328,114.5
경상남도,창원시의창구,31세,2018,3044,1702,1342,126.8,2820,1557,1263,123.3
경상남도,창원시의창구,32세,2018,3083,1740,1343,129.6,2890,1606,1284,125.1
경상남도,창원시의창구,33세,2018,3384,1838,1546,118.9,3181,1703,1478,115.2
경상남도,창원시의창구,34세,2018,3377,1785,1592,112.1,3224,1673,1551,107.9
경상남도,창원시의창구,35~39세,2018,19899,10411,9488,109.7,19255,10003,9252,108.1
경상남도,창원시의창구,35세,2018,3789,1983,1806,109.8,3647,1893,1754,107.9
경상남도,창원시의창구,36세,2018,4077,2149,1928,111.5,3922,2047,1875,109.2
경상남도,창원시의창구,37세,2018,4099,2126,1973,107.8,3983,2049,1934,105.9
경상남도,창원시의창구,38세,2018,4249,2213,2036,108.7,4124,2137,1987,107.5
경상남도,창원시의창구,39세,2018,3685,1940,1745,111.2,3579,1877,1702,110.3
경상남도,창원시의창구,40~44세,2018,18043,9371,8672,108.1,17557,9068,8489,106.8
경상남도,창원시의창구,40세,2018,3572,1885,1687,111.7,3458,1815,1643,110.5
경상남도,창원시의창구,41세,2018,3429,1810,1619,111.8,3332,1749,1583,110.5
경상남도,창원시의창구,42세,2018,3481,1824,1657,110.1,3378,1760,1618,108.8
경상남도,창원시의창구,43세,2018,3582,1847,1735,106.5,3496,1789,1707,104.8
경상남도,창원시의창구,44세,2018,3979,2005,1974,101.6,3893,1955,1938,100.9
경상남도,창원시의창구,45~49세,2018,22893,11068,11825,93.6,22461,10821,11640,93
경상남도,창원시의창구,45세,2018,4277,2087,2190,95.3,4192,2043,2149,95.1
경상남도,창원시의창구,46세,2018,4213,2124,2089,101.7,4129,2072,2057,100.7
경상남도,창원시의창구,47세,2018,4626,2174,2452,88.7,4543,2124,2419,87.8
경상남도,창원시의창구,48세,2018,4776,2282,2494,91.5,4686,2228,2458,90.6
경상남도,창원시의창구,49세,2018,5001,2401,2600,92.3,4911,2354,2557,92.1
경상남도,창원시의창구,50~54세,2018,23905,11528,12377,93.1,23498,11318,12180,92.9
경상남도,창원시의창구,50세,2018,5134,2378,2756,86.3,5029,2324,2705,85.9
경상남도,창원시의창구,51세,2018,4772,2230,2542,87.7,4700,2195,2505,87.6
경상남도,창원시의창구,52세,2018,4762,2365,2397,98.7,4690,2323,2367,98.1
경상남도,창원시의창구,53세,2018,4975,2460,2515,97.8,4894,2418,2476,97.7
경상남도,창원시의창구,54세,2018,4262,2095,2167,96.7,4185,2058,2127,96.8
경상남도,창원시의창구,55~59세,2018,24291,12489,11802,105.8,24043,12366,11677,105.9
경상남도,창원시의창구,55세,2018,4736,2445,2291,106.7,4659,2406,2253,106.8
경상남도,창원시의창구,56세,2018,4991,2584,2407,107.4,4930,2553,2377,107.4
경상남도,창원시의창구,57세,2018,5209,2659,2550,104.3,5168,2644,2524,104.8
경상남도,창원시의창구,58세,2018,5080,2576,2504,102.9,5038,2554,2484,102.8
경상남도,창원시의창구,59세,2018,4275,2225,2050,108.5,4248,2209,2039,108.3
경상남도,창원시의창구,60~64세,2018,17389,8719,8670,100.6,17245,8649,8596,100.6
경상남도,창원시의창구,60세,2018,3965,2051,1914,107.2,3923,2027,1896,106.9
경상남도,창원시의창구,61세,2018,3781,1864,1917,97.2,3752,1847,1905,97
경상남도,창원시의창구,62세,2018,3485,1705,1780,95.8,3458,1694,1764,96
경상남도,창원시의창구,63세,2018,3339,1652,1687,97.9,3313,1643,1670,98.4
경상남도,창원시의창구,64세,2018,2819,1447,1372,105.5,2799,1438,1361,105.7
경상남도,창원시의창구,65~69세,2018,10463,5373,5090,105.6,10392,5338,5054,105.6
경상남도,창원시의창구,65세,2018,2422,1232,1190,103.5,2402,1223,1179,103.7
경상남도,창원시의창구,66세,2018,2524,1309,1215,107.7,2510,1303,1207,108
경상남도,창원시의창구,67세,2018,1905,963,942,102.2,1895,956,939,101.8
경상남도,창원시의창구,68세,2018,1811,941,870,108.2,1795,931,864,107.8
경상남도,창원시의창구,69세,2018,1801,928,873,106.3,1790,925,865,106.9
경상남도,창원시의창구,70~74세,2018,6554,3210,3344,96,6524,3197,3327,96.1
경상남도,창원시의창구,70세,2018,1697,858,839,102.3,1688,851,837,101.7
경상남도,창원시의창구,71세,2018,1569,773,796,97.1,1560,770,790,97.5
경상남도,창원시의창구,72세,2018,1111,557,554,100.5,1104,555,549,101.1
경상남도,창원시의창구,73세,2018,1067,507,560,90.5,1065,506,559,90.5
경상남도,창원시의창구,74세,2018,1110,515,595,86.6,1107,515,592,87
경상남도,창원시의창구,75~79세,2018,5259,2093,3166,66.1,5245,2090,3155,66.2
경상남도,창원시의창구,75세,2018,1174,510,664,76.8,1172,510,662,77
경상남도,창원시의창구,76세,2018,1210,508,702,72.4,1207,507,700,72.4
경상남도,창원시의창구,77세,2018,1008,410,598,68.6,1003,409,594,68.9
경상남도,창원시의창구,78세,2018,989,366,623,58.7,988,366,622,58.8
경상남도,창원시의창구,79세,2018,878,299,579,51.6,875,298,577,51.6
경상남도,창원시의창구,80~84세,2018,3491,1117,2374,47.1,3480,1114,2366,47.1
경상남도,창원시의창구,80세,2018,768,271,497,54.5,763,270,493,54.8
경상남도,창원시의창구,81세,2018,776,256,520,49.2,775,256,519,49.3
경상남도,창원시의창구,82세,2018,694,236,458,51.5,690,234,456,51.3
경상남도,창원시의창구,83세,2018,706,230,476,48.3,705,230,475,48.4
경상남도,창원시의창구,84세,2018,547,124,423,29.3,547,124,423,29.3
경상남도,창원시의창구,85세이상,2018,2396,512,1884,27.2,2390,510,1880,27.1
경상남도,창원시의창구,85~89세,2018,1763,400,1363,29.3,1759,399,1360,29.3
경상남도,창원시의창구,85세,2018,469,120,349,34.4,468,119,349,34.1
경상남도,창원시의창구,86세,2018,458,105,353,29.7,457,105,352,29.8
경상남도,창원시의창구,87세,2018,323,77,246,31.3,322,77,245,31.4
경상남도,창원시의창구,88세,2018,271,49,222,22.1,270,49,221,22.2
경상남도,창원시의창구,89세,2018,242,49,193,25.4,242,49,193,25.4
경상남도,창원시의창구,90~94세,2018,527,99,428,23.1,525,98,427,23
경상남도,창원시의창구,90세,2018,167,33,134,24.6,167,33,134,24.6
경상남도,창원시의창구,91세,2018,140,23,117,19.7,140,23,117,19.7
경상남도,창원시의창구,92세,2018,97,18,79,22.8,96,17,79,21.5
경상남도,창원시의창구,93세,2018,81,20,61,32.8,80,20,60,33.3
경상남도,창원시의창구,94세,2018,42,5,37,13.5,42,5,37,13.5
경상남도,창원시의창구,95~99세,2018,93,12,81,14.8,93,12,81,14.8
경상남도,창원시의창구,95세,2018,37,6,31,19.4,37,6,31,19.4
경상남도,창원시의창구,96세,2018,34,5,29,17.2,34,5,29,17.2
경상남도,창원시의창구,97세,2018,10,X,10,0,10,X,10,0
경상남도,창원시의창구,98세,2018,10,X,9,11.1,10,X,9,11.1
경상남도,창원시의창구,99세,2018,X,X,X,0,X,X,X,0
경상남도,창원시의창구,100세이상,2018,13,X,12,8.3,13,X,12,8.3
경상남도,창원시의창구,15세미만,2018,31713,16448,15265,107.7,31578,16388,15190,107.9
경상남도,창원시의창구,15~64세,2018,192055,99929,92126,108.5,187248,97015,90233,107.5
경상남도,창원시의창구,65세이상,2018,28163,12305,15858,77.6,28031,12249,15782,77.6
경상남도,창원시의창구,평균연령,2018,41,39.8,42.2,,41,39.8,42.3,
경상남도,창원시의창구,중위연령,2018,42.5,40.6,44.4,,42.8,40.9,44.6,
경상남도,창원시성산구,합계,2018,225894,117727,108167,108.8,220793,114085,106708,106.9
경상남도,창원시성산구,0~4세,2018,8821,4499,4322,104.1,8761,4467,4294,104
경상남도,창원시성산구,0세,2018,1633,839,794,105.7,1615,826,789,104.7
경상남도,창원시성산구,1세,2018,1580,811,769,105.5,1571,807,764,105.6
경상남도,창원시성산구,2세,2018,1827,923,904,102.1,1816,918,898,102.2
경상남도,창원시성산구,3세,2018,1886,964,922,104.6,1879,962,917,104.9
경상남도,창원시성산구,4세,2018,1895,962,933,103.1,1880,954,926,103
경상남도,창원시성산구,5~9세,2018,10291,5320,4971,107,10268,5311,4957,107.1
경상남도,창원시성산구,5세,2018,1914,986,928,106.3,1909,983,926,106.2
경상남도,창원시성산구,6세,2018,2188,1120,1068,104.9,2182,1118,1064,105.1
경상남도,창원시성산구,7세,2018,2095,1079,1016,106.2,2094,1079,1015,106.3
경상남도,창원시성산구,8세,2018,2043,1050,993,105.7,2040,1049,991,105.9
경상남도,창원시성산구,9세,2018,2051,1085,966,112.3,2043,1082,961,112.6
경상남도,창원시성산구,10~14세,2018,11336,5978,5358,111.6,11317,5968,5349,111.6
경상남도,창원시성산구,10세,2018,2219,1125,1094,102.8,2214,1121,1093,102.6
경상남도,창원시성산구,11세,2018,2308,1250,1058,118.1,2305,1248,1057,118.1
경상남도,창원시성산구,12세,2018,2179,1176,1003,117.2,2176,1175,1001,117.4
경상남도,창원시성산구,13세,2018,2208,1152,1056,109.1,2206,1151,1055,109.1
경상남도,창원시성산구,14세,2018,2422,1275,1147,111.2,2416,1273,1143,111.4
경상남도,창원시성산구,15~19세,2018,13842,7756,6086,127.4,13803,7734,6069,127.4
경상남도,창원시성산구,15세,2018,2572,1407,1165,120.8,2567,1404,1163,120.7
경상남도,창원시성산구,16세,2018,2610,1366,1244,109.8,2608,1366,1242,110
경상남도,창원시성산구,17세,2018,3152,1706,1446,118,3148,1703,1445,117.9
경상남도,창원시성산구,18세,2018,3273,1919,1354,141.7,3266,1915,1351,141.7
경상남도,창원시성산구,19세,2018,2235,1358,877,154.8,2214,1346,868,155.1
경상남도,창원시성산구,20~24세,2018,15851,9249,6602,140.1,15446,8959,6487,138.1
경상남도,창원시성산구,20세,2018,2725,1709,1016,168.2,2682,1684,998,168.7
경상남도,창원시성산구,21세,2018,3006,1850,1156,160,2955,1812,1143,158.5
경상남도,창원시성산구,22세,2018,3359,1968,1391,141.5,3271,1902,1369,138.9
경상남도,창원시성산구,23세,2018,3364,1835,1529,120,3247,1749,1498,116.8
경상남도,창원시성산구,24세,2018,3397,1887,1510,125,3291,1812,1479,122.5
경상남도,창원시성산구,25~29세,2018,18230,10297,7933,129.8,17077,9404,7673,122.6
경상남도,창원시성산구,25세,2018,3534,1955,1579,123.8,3376,1838,1538,119.5
경상남도,창원시성산구,26세,2018,3738,2083,1655,125.9,3483,1884,1599,117.8
경상남도,창원시성산구,27세,2018,3712,2057,1655,124.3,3485,1885,1600,117.8
경상남도,창원시성산구,28세,2018,3651,2116,1535,137.9,3402,1918,1484,129.2
경상남도,창원시성산구,29세,2018,3595,2086,1509,138.2,3331,1879,1452,129.4
경상남도,창원시성산구,30~34세,2018,16945,9877,7068,139.7,15734,8906,6828,130.4
경상남도,창원시성산구,30세,2018,3498,2049,1449,141.4,3246,1840,1406,130.9
경상남도,창원시성산구,31세,2018,3517,2073,1444,143.6,3246,1861,1385,134.4
경상남도,창원시성산구,32세,2018,3370,1981,1389,142.6,3123,1792,1331,134.6
경상남도,창원시성산구,33세,2018,3344,1966,1378,142.7,3095,1765,1330,132.7
경상남도,창원시성산구,34세,2018,3216,1808,1408,128.4,3024,1648,1376,119.8
경상남도,창원시성산구,35~39세,2018,17515,9125,8390,108.8,16769,8555,8214,104.2
경상남도,창원시성산구,35세,2018,3474,1900,1574,120.7,3275,1746,1529,114.2
경상남도,창원시성산구,36세,2018,3511,1831,1680,109,3346,1706,1640,104
경상남도,창원시성산구,37세,2018,3503,1824,1679,108.6,3358,1721,1637,105.1
경상남도,창원시성산구,38세,2018,3585,1819,1766,103,3467,1727,1740,99.3
경상남도,창원시성산구,39세,2018,3442,1751,1691,103.5,3323,1655,1668,99.2
경상남도,창원시성산구,40~44세,2018,17342,8372,8970,93.3,16917,8084,8833,91.5
경상남도,창원시성산구,40세,2018,3234,1650,1584,104.2,3126,1575,1551,101.5
경상남도,창원시성산구,41세,2018,3334,1652,1682,98.2,3236,1582,1654,95.6
경상남도,창원시성산구,42세,2018,3303,1596,1707,93.5,3236,1554,1682,92.4
경상남도,창원시성산구,43세,2018,3483,1615,1868,86.5,3406,1566,1840,85.1
경상남도,창원시성산구,44세,2018,3988,1859,2129,87.3,3913,1807,2106,85.8
경상남도,창원시성산구,45~49세,2018,23122,10937,12185,89.8,22746,10699,12047,88.8
경상남도,창원시성산구,45세,2018,4194,1956,2238,87.4,4128,1909,2219,86
경상남도,창원시성산구,46세,2018,4343,2088,2255,92.6,4265,2035,2230,91.3
경상남도,창원시성산구,47세,2018,4784,2277,2507,90.8,4712,2235,2477,90.2
경상남도,창원시성산구,48세,2018,4921,2339,2582,90.6,4834,2287,2547,89.8
경상남도,창원시성산구,49세,2018,4880,2277,2603,87.5,4807,2233,2574,86.8
경상남도,창원시성산구,50~54세,2018,22990,11081,11909,93,22725,10935,11790,92.7
경상남도,창원시성산구,50세,2018,4956,2291,2665,86,4905,2264,2641,85.7
경상남도,창원시성산구,51세,2018,4574,2142,2432,88.1,4519,2105,2414,87.2
경상남도,창원시성산구,52세,2018,4583,2297,2286,100.5,4524,2266,2258,100.4
경상남도,창원시성산구,53세,2018,4765,2324,2441,95.2,4716,2297,2419,95
경상남도,창원시성산구,54세,2018,4112,2027,2085,97.2,4061,2003,2058,97.3
경상남도,창원시성산구,55~59세,2018,22038,11660,10378,112.4,21837,11572,10265,112.7
경상남도,창원시성산구,55세,2018,4559,2359,2200,107.2,4499,2329,2170,107.3
경상남도,창원시성산구,56세,2018,4577,2368,2209,107.2,4534,2349,2185,107.5
경상남도,창원시성산구,57세,2018,4779,2456,2323,105.7,4743,2444,2299,106.3
경상남도,창원시성산구,58세,2018,4517,2443,2074,117.8,4485,2430,2055,118.2
경상남도,창원시성산구,59세,2018,3606,2034,1572,129.4,3576,2020,1556,129.8
경상남도,창원시성산구,60~64세,2018,12415,6691,5724,116.9,12310,6642,5668,117.2
경상남도,창원시성산구,60세,2018,3194,1817,1377,132,3168,1803,1365,132.1
경상남도,창원시성산구,61세,2018,2709,1477,1232,119.9,2686,1464,1222,119.8
경상남도,창원시성산구,62세,2018,2414,1238,1176,105.3,2394,1230,1164,105.7
경상남도,창원시성산구,63세,2018,2337,1195,1142,104.6,2313,1185,1128,105.1
경상남도,창원시성산구,64세,2018,1761,964,797,121,1749,960,789,121.7
경상남도,창원시성산구,65~69세,2018,6396,3431,2965,115.7,6355,3408,2947,115.6
경상남도,창원시성산구,65세,2018,1603,880,723,121.7,1587,871,716,121.6
경상남도,창원시성산구,66세,2018,1503,833,670,124.3,1496,829,667,124.3
경상남도,창원시성산구,67세,2018,1209,630,579,108.8,1201,625,576,108.5
경상남도,창원시성산구,68세,2018,1054,584,470,124.3,1047,581,466,124.7
경상남도,창원시성산구,69세,2018,1027,504,523,96.4,1024,502,522,96.2
경상남도,창원시성산구,70~74세,2018,3496,1714,1782,96.2,3478,1707,1771,96.4
경상남도,창원시성산구,70세,2018,945,469,476,98.5,943,469,474,98.9
경상남도,창원시성산구,71세,2018,894,471,423,111.3,888,468,420,111.4
경상남도,창원시성산구,72세,2018,578,288,290,99.3,573,286,287,99.7
경상남도,창원시성산구,73세,2018,535,257,278,92.4,532,256,276,92.8
경상남도,창원시성산구,74세,2018,544,229,315,72.7,542,228,314,72.6
경상남도,창원시성산구,75~79세,2018,2581,987,1594,61.9,2575,985,1590,61.9
경상남도,창원시성산구,75세,2018,546,230,316,72.8,545,230,315,73
경상남도,창원시성산구,76세,2018,601,247,354,69.8,597,246,351,70.1
경상남도,창원시성산구,77세,2018,495,195,300,65,494,194,300,64.7
경상남도,창원시성산구,78세,2018,468,160,308,51.9,468,160,308,51.9
경상남도,창원시성산구,79세,2018,471,155,316,49.1,471,155,316,49.1
경상남도,창원시성산구,80~84세,2018,1666,521,1145,45.5,1662,518,1144,45.3
경상남도,창원시성산구,80세,2018,400,149,251,59.4,398,148,250,59.2
경상남도,창원시성산구,81세,2018,341,106,235,45.1,341,106,235,45.1
경상남도,창원시성산구,82세,2018,337,98,239,41,337,98,239,41
경상남도,창원시성산구,83세,2018,323,97,226,42.9,322,96,226,42.5
경상남도,창원시성산구,84세,2018,265,71,194,36.6,264,70,194,36.1
경상남도,창원시성산구,85세이상,2018,1017,232,785,29.6,1013,231,782,29.5
경상남도,창원시성산구,85~89세,2018,773,180,593,30.4,770,179,591,30.3
경상남도,창원시성산구,85세,2018,223,67,156,42.9,222,67,155,43.2
경상남도,창원시성산구,86세,2018,178,35,143,24.5,178,35,143,24.5
경상남도,창원시성산구,87세,2018,131,28,103,27.2,131,28,103,27.2
경상남도,창원시성산구,88세,2018,134,21,113,18.6,133,21,112,18.8
경상남도,창원시성산구,89세,2018,107,29,78,37.2,106,28,78,35.9
경상남도,창원시성산구,90~94세,2018,208,48,160,30,207,48,159,30.2
경상남도,창원시성산구,90세,2018,67,14,53,26.4,66,14,52,26.9
경상남도,창원시성산구,91세,2018,51,16,35,45.7,51,16,35,45.7
경상남도,창원시성산구,92세,2018,35,5,30,16.7,35,5,30,16.7
경상남도,창원시성산구,93세,2018,33,9,24,37.5,33,9,24,37.5
경상남도,창원시성산구,94세,2018,22,X,18,22.2,22,X,18,22.2
경상남도,창원시성산구,95~99세,2018,31,X,27,14.8,31,X,27,14.8
경상남도,창원시성산구,95세,2018,11,X,8,37.5,11,X,8,37.5
경상남도,창원시성산구,96세,2018,11,X,11,0,11,X,11,0
경상남도,창원시성산구,97세,2018,X,X,X,0,X,X,X,0
경상남도,창원시성산구,98세,2018,X,X,X,0,X,X,X,0
경상남도,창원시성산구,99세,2018,5,X,X,25,5,X,X,25
경상남도,창원시성산구,100세이상,2018,5,X,5,0,5,X,5,0
경상남도,창원시성산구,15세미만,2018,30448,15797,14651,107.8,30346,15746,14600,107.8
경상남도,창원시성산구,15~64세,2018,180290,95045,85245,111.5,175364,91490,83874,109.1
경상남도,창원시성산구,65세이상,2018,15156,6885,8271,83.2,15083,6849,8234,83.2
경상남도,창원시성산구,평균연령,2018,38.7,37.8,39.6,,38.8,37.9,39.7,
경상남도,창원시성산구,중위연령,2018,40,38.2,42.1,,40.4,38.6,42.2,
경상남도,창원시마산합포구,합계,2018,178431,89077,89354,99.7,175558,87351,88207,99
경상남도,창원시마산합포구,0~4세,2018,6476,3369,3107,108.4,6459,3364,3095,108.7
경상남도,창원시마산합포구,0세,2018,1060,533,527,101.1,1059,532,527,100.9
경상남도,창원시마산합포구,1세,2018,1178,621,557,111.5,1173,621,552,112.5
경상남도,창원시마산합포구,2세,2018,1361,728,633,115,1358,726,632,114.9
경상남도,창원시마산합포구,3세,2018,1446,738,708,104.2,1442,738,704,104.8
경상남도,창원시마산합포구,4세,2018,1431,749,682,109.8,1427,747,680,109.9
경상남도,창원시마산합포구,5~9세,2018,7318,3769,3549,106.2,7312,3767,3545,106.3
경상남도,창원시마산합포구,5세,2018,1510,776,734,105.7,1509,776,733,105.9
경상남도,창원시마산합포구,6세,2018,1571,814,757,107.5,1568,813,755,107.7
경상남도,창원시마산합포구,7세,2018,1524,769,755,101.9,1524,769,755,101.9
경상남도,창원시마산합포구,8세,2018,1352,690,662,104.2,1352,690,662,104.2
경상남도,창원시마산합포구,9세,2018,1361,720,641,112.3,1359,719,640,112.3
경상남도,창원시마산합포구,10~14세,2018,6553,3358,3195,105.1,6542,3354,3188,105.2
경상남도,창원시마산합포구,10세,2018,1327,680,647,105.1,1325,680,645,105.4
경상남도,창원시마산합포구,11세,2018,1412,720,692,104,1410,719,691,104.1
경상남도,창원시마산합포구,12세,2018,1260,629,631,99.7,1257,627,630,99.5
경상남도,창원시마산합포구,13세,2018,1199,634,565,112.2,1198,634,564,112.4
경상남도,창원시마산합포구,14세,2018,1355,695,660,105.3,1352,694,658,105.5
경상남도,창원시마산합포구,15~19세,2018,8785,4597,4188,109.8,8684,4540,4144,109.6
경상남도,창원시마산합포구,15세,2018,1378,731,647,113,1376,730,646,113
경상남도,창원시마산합포구,16세,2018,1497,729,768,94.9,1494,728,766,95
경상남도,창원시마산합포구,17세,2018,1718,883,835,105.7,1706,879,827,106.3
경상남도,창원시마산합포구,18세,2018,2026,1051,975,107.8,1992,1037,955,108.6
경상남도,창원시마산합포구,19세,2018,2166,1203,963,124.9,2116,1166,950,122.7
경상남도,창원시마산합포구,20~24세,2018,11084,6240,4844,128.8,10651,6021,4630,130
경상남도,창원시마산합포구,20세,2018,2158,1209,949,127.4,2080,1172,908,129.1
경상남도,창원시마산합포구,21세,2018,2199,1219,980,124.4,2120,1184,936,126.5
경상남도,창원시마산합포구,22세,2018,2248,1273,975,130.6,2162,1234,928,133
경상남도,창원시마산합포구,23세,2018,2251,1259,992,126.9,2149,1209,940,128.6
경상남도,창원시마산합포구,24세,2018,2228,1280,948,135,2140,1222,918,133.1
경상남도,창원시마산합포구,25~29세,2018,9841,5502,4339,126.8,9311,5164,4147,124.5
경상남도,창원시마산합포구,25세,2018,2055,1171,884,132.5,1962,1110,852,130.3
경상남도,창원시마산합포구,26세,2018,2071,1135,936,121.3,1989,1089,900,121
경상남도,창원시마산합포구,27세,2018,1946,1094,852,128.4,1823,1013,810,125.1
경상남도,창원시마산합포구,28세,2018,1877,1044,833,125.3,1758,971,787,123.4
경상남도,창원시마산합포구,29세,2018,1892,1058,834,126.9,1779,981,798,122.9
경상남도,창원시마산합포구,30~34세,2018,9990,5429,4561,119,9485,5082,4403,115.4
경상남도,창원시마산합포구,30세,2018,1829,1012,817,123.9,1724,945,779,121.3
경상남도,창원시마산합포구,31세,2018,1875,987,888,111.1,1774,919,855,107.5
경상남도,창원시마산합포구,32세,2018,1985,1089,896,121.5,1876,1017,859,118.4
경상남도,창원시마산합포구,33세,2018,2102,1145,957,119.6,1998,1067,931,114.6
경상남도,창원시마산합포구,34세,2018,2199,1196,1003,119.2,2113,1134,979,115.8
경상남도,창원시마산합포구,35~39세,2018,13668,7221,6447,112,13319,6994,6325,110.6
경상남도,창원시마산합포구,35세,2018,2456,1279,1177,108.7,2370,1220,1150,106.1
경상남도,창원시마산합포구,36세,2018,2804,1462,1342,108.9,2732,1419,1313,108.1
경상남도,창원시마산합포구,37세,2018,2869,1592,1277,124.7,2792,1541,1251,123.2
경상남도,창원시마산합포구,38세,2018,2857,1468,1389,105.7,2792,1423,1369,103.9
경상남도,창원시마산합포구,39세,2018,2682,1420,1262,112.5,2633,1391,1242,112
경상남도,창원시마산합포구,40~44세,2018,11929,6429,5500,116.9,11668,6249,5419,115.3
경상남도,창원시마산합포구,40세,2018,2402,1307,1095,119.4,2347,1265,1082,116.9
경상남도,창원시마산합포구,41세,2018,2347,1307,1040,125.7,2285,1266,1019,124.2
경상남도,창원시마산합포구,42세,2018,2213,1192,1021,116.7,2167,1159,1008,115
경상남도,창원시마산합포구,43세,2018,2422,1283,1139,112.6,2370,1248,1122,111.2
경상남도,창원시마산합포구,44세,2018,2545,1340,1205,111.2,2499,1311,1188,110.4
경상남도,창원시마산합포구,45~49세,2018,13806,7061,6745,104.7,13587,6933,6654,104.2
경상남도,창원시마산합포구,45세,2018,2699,1417,1282,110.5,2656,1391,1265,110
경상남도,창원시마산합포구,46세,2018,2501,1316,1185,111.1,2454,1284,1170,109.7
경상남도,창원시마산합포구,47세,2018,2834,1399,1435,97.5,2789,1369,1420,96.4
경상남도,창원시마산합포구,48세,2018,2841,1456,1385,105.1,2794,1434,1360,105.4
경상남도,창원시마산합포구,49세,2018,2931,1473,1458,101,2894,1455,1439,101.1
경상남도,창원시마산합포구,50~54세,2018,13851,6883,6968,98.8,13669,6792,6877,98.8
경상남도,창원시마산합포구,50세,2018,2970,1441,1529,94.2,2925,1414,1511,93.6
경상남도,창원시마산합포구,51세,2018,2707,1369,1338,102.3,2677,1353,1324,102.2
경상남도,창원시마산합포구,52세,2018,2714,1389,1325,104.8,2676,1371,1305,105.1
경상남도,창원시마산합포구,53세,2018,2891,1414,1477,95.7,2857,1396,1461,95.6
경상남도,창원시마산합포구,54세,2018,2569,1270,1299,97.8,2534,1258,1276,98.6
경상남도,창원시마산합포구,55~59세,2018,16568,7839,8729,89.8,16446,7778,8668,89.7
경상남도,창원시마산합포구,55세,2018,2852,1382,1470,94,2810,1364,1446,94.3
경상남도,창원시마산합포구,56세,2018,3200,1553,1647,94.3,3172,1538,1634,94.1
경상남도,창원시마산합포구,57세,2018,3555,1656,1899,87.2,3538,1647,1891,87.1
경상남도,창원시마산합포구,58세,2018,3560,1668,1892,88.2,3536,1654,1882,87.9
경상남도,창원시마산합포구,59세,2018,3401,1580,1821,86.8,3390,1575,1815,86.8
경상남도,창원시마산합포구,60~64세,2018,15550,7438,8112,91.7,15473,7400,8073,91.7
경상남도,창원시마산합포구,60세,2018,3178,1522,1656,91.9,3164,1512,1652,91.5
경상남도,창원시마산합포구,61세,2018,3185,1532,1653,92.7,3163,1522,1641,92.7
경상남도,창원시마산합포구,62세,2018,3139,1466,1673,87.6,3126,1461,1665,87.7
경상남도,창원시마산합포구,63세,2018,3307,1559,1748,89.2,3294,1552,1742,89.1
경상남도,창원시마산합포구,64세,2018,2741,1359,1382,98.3,2726,1353,1373,98.5
경상남도,창원시마산합포구,65~69세,2018,11230,5359,5871,91.3,11195,5342,5853,91.3
경상남도,창원시마산합포구,65세,2018,2374,1123,1251,89.8,2361,1118,1243,89.9
경상남도,창원시마산합포구,66세,2018,2597,1236,1361,90.8,2589,1232,1357,90.8
경상남도,창원시마산합포구,67세,2018,1975,931,1044,89.2,1971,929,1042,89.2
경상남도,창원시마산합포구,68세,2018,2128,1012,1116,90.7,2122,1009,1113,90.7
경상남도,창원시마산합포구,69세,2018,2156,1057,1099,96.2,2152,1054,1098,96
경상남도,창원시마산합포구,70~74세,2018,8204,3738,4466,83.7,8188,3731,4457,83.7
경상남도,창원시마산합포구,70세,2018,1994,949,1045,90.8,1993,949,1044,90.9
경상남도,창원시마산합포구,71세,2018,1898,852,1046,81.5,1893,851,1042,81.7
경상남도,창원시마산합포구,72세,2018,1381,631,750,84.1,1380,631,749,84.2
경상남도,창원시마산합포구,73세,2018,1441,645,796,81,1434,641,793,80.8
경상남도,창원시마산합포구,74세,2018,1490,661,829,79.7,1488,659,829,79.5
경상남도,창원시마산합포구,75~79세,2018,6673,2760,3913,70.5,6668,2757,3911,70.5
경상남도,창원시마산합포구,75세,2018,1434,601,833,72.1,1433,601,832,72.2
경상남도,창원시마산합포구,76세,2018,1536,684,852,80.3,1536,684,852,80.3
경상남도,창원시마산합포구,77세,2018,1409,582,827,70.4,1409,582,827,70.4
경상남도,창원시마산합포구,78세,2018,1185,477,708,67.4,1182,474,708,66.9
경상남도,창원시마산합포구,79세,2018,1109,416,693,60,1108,416,692,60.1
경상남도,창원시마산합포구,80~84세,2018,4141,1430,2711,52.7,4139,1429,2710,52.7
경상남도,창원시마산합포구,80세,2018,957,361,596,60.6,956,361,595,60.7
경상남도,창원시마산합포구,81세,2018,953,330,623,53,953,330,623,53
경상남도,창원시마산합포구,82세,2018,853,285,568,50.2,853,285,568,50.2
경상남도,창원시마산합포구,83세,2018,707,237,470,50.4,707,237,470,50.4
경상남도,창원시마산합포구,84세,2018,671,217,454,47.8,670,216,454,47.6
경상남도,창원시마산합포구,85세이상,2018,2764,655,2109,31.1,2762,654,2108,31
경상남도,창원시마산합포구,85~89세,2018,2042,517,1525,33.9,2042,517,1525,33.9
경상남도,창원시마산합포구,85세,2018,506,135,371,36.4,506,135,371,36.4
경상남도,창원시마산합포구,86세,2018,511,147,364,40.4,511,147,364,40.4
경상남도,창원시마산합포구,87세,2018,386,86,300,28.7,386,86,300,28.7
경상남도,창원시마산합포구,88세,2018,355,74,281,26.3,355,74,281,26.3
경상남도,창원시마산합포구,89세,2018,284,75,209,35.9,284,75,209,35.9
경상남도,창원시마산합포구,90~94세,2018,581,117,464,25.2,580,117,463,25.3
경상남도,창원시마산합포구,90세,2018,193,37,156,23.7,193,37,156,23.7
경상남도,창원시마산합포구,91세,2018,143,36,107,33.6,143,36,107,33.6
경상남도,창원시마산합포구,92세,2018,112,25,87,28.7,112,25,87,28.7
경상남도,창원시마산합포구,93세,2018,82,8,74,10.8,81,8,73,11
경상남도,창원시마산합포구,94세,2018,51,11,40,27.5,51,11,40,27.5
경상남도,창원시마산합포구,95~99세,2018,131,21,110,19.1,130,20,110,18.2
경상남도,창원시마산합포구,95세,2018,57,6,51,11.8,57,6,51,11.8
경상남도,창원시마산합포구,96세,2018,34,8,26,30.8,34,8,26,30.8
경상남도,창원시마산합포구,97세,2018,23,X,19,21.1,22,X,19,15.8
경상남도,창원시마산합포구,98세,2018,12,X,11,9.1,12,X,11,9.1
경상남도,창원시마산합포구,99세,2018,5,X,X,66.7,5,X,X,66.7
경상남도,창원시마산합포구,100세이상,2018,10,X,10,0,10,X,10,0
경상남도,창원시마산합포구,15세미만,2018,20347,10496,9851,106.5,20313,10485,9828,106.7
경상남도,창원시마산합포구,15~64세,2018,125072,64639,60433,107,122293,62953,59340,106.1
경상남도,창원시마산합포구,65세이상,2018,33012,13942,19070,73.1,32952,13913,19039,73.1
경상남도,창원시마산합포구,평균연령,2018,44.5,42.7,46.2,,44.6,42.9,46.3,
경상남도,창원시마산합포구,중위연령,2018,46.3,44,48.8,,46.7,44.3,49,
경상남도,창원시마산회원구,합계,2018,197683,99217,98466,100.8,194913,97603,97310,100.3
경상남도,창원시마산회원구,0~4세,2018,6610,3430,3180,107.9,6587,3415,3172,107.7
경상남도,창원시마산회원구,0세,2018,1002,501,501,100,998,498,500,99.6
경상남도,창원시마산회원구,1세,2018,1175,605,570,106.1,1169,602,567,106.2
경상남도,창원시마산회원구,2세,2018,1360,691,669,103.3,1353,686,667,102.8
경상남도,창원시마산회원구,3세,2018,1531,800,731,109.4,1527,797,730,109.2
경상남도,창원시마산회원구,4세,2018,1542,833,709,117.5,1540,832,708,117.5
경상남도,창원시마산회원구,5~9세,2018,8712,4579,4133,110.8,8700,4573,4127,110.8
경상남도,창원시마산회원구,5세,2018,1599,814,785,103.7,1597,813,784,103.7
경상남도,창원시마산회원구,6세,2018,1839,972,867,112.1,1834,969,865,112
경상남도,창원시마산회원구,7세,2018,1804,960,844,113.7,1803,959,844,113.6
경상남도,창원시마산회원구,8세,2018,1757,902,855,105.5,1755,901,854,105.5
경상남도,창원시마산회원구,9세,2018,1713,931,782,119.1,1711,931,780,119.4
경상남도,창원시마산회원구,10~14세,2018,9206,4757,4449,106.9,9198,4752,4446,106.9
경상남도,창원시마산회원구,10세,2018,1836,936,900,104,1833,934,899,103.9
경상남도,창원시마산회원구,11세,2018,1916,1029,887,116,1914,1028,886,116
경상남도,창원시마산회원구,12세,2018,1772,935,837,111.7,1769,933,836,111.6
경상남도,창원시마산회원구,13세,2018,1763,875,888,98.5,1763,875,888,98.5
경상남도,창원시마산회원구,14세,2018,1919,982,937,104.8,1919,982,937,104.8
경상남도,창원시마산회원구,15~19세,2018,10791,5699,5092,111.9,10752,5674,5078,111.7
경상남도,창원시마산회원구,15세,2018,1959,1071,888,120.6,1958,1070,888,120.5
경상남도,창원시마산회원구,16세,2018,1877,1000,877,114,1873,997,876,113.8
경상남도,창원시마산회원구,17세,2018,2129,1158,971,119.3,2126,1156,970,119.2
경상남도,창원시마산회원구,18세,2018,2432,1263,1169,108,2414,1253,1161,107.9
경상남도,창원시마산회원구,19세,2018,2394,1207,1187,101.7,2381,1198,1183,101.3
경상남도,창원시마산회원구,20~24세,2018,12376,6617,5759,114.9,12114,6489,5625,115.4
경상남도,창원시마산회원구,20세,2018,2428,1262,1166,108.2,2405,1251,1154,108.4
경상남도,창원시마산회원구,21세,2018,2661,1426,1235,115.5,2625,1408,1217,115.7
경상남도,창원시마산회원구,22세,2018,2454,1354,1100,123.1,2394,1321,1073,123.1
경상남도,창원시마산회원구,23세,2018,2405,1289,1116,115.5,2328,1251,1077,116.2
경상남도,창원시마산회원구,24세,2018,2428,1286,1142,112.6,2362,1258,1104,113.9
경상남도,창원시마산회원구,25~29세,2018,11438,6291,5147,122.2,10906,5937,4969,119.5
경상남도,창원시마산회원구,25세,2018,2467,1338,1129,118.5,2388,1286,1102,116.7
경상남도,창원시마산회원구,26세,2018,2394,1313,1081,121.5,2313,1264,1049,120.5
경상남도,창원시마산회원구,27세,2018,2219,1223,996,122.8,2106,1146,960,119.4
경상남도,창원시마산회원구,28세,2018,2231,1240,991,125.1,2101,1152,949,121.4
경상남도,창원시마산회원구,29세,2018,2127,1177,950,123.9,1998,1089,909,119.8
경상남도,창원시마산회원구,30~34세,2018,10667,5686,4981,114.2,10079,5318,4761,111.7
경상남도,창원시마산회원구,30세,2018,2062,1112,950,117.1,1944,1040,904,115
경상남도,창원시마산회원구,31세,2018,2117,1125,992,113.4,1973,1030,943,109.2
경상남도,창원시마산회원구,32세,2018,2034,1086,948,114.6,1913,1005,908,110.7
경상남도,창원시마산회원구,33세,2018,2091,1099,992,110.8,1988,1034,954,108.4
경상남도,창원시마산회원구,34세,2018,2363,1264,1099,115,2261,1209,1052,114.9
경상남도,창원시마산회원구,35~39세,2018,14641,7671,6970,110.1,14324,7489,6835,109.6
경상남도,창원시마산회원구,35세,2018,2591,1389,1202,115.6,2518,1345,1173,114.7
경상남도,창원시마산회원구,36세,2018,2957,1529,1428,107.1,2884,1494,1390,107.5
경상남도,창원시마산회원구,37세,2018,2987,1564,1423,109.9,2919,1524,1395,109.2
경상남도,창원시마산회원구,38세,2018,3109,1601,1508,106.2,3063,1571,1492,105.3
경상남도,창원시마산회원구,39세,2018,2997,1588,1409,112.7,2940,1555,1385,112.3
경상남도,창원시마산회원구,40~44세,2018,14938,7604,7334,103.7,14729,7479,7250,103.2
경상남도,창원시마산회원구,40세,2018,2881,1480,1401,105.6,2836,1455,1381,105.4
경상남도,창원시마산회원구,41세,2018,2929,1469,1460,100.6,2889,1445,1444,100.1
경상남도,창원시마산회원구,42세,2018,2775,1437,1338,107.4,2725,1404,1321,106.3
경상남도,창원시마산회원구,43세,2018,3045,1512,1533,98.6,3006,1488,1518,98
경상남도,창원시마산회원구,44세,2018,3308,1706,1602,106.5,3273,1687,1586,106.4
경상남도,창원시마산회원구,45~49세,2018,17440,8837,8603,102.7,17202,8693,8509,102.2
경상남도,창원시마산회원구,45세,2018,3392,1741,1651,105.5,3349,1715,1634,105
경상남도,창원시마산회원구,46세,2018,3206,1640,1566,104.7,3157,1609,1548,103.9
경상남도,창원시마산회원구,47세,2018,3576,1775,1801,98.6,3512,1735,1777,97.6
경상남도,창원시마산회원구,48세,2018,3553,1784,1769,100.8,3510,1758,1752,100.3
경상남도,창원시마산회원구,49세,2018,3713,1897,1816,104.5,3674,1876,1798,104.3
경상남도,창원시마산회원구,50~54세,2018,16965,8409,8556,98.3,16764,8300,8464,98.1
경상남도,창원시마산회원구,50세,2018,3711,1827,1884,97,3673,1805,1868,96.6
경상남도,창원시마산회원구,51세,2018,3425,1684,1741,96.7,3386,1662,1724,96.4
경상남도,창원시마산회원구,52세,2018,3469,1784,1685,105.9,3420,1765,1655,106.6
경상남도,창원시마산회원구,53세,2018,3354,1618,1736,93.2,3318,1595,1723,92.6
경상남도,창원시마산회원구,54세,2018,3006,1496,1510,99.1,2967,1473,1494,98.6
경상남도,창원시마산회원구,55~59세,2018,18589,9156,9433,97.1,18422,9073,9349,97
경상남도,창원시마산회원구,55세,2018,3377,1686,1691,99.7,3332,1667,1665,100.1
경상남도,창원시마산회원구,56세,2018,3831,1894,1937,97.8,3793,1872,1921,97.4
경상남도,창원시마산회원구,57세,2018,3968,2006,1962,102.2,3946,1993,1953,102
경상남도,창원시마산회원구,58세,2018,3946,1888,2058,91.7,3914,1874,2040,91.9
경상남도,창원시마산회원구,59세,2018,3467,1682,1785,94.2,3437,1667,1770,94.2
경상남도,창원시마산회원구,60~64세,2018,15828,7607,8221,92.5,15728,7563,8165,92.6
경상남도,창원시마산회원구,60세,2018,3319,1603,1716,93.4,3293,1593,1700,93.7
경상남도,창원시마산회원구,61세,2018,3385,1622,1763,92,3367,1610,1757,91.6
경상남도,창원시마산회원구,62세,2018,3113,1487,1626,91.5,3087,1475,1612,91.5
경상남도,창원시마산회원구,63세,2018,3288,1558,1730,90.1,3277,1556,1721,90.4
경상남도,창원시마산회원구,64세,2018,2723,1337,1386,96.5,2704,1329,1375,96.7
경상남도,창원시마산회원구,65~69세,2018,11092,5254,5838,90,11053,5237,5816,90
경상남도,창원시마산회원구,65세,2018,2407,1167,1240,94.1,2394,1161,1233,94.2
경상남도,창원시마산회원구,66세,2018,2604,1284,1320,97.3,2594,1280,1314,97.4
경상남도,창원시마산회원구,67세,2018,2045,944,1101,85.7,2038,942,1096,85.9
경상남도,창원시마산회원구,68세,2018,1986,885,1101,80.4,1981,881,1100,80.1
경상남도,창원시마산회원구,69세,2018,2050,974,1076,90.5,2046,973,1073,90.7
경상남도,창원시마산회원구,70~74세,2018,7630,3662,3968,92.3,7612,3657,3955,92.5
경상남도,창원시마산회원구,70세,2018,1981,969,1012,95.8,1978,969,1009,96
경상남도,창원시마산회원구,71세,2018,1763,854,909,93.9,1759,853,906,94.2
경상남도,창원시마산회원구,72세,2018,1265,632,633,99.8,1260,629,631,99.7
경상남도,창원시마산회원구,73세,2018,1242,575,667,86.2,1240,575,665,86.5
경상남도,창원시마산회원구,74세,2018,1379,632,747,84.6,1375,631,744,84.8
경상남도,창원시마산회원구,75~79세,2018,5649,2427,3222,75.3,5640,2425,3215,75.4
경상남도,창원시마산회원구,75세,2018,1268,564,704,80.1,1266,563,703,80.1
경상남도,창원시마산회원구,76세,2018,1269,566,703,80.5,1269,566,703,80.5
경상남도,창원시마산회원구,77세,2018,1166,497,669,74.3,1164,497,667,74.5
경상남도,창원시마산회원구,78세,2018,1003,415,588,70.6,999,414,585,70.8
경상남도,창원시마산회원구,79세,2018,943,385,558,69,942,385,557,69.1
경상남도,창원시마산회원구,80~84세,2018,3212,1118,2094,53.4,3204,1116,2088,53.4
경상남도,창원시마산회원구,80세,2018,791,307,484,63.4,788,307,481,63.8
경상남도,창원시마산회원구,81세,2018,682,253,429,59,681,253,428,59.1
경상남도,창원시마산회원구,82세,2018,661,224,437,51.3,659,223,436,51.1
경상남도,창원시마산회원구,83세,2018,596,188,408,46.1,594,187,407,45.9
경상남도,창원시마산회원구,84세,2018,482,146,336,43.5,482,146,336,43.5
경상남도,창원시마산회원구,85세이상,2018,1899,413,1486,27.8,1899,413,1486,27.8
경상남도,창원시마산회원구,85~89세,2018,1403,321,1082,29.7,1403,321,1082,29.7
경상남도,창원시마산회원구,85세,2018,364,104,260,40,364,104,260,40
경상남도,창원시마산회원구,86세,2018,361,95,266,35.7,361,95,266,35.7
경상남도,창원시마산회원구,87세,2018,269,45,224,20.1,269,45,224,20.1
경상남도,창원시마산회원구,88세,2018,209,38,171,22.2,209,38,171,22.2
경상남도,창원시마산회원구,89세,2018,200,39,161,24.2,200,39,161,24.2
경상남도,창원시마산회원구,90~94세,2018,406,78,328,23.8,406,78,328,23.8
경상남도,창원시마산회원구,90세,2018,136,33,103,32,136,33,103,32
경상남도,창원시마산회원구,91세,2018,109,19,90,21.1,109,19,90,21.1
경상남도,창원시마산회원구,92세,2018,63,9,54,16.7,63,9,54,16.7
경상남도,창원시마산회원구,93세,2018,63,11,52,21.2,63,11,52,21.2
경상남도,창원시마산회원구,94세,2018,35,6,29,20.7,35,6,29,20.7
경상남도,창원시마산회원구,95~99세,2018,82,13,69,18.8,82,13,69,18.8
경상남도,창원시마산회원구,95세,2018,36,6,30,20,36,6,30,20
경상남도,창원시마산회원구,96세,2018,18,X,16,12.5,18,X,16,12.5
경상남도,창원시마산회원구,97세,2018,15,X,12,25,15,X,12,25
경상남도,창원시마산회원구,98세,2018,9,X,8,12.5,9,X,8,12.5
경상남도,창원시마산회원구,99세,2018,X,X,X,33.3,X,X,X,33.3
경상남도,창원시마산회원구,100세이상,2018,8,X,7,14.3,8,X,7,14.3
경상남도,창원시마산회원구,15세미만,2018,24528,12766,11762,108.5,24485,12740,11745,108.5
경상남도,창원시마산회원구,15~64세,2018,143673,73577,70096,105,141020,72015,69005,104.4
경상남도,창원시마산회원구,65세이상,2018,29482,12874,16608,77.5,29408,12848,16560,77.6
경상남도,창원시마산회원구,평균연령,2018,42.8,41.5,44.1,,42.9,41.6,44.1,
경상남도,창원시마산회원구,중위연령,2018,44.8,43.3,46.3,,45,43.6,46.5,
경상남도,창원시진해구,합계,2018,190276,97660,92616,105.4,185625,94709,90916,104.2
경상남도,창원시진해구,0~4세,2018,10062,5218,4844,107.7,9969,5179,4790,108.1
경상남도,창원시진해구,0세,2018,1608,838,770,108.8,1599,834,765,109
경상남도,창원시진해구,1세,2018,1821,924,897,103,1798,913,885,103.2
경상남도,창원시진해구,2세,2018,2123,1086,1037,104.7,2102,1079,1023,105.5
경상남도,창원시진해구,3세,2018,2230,1203,1027,117.1,2207,1192,1015,117.4
경상남도,창원시진해구,4세,2018,2280,1167,1113,104.9,2263,1161,1102,105.4
경상남도,창원시진해구,5~9세,2018,11749,6082,5667,107.3,11717,6064,5653,107.3
경상남도,창원시진해구,5세,2018,2362,1237,1125,110,2352,1232,1120,110
경상남도,창원시진해구,6세,2018,2510,1329,1181,112.5,2504,1326,1178,112.6
경상남도,창원시진해구,7세,2018,2384,1206,1178,102.4,2378,1203,1175,102.4
경상남도,창원시진해구,8세,2018,2285,1213,1072,113.2,2281,1209,1072,112.8
경상남도,창원시진해구,9세,2018,2208,1097,1111,98.7,2202,1094,1108,98.7
경상남도,창원시진해구,10~14세,2018,10615,5462,5153,106,10589,5448,5141,106
경상남도,창원시진해구,10세,2018,2332,1115,1217,91.6,2325,1113,1212,91.8
경상남도,창원시진해구,11세,2018,2267,1170,1097,106.7,2259,1165,1094,106.5
경상남도,창원시진해구,12세,2018,2028,1087,941,115.5,2026,1086,940,115.5
경상남도,창원시진해구,13세,2018,1890,958,932,102.8,1886,955,931,102.6
경상남도,창원시진해구,14세,2018,2098,1132,966,117.2,2093,1129,964,117.1
경상남도,창원시진해구,15~19세,2018,9150,4923,4227,116.5,9105,4896,4209,116.3
경상남도,창원시진해구,15세,2018,1958,1062,896,118.5,1953,1058,895,118.2
경상남도,창원시진해구,16세,2018,1915,1044,871,119.9,1910,1040,870,119.5
경상남도,창원시진해구,17세,2018,1976,1033,943,109.5,1970,1030,940,109.6
경상남도,창원시진해구,18세,2018,1879,946,933,101.4,1871,939,932,100.8
경상남도,창원시진해구,19세,2018,1422,838,584,143.5,1401,829,572,144.9
경상남도,창원시진해구,20~24세,2018,8681,5097,3584,142.2,8354,4891,3463,141.2
경상남도,창원시진해구,20세,2018,1588,981,607,161.6,1560,965,595,162.2
경상남도,창원시진해구,21세,2018,1787,1085,702,154.6,1741,1055,686,153.8
경상남도,창원시진해구,22세,2018,1734,985,749,131.5,1673,951,722,131.7
경상남도,창원시진해구,23세,2018,1698,981,717,136.8,1610,928,682,136.1
경상남도,창원시진해구,24세,2018,1874,1065,809,131.6,1770,992,778,127.5
경상남도,창원시진해구,25~29세,2018,10440,5762,4678,123.2,9666,5245,4421,118.6
경상남도,창원시진해구,25세,2018,1997,1169,828,141.2,1866,1068,798,133.8
경상남도,창원시진해구,26세,2018,2139,1187,952,124.7,2007,1104,903,122.3
경상남도,창원시진해구,27세,2018,1975,1056,919,114.9,1833,964,869,110.9
경상남도,창원시진해구,28세,2018,2131,1175,956,122.9,1955,1066,889,119.9
경상남도,창원시진해구,29세,2018,2198,1175,1023,114.9,2005,1043,962,108.4
경상남도,창원시진해구,30~34세,2018,12871,6836,6035,113.3,11914,6178,5736,107.7
경상남도,창원시진해구,30세,2018,2243,1193,1050,113.6,2066,1072,994,107.8
경상남도,창원시진해구,31세,2018,2396,1269,1127,112.6,2174,1118,1056,105.9
경상남도,창원시진해구,32세,2018,2532,1364,1168,116.8,2347,1240,1107,112
경상남도,창원시진해구,33세,2018,2722,1426,1296,110,2521,1284,1237,103.8
경상남도,창원시진해구,34세,2018,2978,1584,1394,113.6,2806,1464,1342,109.1
경상남도,창원시진해구,35~39세,2018,19035,9883,9152,108,18360,9419,8941,105.3
경상남도,창원시진해구,35세,2018,3417,1781,1636,108.9,3251,1668,1583,105.4
경상남도,창원시진해구,36세,2018,3797,1985,1812,109.5,3654,1893,1761,107.5
경상남도,창원시진해구,37세,2018,3955,2096,1859,112.7,3842,2012,1830,109.9
경상남도,창원시진해구,38세,2018,4054,2054,2000,102.7,3932,1965,1967,99.9
경상남도,창원시진해구,39세,2018,3812,1967,1845,106.6,3681,1881,1800,104.5
경상남도,창원시진해구,40~44세,2018,17173,9165,8008,114.4,16729,8856,7873,112.5
경상남도,창원시진해구,40세,2018,3363,1793,1570,114.2,3264,1720,1544,111.4
경상남도,창원시진해구,41세,2018,3362,1779,1583,112.4,3286,1721,1565,110
경상남도,창원시진해구,42세,2018,3297,1794,1503,119.4,3195,1725,1470,117.3
경상남도,창원시진해구,43세,2018,3438,1829,1609,113.7,3374,1789,1585,112.9
경상남도,창원시진해구,44세,2018,3713,1970,1743,113,3610,1901,1709,111.2
경상남도,창원시진해구,45~49세,2018,16511,8911,7600,117.3,16087,8655,7432,116.5
경상남도,창원시진해구,45세,2018,3519,1898,1621,117.1,3433,1848,1585,116.6
경상남도,창원시진해구,46세,2018,3291,1768,1523,116.1,3213,1716,1497,114.6
경상남도,창원시진해구,47세,2018,3392,1826,1566,116.6,3287,1757,1530,114.8
경상남도,창원시진해구,48세,2018,3209,1702,1507,112.9,3127,1662,1465,113.4
경상남도,창원시진해구,49세,2018,3100,1717,1383,124.2,3027,1672,1355,123.4
경상남도,창원시진해구,50~54세,2018,13517,6989,6528,107.1,13156,6784,6372,106.5
경상남도,창원시진해구,50세,2018,3060,1626,1434,113.4,2983,1586,1397,113.5
경상남도,창원시진해구,51세,2018,2708,1394,1314,106.1,2623,1343,1280,104.9
경상남도,창원시진해구,52세,2018,2653,1348,1305,103.3,2593,1313,1280,102.6
경상남도,창원시진해구,53세,2018,2549,1304,1245,104.7,2485,1266,1219,103.9
경상남도,창원시진해구,54세,2018,2547,1317,1230,107.1,2472,1276,1196,106.7
경상남도,창원시진해구,55~59세,2018,14269,6975,7294,95.6,14051,6868,7183,95.6
경상남도,창원시진해구,55세,2018,2770,1414,1356,104.3,2710,1384,1326,104.4
경상남도,창원시진해구,56세,2018,2661,1334,1327,100.5,2621,1316,1305,100.8
경상남도,창원시진해구,57세,2018,3030,1476,1554,95,2990,1457,1533,95
경상남도,창원시진해구,58세,2018,3075,1448,1627,89,3036,1426,1610,88.6
경상남도,창원시진해구,59세,2018,2733,1303,1430,91.1,2694,1285,1409,91.2
경상남도,창원시진해구,60~64세,2018,12264,6068,6196,97.9,12116,5992,6124,97.8
경상남도,창원시진해구,60세,2018,2626,1307,1319,99.1,2590,1290,1300,99.2
경상남도,창원시진해구,61세,2018,2550,1261,1289,97.8,2522,1250,1272,98.3
경상남도,창원시진해구,62세,2018,2457,1206,1251,96.4,2429,1186,1243,95.4
경상남도,창원시진해구,63세,2018,2513,1204,1309,92,2483,1186,1297,91.4
경상남도,창원시진해구,64세,2018,2118,1090,1028,106,2092,1080,1012,106.7
경상남도,창원시진해구,65~69세,2018,8173,3958,4215,93.9,8093,3920,4173,93.9
경상남도,창원시진해구,65세,2018,1797,911,886,102.8,1770,894,876,102.1
경상남도,창원시진해구,66세,2018,1929,937,992,94.5,1916,932,984,94.7
경상남도,창원시진해구,67세,2018,1483,685,798,85.8,1473,682,791,86.2
경상남도,창원시진해구,68세,2018,1424,664,760,87.4,1411,659,752,87.6
경상남도,창원시진해구,69세,2018,1540,761,779,97.7,1523,753,770,97.8
경상남도,창원시진해구,70~74세,2018,5913,2752,3161,87.1,5888,2741,3147,87.1
경상남도,창원시진해구,70세,2018,1408,702,706,99.4,1404,701,703,99.7
경상남도,창원시진해구,71세,2018,1380,629,751,83.8,1370,623,747,83.4
경상남도,창원시진해구,72세,2018,1072,525,547,96,1069,524,545,96.1
경상남도,창원시진해구,73세,2018,1014,430,584,73.6,1011,428,583,73.4
경상남도,창원시진해구,74세,2018,1039,466,573,81.3,1034,465,569,81.7
경상남도,창원시진해구,75~79세,2018,4820,2006,2814,71.3,4809,2003,2806,71.4
경상남도,창원시진해구,75세,2018,1010,434,576,75.3,1009,434,575,75.5
경상남도,창원시진해구,76세,2018,1153,479,674,71.1,1152,478,674,70.9
경상남도,창원시진해구,77세,2018,919,379,540,70.2,916,379,537,70.6
경상남도,창원시진해구,78세,2018,889,364,525,69.3,886,363,523,69.4
경상남도,창원시진해구,79세,2018,849,350,499,70.1,846,349,497,70.2
경상남도,창원시진해구,80~84세,2018,3092,1099,1993,55.1,3087,1097,1990,55.1
경상남도,창원시진해구,80세,2018,734,286,448,63.8,731,284,447,63.5
경상남도,창원시진해구,81세,2018,728,264,464,56.9,728,264,464,56.9
경상남도,창원시진해구,82세,2018,593,219,374,58.6,592,219,373,58.7
경상남도,창원시진해구,83세,2018,557,182,375,48.5,557,182,375,48.5
경상남도,창원시진해구,84세,2018,480,148,332,44.6,479,148,331,44.7
경상남도,창원시진해구,85세이상,2018,1941,474,1467,32.3,1935,473,1462,32.4
경상남도,창원시진해구,85~89세,2018,1414,370,1044,35.4,1410,369,1041,35.4
경상남도,창원시진해구,85세,2018,376,122,254,48,374,121,253,47.8
경상남도,창원시진해구,86세,2018,356,85,271,31.4,355,85,270,31.5
경상남도,창원시진해구,87세,2018,263,66,197,33.5,262,66,196,33.7
경상남도,창원시진해구,88세,2018,221,47,174,27,221,47,174,27
경상남도,창원시진해구,89세,2018,198,50,148,33.8,198,50,148,33.8
경상남도,창원시진해구,90~94세,2018,441,89,352,25.3,439,89,350,25.4
경상남도,창원시진해구,90세,2018,162,38,124,30.6,162,38,124,30.6
경상남도,창원시진해구,91세,2018,86,20,66,30.3,86,20,66,30.3
경상남도,창원시진해구,92세,2018,88,16,72,22.2,87,16,71,22.5
경상남도,창원시진해구,93세,2018,60,7,53,13.2,59,7,52,13.5
경상남도,창원시진해구,94세,2018,45,8,37,21.6,45,8,37,21.6
경상남도,창원시진해구,95~99세,2018,74,13,61,21.3,74,13,61,21.3
경상남도,창원시진해구,95세,2018,33,X,29,13.8,33,X,29,13.8
경상남도,창원시진해구,96세,2018,16,6,10,60,16,6,10,60
경상남도,창원시진해구,97세,2018,10,X,9,11.1,10,X,9,11.1
경상남도,창원시진해구,98세,2018,14,X,12,16.7,14,X,12,16.7
경상남도,창원시진해구,99세,2018,X,X,X,0,X,X,X,0
경상남도,창원시진해구,100세이상,2018,12,X,10,20,12,X,10,20
경상남도,창원시진해구,15세미만,2018,32426,16762,15664,107,32275,16691,15584,107.1
경상남도,창원시진해구,15~64세,2018,133911,70609,63302,111.5,129538,67784,61754,109.8
경상남도,창원시진해구,65세이상,2018,23939,10289,13650,75.4,23812,10234,13578,75.4
경상남도,창원시진해구,평균연령,2018,40,38.8,41.2,,40.1,38.9,41.3,
경상남도,창원시진해구,중위연령,2018,40.8,39.8,41.9,,41,40,42,
서울특별시,종로구,합계,2019,154969,74880,80089,93.5,141810,69062,72748,94.9
서울특별시,종로구,0~4세,2019,3565,1778,1787,99.5,3384,1685,1699,99.2
서울특별시,종로구,0세,2019,649,329,320,102.8,623,316,307,102.9
서울특별시,종로구,1세,2019,583,296,287,103.1,552,280,272,102.9
서울특별시,종로구,2세,2019,699,340,359,94.7,660,317,343,92.4
서울특별시,종로구,3세,2019,790,388,402,96.5,747,368,379,97.1
서울특별시,종로구,4세,2019,844,425,419,101.4,802,404,398,101.5
서울특별시,종로구,5~9세,2019,4372,2203,2169,101.6,4242,2137,2105,101.5
서울특별시,종로구,5세,2019,841,407,434,93.8,806,392,414,94.7
서울특별시,종로구,6세,2019,824,422,402,105,799,406,393,103.3
서울특별시,종로구,7세,2019,940,475,465,102.2,910,457,453,100.9
서울특별시,종로구,8세,2019,876,453,423,107.1,860,445,415,107.2
서울특별시,종로구,9세,2019,891,446,445,100.2,867,437,430,101.6
서울특별시,종로구,10~14세,2019,4740,2428,2312,105,4659,2383,2276,104.7
서울특별시,종로구,10세,2019,891,458,433,105.8,875,449,426,105.4
서울특별시,종로구,11세,2019,934,492,442,111.3,919,486,433,112.2
서울특별시,종로구,12세,2019,1039,516,523,98.7,1019,505,514,98.2
서울특별시,종로구,13세,2019,956,488,468,104.3,944,485,459,105.7
서울특별시,종로구,14세,2019,920,474,446,106.3,902,458,444,103.2
서울특별시,종로구,15~19세,2019,9015,4607,4408,104.5,8000,4259,3741,113.8
서울특별시,종로구,15세,2019,1100,589,511,115.3,1088,585,503,116.3
서울특별시,종로구,16세,2019,1572,924,648,142.6,1557,918,639,143.7
서울특별시,종로구,17세,2019,1654,904,750,120.5,1591,882,709,124.4
서울특별시,종로구,18세,2019,2035,1046,989,105.8,1722,935,787,118.8
서울특별시,종로구,19세,2019,2654,1144,1510,75.8,2042,939,1103,85.1
서울특별시,종로구,20~24세,2019,15242,6707,8535,78.6,11548,5431,6117,88.8
서울특별시,종로구,20세,2019,2765,1083,1682,64.4,2008,857,1151,74.5
서울특별시,종로구,21세,2019,2977,1208,1769,68.3,2097,896,1201,74.6
서울특별시,종로구,22세,2019,3095,1353,1742,77.7,2307,1093,1214,90
서울특별시,종로구,23세,2019,3269,1520,1749,86.9,2557,1268,1289,98.4
서울특별시,종로구,24세,2019,3136,1543,1593,96.9,2579,1317,1262,104.4
서울특별시,종로구,25~29세,2019,14057,7194,6863,104.8,12384,6443,5941,108.4
서울특별시,종로구,25세,2019,2953,1485,1468,101.2,2550,1309,1241,105.5
서울특별시,종로구,26세,2019,2984,1505,1479,101.8,2615,1344,1271,105.7
서울특별시,종로구,27세,2019,2831,1469,1362,107.9,2513,1328,1185,112.1
서울특별시,종로구,28세,2019,2747,1436,1311,109.5,2457,1305,1152,113.3
서울특별시,종로구,29세,2019,2542,1299,1243,104.5,2249,1157,1092,106
서울특별시,종로구,30~34세,2019,10753,5443,5310,102.5,9479,4793,4686,102.3
서울특별시,종로구,30세,2019,2310,1186,1124,105.5,2038,1053,985,106.9
서울특별시,종로구,31세,2019,2262,1187,1075,110.4,1987,1042,945,110.3
서울특별시,종로구,32세,2019,2224,1045,1179,88.6,1946,914,1032,88.6
서울특별시,종로구,33세,2019,2002,1024,978,104.7,1734,869,865,100.5
서울특별시,종로구,34세,2019,1955,1001,954,104.9,1774,915,859,106.5
서울특별시,종로구,35~39세,2019,10504,5206,5298,98.3,9483,4664,4819,96.8
서울특별시,종로구,35세,2019,1939,995,944,105.4,1723,874,849,102.9
서울특별시,종로구,36세,2019,2055,1019,1036,98.4,1863,927,936,99
서울특별시,종로구,37세,2019,2161,1058,1103,95.9,1936,943,993,95
서울특별시,종로구,38세,2019,2216,1101,1115,98.7,2013,998,1015,98.3
서울특별시,종로구,39세,2019,2133,1033,1100,93.9,1948,922,1026,89.9
서울특별시,종로구,40~44세,2019,9846,4811,5035,95.6,9038,4353,4685,92.9
서울특별시,종로구,40세,2019,2040,1014,1026,98.8,1869,922,947,97.4
서울특별시,종로구,41세,2019,1840,923,917,100.7,1676,830,846,98.1
서울특별시,종로구,42세,2019,1927,906,1021,88.7,1758,815,943,86.4
서울특별시,종로구,43세,2019,1978,976,1002,97.4,1817,880,937,93.9
서울특별시,종로구,44세,2019,2061,992,1069,92.8,1918,906,1012,89.5
서울특별시,종로구,45~49세,2019,12652,6214,6438,96.5,11824,5771,6053,95.3
서울특별시,종로구,45세,2019,2243,1088,1155,94.2,2097,1009,1088,92.7
서울특별시,종로구,46세,2019,2458,1155,1303,88.6,2288,1067,1221,87.4
서울특별시,종로구,47세,2019,2552,1278,1274,100.3,2385,1190,1195,99.6
서울특별시,종로구,48세,2019,2708,1387,1321,105,2543,1293,1250,103.4
서울특별시,종로구,49세,2019,2691,1306,1385,94.3,2511,1212,1299,93.3
서울특별시,종로구,50~54세,2019,12323,5969,6354,93.9,11538,5586,5952,93.9
서울특별시,종로구,50세,2019,2592,1245,1347,92.4,2438,1167,1271,91.8
서울특별시,종로구,51세,2019,2549,1221,1328,91.9,2370,1137,1233,92.2
서울특별시,종로구,52세,2019,2393,1161,1232,94.2,2263,1091,1172,93.1
서울특별시,종로구,53세,2019,2340,1135,1205,94.2,2194,1066,1128,94.5
서울특별시,종로구,54세,2019,2449,1207,1242,97.2,2273,1125,1148,98
서울특별시,종로구,55~59세,2019,12556,6204,6352,97.7,11885,5885,6000,98.1
서울특별시,종로구,55세,2019,2448,1226,1222,100.3,2278,1142,1136,100.5
서울특별시,종로구,56세,2019,2488,1249,1239,100.8,2328,1175,1153,101.9
서울특별시,종로구,57세,2019,2444,1265,1179,107.3,2307,1197,1110,107.8
서울특별시,종로구,58세,2019,2616,1274,1342,94.9,2546,1245,1301,95.7
서울특별시,종로구,59세,2019,2560,1190,1370,86.9,2426,1126,1300,86.6
서울특별시,종로구,60~64세,2019,10726,5338,5388,99.1,10199,5101,5098,100.1
서울특별시,종로구,60세,2019,2365,1204,1161,103.7,2238,1158,1080,107.2
서울특별시,종로구,61세,2019,2169,1085,1084,100.1,2048,1032,1016,101.6
서울특별시,종로구,62세,2019,2136,1067,1069,99.8,2032,1015,1017,99.8
서울특별시,종로구,63세,2019,1999,989,1010,97.9,1905,946,959,98.6
서울특별시,종로구,64세,2019,2057,993,1064,93.3,1976,950,1026,92.6
서울특별시,종로구,65~69세,2019,7366,3527,3839,91.9,7102,3414,3688,92.6
서울특별시,종로구,65세,2019,1759,869,890,97.6,1684,838,846,99.1
서울특별시,종로구,66세,2019,1563,763,800,95.4,1500,737,763,96.6
서울특별시,종로구,67세,2019,1634,797,837,95.2,1587,773,814,95
서울특별시,종로구,68세,2019,1126,513,613,83.7,1079,494,585,84.4
서울특별시,종로구,69세,2019,1284,585,699,83.7,1252,572,680,84.1
서울특별시,종로구,70~74세,2019,6101,2718,3383,80.3,5999,2673,3326,80.4
서울특별시,종로구,70세,2019,1330,609,721,84.5,1304,595,709,83.9
서울특별시,종로구,71세,2019,1321,599,722,83,1295,586,709,82.7
서울특별시,종로구,72세,2019,1346,600,746,80.4,1328,593,735,80.7
서울특별시,종로구,73세,2019,1042,450,592,76,1029,446,583,76.5
서울특별시,종로구,74세,2019,1062,460,602,76.4,1043,453,590,76.8
서울특별시,종로구,75~79세,2019,5377,2329,3048,76.4,5327,2309,3018,76.5
서울특별시,종로구,75세,2019,1080,445,635,70.1,1072,443,629,70.4
서울특별시,종로구,76세,2019,1095,497,598,83.1,1086,492,594,82.8
서울특별시,종로구,77세,2019,1256,550,706,77.9,1243,545,698,78.1
서울특별시,종로구,78세,2019,1039,449,590,76.1,1029,444,585,75.9
서울특별시,종로구,79세,2019,907,388,519,74.8,897,385,512,75.2
서울특별시,종로구,80~84세,2019,3461,1416,2045,69.2,3430,1401,2029,69
서울특별시,종로구,80세,2019,904,375,529,70.9,896,372,524,71
서울특별시,종로구,81세,2019,752,299,453,66,744,297,447,66.4
서울특별시,종로구,82세,2019,669,285,384,74.2,663,282,381,74
서울특별시,종로구,83세,2019,602,246,356,69.1,601,246,355,69.3
서울특별시,종로구,84세,2019,534,211,323,65.3,526,204,322,63.4
서울특별시,종로구,85세이상,2019,2313,788,1525,51.7,2289,774,1515,51.1
서울특별시,종로구,85~89세,2019,1580,555,1025,54.1,1567,549,1018,53.9
서울특별시,종로구,85세,2019,445,173,272,63.6,441,172,269,63.9
서울특별시,종로구,86세,2019,354,123,231,53.2,351,121,230,52.6
서울특별시,종로구,87세,2019,308,114,194,58.8,306,113,193,58.5
서울특별시,종로구,88세,2019,267,84,183,45.9,265,83,182,45.6
서울특별시,종로구,89세,2019,206,61,145,42.1,204,60,144,41.7
서울특별시,종로구,90~94세,2019,565,182,383,47.5,557,177,380,46.6
서울특별시,종로구,90세,2019,178,67,111,60.4,175,64,111,57.7
서울특별시,종로구,91세,2019,132,33,99,33.3,129,33,96,34.4
서울특별시,종로구,92세,2019,116,42,74,56.8,115,41,74,55.4
서울특별시,종로구,93세,2019,76,23,53,43.4,75,22,53,41.5
서울특별시,종로구,94세,2019,63,17,46,37,63,17,46,37
서울특별시,종로구,95~99세,2019,147,45,102,44.1,145,43,102,42.2
서울특별시,종로구,95세,2019,43,13,30,43.3,43,13,30,43.3
서울특별시,종로구,96세,2019,35,12,23,52.2,34,11,23,47.8
서울특별시,종로구,97세,2019,39,12,27,44.4,39,12,27,44.4
서울특별시,종로구,98세,2019,16,5,11,45.5,15,X,11,36.4
서울특별시,종로구,99세,2019,14,X,11,27.3,14,X,11,27.3
서울특별시,종로구,100세이상,2019,21,6,15,40,20,5,15,33.3
서울특별시,종로구,15세미만,2019,12677,6409,6268,102.2,12285,6205,6080,102.1
서울특별시,종로구,15~64세,2019,117674,57693,59981,96.2,105378,52286,53092,98.5
서울특별시,종로구,65세이상,2019,24618,10778,13840,77.9,24147,10571,13576,77.9
서울특별시,종로구,평균연령,2019,42.8,42.2,43.5,,43.6,42.7,44.5,
서울특별시,종로구,중위연령,2019,42.7,41.9,43.4,,44.3,43.2,45.3,
서울특별시,중구,합계,2019,130957,63406,67551,93.9,118398,57381,61017,94
서울특별시,중구,0~4세,2019,3968,2023,1945,104,3616,1833,1783,102.8
서울특별시,중구,0세,2019,776,397,379,104.7,728,373,355,105.1
서울특별시,중구,1세,2019,724,369,355,103.9,656,330,326,101.2
서울특별시,중구,2세,2019,788,392,396,99,701,348,353,98.6
서울특별시,중구,3세,2019,870,458,412,111.2,786,411,375,109.6
서울특별시,중구,4세,2019,810,407,403,101,745,371,374,99.2
서울특별시,중구,5~9세,2019,3676,1889,1787,105.7,3444,1762,1682,104.8
서울특별시,중구,5세,2019,799,406,393,103.3,746,377,369,102.2
서울특별시,중구,6세,2019,755,395,360,109.7,704,361,343,105.2
서울특별시,중구,7세,2019,738,389,349,111.5,687,369,318,116
서울특별시,중구,8세,2019,733,358,375,95.5,688,334,354,94.4
서울특별시,중구,9세,2019,651,341,310,110,619,321,298,107.7
서울특별시,중구,10~14세,2019,2951,1485,1466,101.3,2811,1409,1402,100.5
서울특별시,중구,10세,2019,585,291,294,99,552,272,280,97.1
서울특별시,중구,11세,2019,668,322,346,93.1,639,310,329,94.2
서울특별시,중구,12세,2019,625,315,310,101.6,597,295,302,97.7
서울특별시,중구,13세,2019,511,271,240,112.9,487,257,230,111.7
서울특별시,중구,14세,2019,562,286,276,103.6,536,275,261,105.4
서울특별시,중구,15~19세,2019,5098,2289,2809,81.5,4656,2111,2545,82.9
서울특별시,중구,15세,2019,675,331,344,96.2,640,314,326,96.3
서울특별시,중구,16세,2019,710,306,404,75.7,695,301,394,76.4
서울특별시,중구,17세,2019,786,340,446,76.2,747,320,427,74.9
서울특별시,중구,18세,2019,1133,486,647,75.1,1045,463,582,79.6
서울특별시,중구,19세,2019,1794,826,968,85.3,1529,713,816,87.4
서울특별시,중구,20~24세,2019,10762,4841,5921,81.8,8523,3919,4604,85.1
서울특별시,중구,20세,2019,1955,852,1103,77.2,1513,654,859,76.1
서울특별시,중구,21세,2019,1996,813,1183,68.7,1526,619,907,68.2
서울특별시,중구,22세,2019,2194,966,1228,78.7,1748,796,952,83.6
서울특별시,중구,23세,2019,2351,1101,1250,88.1,1898,930,968,96.1
서울특별시,중구,24세,2019,2266,1109,1157,95.9,1838,920,918,100.2
서울특별시,중구,25~29세,2019,12057,6006,6051,99.3,10448,5238,5210,100.5
서울특별시,중구,25세,2019,2392,1187,1205,98.5,2043,1036,1007,102.9
서울특별시,중구,26세,2019,2495,1226,1269,96.6,2152,1068,1084,98.5
서울특별시,중구,27세,2019,2572,1275,1297,98.3,2233,1112,1121,99.2
서울특별시,중구,28세,2019,2332,1168,1164,100.3,2065,1034,1031,100.3
서울특별시,중구,29세,2019,2266,1150,1116,103,1955,988,967,102.2
서울특별시,중구,30~34세,2019,11034,5548,5486,101.1,9594,4782,4812,99.4
서울특별시,중구,30세,2019,2169,1115,1054,105.8,1900,970,930,104.3
서울특별시,중구,31세,2019,2284,1122,1162,96.6,1978,954,1024,93.2
서울특별시,중구,32세,2019,2258,1149,1109,103.6,1954,998,956,104.4
서울특별시,중구,33세,2019,2171,1073,1098,97.7,1862,902,960,94
서울특별시,중구,34세,2019,2152,1089,1063,102.4,1900,958,942,101.7
서울특별시,중구,35~39세,2019,10933,5607,5326,105.3,9855,4996,4859,102.8
서울특별시,중구,35세,2019,2141,1104,1037,106.5,1920,974,946,103
서울특별시,중구,36세,2019,2230,1122,1108,101.3,2008,1004,1004,100
서울특별시,중구,37세,2019,2242,1144,1098,104.2,2004,1009,995,101.4
서울특별시,중구,38세,2019,2116,1087,1029,105.6,1922,977,945,103.4
서울특별시,중구,39세,2019,2204,1150,1054,109.1,2001,1032,969,106.5
서울특별시,중구,40~44세,2019,8810,4586,4224,108.6,7897,4087,3810,107.3
서울특별시,중구,40세,2019,1907,982,925,106.2,1714,869,845,102.8
서울특별시,중구,41세,2019,1782,966,816,118.4,1580,849,731,116.1
서울특별시,중구,42세,2019,1723,887,836,106.1,1561,803,758,105.9
서울특별시,중구,43세,2019,1664,867,797,108.8,1470,764,706,108.2
서울특별시,중구,44세,2019,1734,884,850,104,1572,802,770,104.2
서울특별시,중구,45~49세,2019,9926,4963,4963,100,8961,4480,4481,100
서울특별시,중구,45세,2019,1873,955,918,104,1671,855,816,104.8
서울특별시,중구,46세,2019,1828,885,943,93.8,1647,799,848,94.2
서울특별시,중구,47세,2019,1993,1024,969,105.7,1794,912,882,103.4
서울특별시,중구,48세,2019,2153,1083,1070,101.2,1974,991,983,100.8
서울특별시,중구,49세,2019,2079,1016,1063,95.6,1875,923,952,97
서울특별시,중구,50~54세,2019,10291,5096,5195,98.1,9416,4660,4756,98
서울특별시,중구,50세,2019,2125,1105,1020,108.3,1950,1016,934,108.8
서울특별시,중구,51세,2019,2262,1082,1180,91.7,2053,969,1084,89.4
서울특별시,중구,52세,2019,1996,986,1010,97.6,1846,921,925,99.6
서울특별시,중구,53세,2019,1874,959,915,104.8,1709,876,833,105.2
서울특별시,중구,54세,2019,2034,964,1070,90.1,1858,878,980,89.6
서울특별시,중구,55~59세,2019,10786,5306,5480,96.8,9892,4914,4978,98.7
서울특별시,중구,55세,2019,2015,997,1018,97.9,1830,918,912,100.7
서울특별시,중구,56세,2019,2158,1074,1084,99.1,1923,962,961,100.1
서울특별시,중구,57세,2019,2132,1061,1071,99.1,1947,990,957,103.4
서울특별시,중구,58세,2019,2210,1085,1125,96.4,2091,1035,1056,98
서울특별시,중구,59세,2019,2271,1089,1182,92.1,2101,1009,1092,92.4
서울특별시,중구,60~64세,2019,9870,4799,5071,94.6,9125,4489,4636,96.8
서울특별시,중구,60세,2019,2066,1023,1043,98.1,1899,953,946,100.7
서울특별시,중구,61세,2019,1984,927,1057,87.7,1796,850,946,89.9
서울특별시,중구,62세,2019,2027,1010,1017,99.3,1864,945,919,102.8
서울특별시,중구,63세,2019,1900,929,971,95.7,1784,881,903,97.6
서울특별시,중구,64세,2019,1893,910,983,92.6,1782,860,922,93.3
서울특별시,중구,65~69세,2019,6665,3200,3465,92.4,6308,3040,3268,93
서울특별시,중구,65세,2019,1587,781,806,96.9,1482,731,751,97.3
서울특별시,중구,66세,2019,1363,643,720,89.3,1282,611,671,91.1
서울특별시,중구,67세,2019,1437,678,759,89.3,1374,648,726,89.3
서울특별시,중구,68세,2019,1041,496,545,91,979,468,511,91.6
서울특별시,중구,69세,2019,1237,602,635,94.8,1191,582,609,95.6
서울특별시,중구,70~74세,2019,5286,2370,2916,81.3,5156,2319,2837,81.7
서울특별시,중구,70세,2019,1166,542,624,86.9,1127,525,602,87.2
서울특별시,중구,71세,2019,1168,539,629,85.7,1141,532,609,87.4
서울특별시,중구,72세,2019,1179,519,660,78.6,1147,505,642,78.7
서울특별시,중구,73세,2019,861,355,506,70.2,843,346,497,69.6
서울특별시,중구,74세,2019,912,415,497,83.5,898,411,487,84.4
서울특별시,중구,75~79세,2019,4333,1835,2498,73.5,4256,1801,2455,73.4
서울특별시,중구,75세,2019,912,405,507,79.9,894,394,500,78.8
서울특별시,중구,76세,2019,862,362,500,72.4,843,356,487,73.1
서울특별시,중구,77세,2019,1034,436,598,72.9,1018,431,587,73.4
서울특별시,중구,78세,2019,836,354,482,73.4,825,349,476,73.3
서울특별시,중구,79세,2019,689,278,411,67.6,676,271,405,66.9
서울특별시,중구,80~84세,2019,2692,1029,1663,61.9,2642,1013,1629,62.2
서울특별시,중구,80세,2019,694,288,406,70.9,682,284,398,71.4
서울특별시,중구,81세,2019,584,225,359,62.7,575,220,355,62
서울특별시,중구,82세,2019,527,185,342,54.1,517,184,333,55.3
서울특별시,중구,83세,2019,477,178,299,59.5,467,176,291,60.5
서울특별시,중구,84세,2019,410,153,257,59.5,401,149,252,59.1
서울특별시,중구,85세이상,2019,1819,534,1285,41.6,1798,528,1270,41.6
서울특별시,중구,85~89세,2019,1234,370,864,42.8,1222,366,856,42.8
서울특별시,중구,85세,2019,344,105,239,43.9,339,104,235,44.3
서울특별시,중구,86세,2019,284,86,198,43.4,281,84,197,42.6
서울특별시,중구,87세,2019,237,68,169,40.2,235,68,167,40.7
서울특별시,중구,88세,2019,187,59,128,46.1,187,59,128,46.1
서울특별시,중구,89세,2019,182,52,130,40,180,51,129,39.5
서울특별시,중구,90~94세,2019,476,133,343,38.8,469,131,338,38.8
서울특별시,중구,90세,2019,147,51,96,53.1,145,50,95,52.6
서울특별시,중구,91세,2019,130,36,94,38.3,129,36,93,38.7
서울특별시,중구,92세,2019,99,25,74,33.8,95,24,71,33.8
서울특별시,중구,93세,2019,60,14,46,30.4,60,14,46,30.4
서울특별시,중구,94세,2019,40,7,33,21.2,40,7,33,21.2
서울특별시,중구,95~99세,2019,92,26,66,39.4,91,26,65,40
서울특별시,중구,95세,2019,32,13,19,68.4,32,13,19,68.4
서울특별시,중구,96세,2019,21,X,18,16.7,21,X,18,16.7
서울특별시,중구,97세,2019,26,7,19,36.8,25,7,18,38.9
서울특별시,중구,98세,2019,9,X,7,28.6,9,X,7,28.6
서울특별시,중구,99세,2019,X,X,X,33.3,X,X,X,33.3
서울특별시,중구,100세이상,2019,17,5,12,41.7,16,5,11,45.5
서울특별시,중구,15세미만,2019,10595,5397,5198,103.8,9871,5004,4867,102.8
서울특별시,중구,15~64세,2019,99567,49041,50526,97.1,88367,43676,44691,97.7
서울특별시,중구,65세이상,2019,20795,8968,11827,75.8,20160,8701,11459,75.9
서울특별시,중구,평균연령,2019,43.4,42.7,44,,44,43.3,44.7,
서울특별시,중구,중위연령,2019,42.8,42.1,43.5,,44,43.2,44.7,
서울특별시,용산구,합계,2019,227181,110934,116247,95.4,206678,99313,107365,92.5
서울특별시,용산구,0~4세,2019,8159,4185,3974,105.3,6568,3407,3161,107.8
서울특별시,용산구,0세,2019,1400,748,652,114.7,1268,675,593,113.8
서울특별시,용산구,1세,2019,1529,796,733,108.6,1216,647,569,113.7
서울특별시,용산구,2세,2019,1622,796,826,96.4,1259,628,631,99.5
서울특별시,용산구,3세,2019,1809,918,891,103,1433,730,703,103.8
서울특별시,용산구,4세,2019,1799,927,872,106.3,1392,727,665,109.3
서울특별시,용산구,5~9세,2019,7702,3978,3724,106.8,6604,3435,3169,108.4
서울특별시,용산구,5세,2019,1638,842,796,105.8,1338,689,649,106.2
서울특별시,용산구,6세,2019,1563,789,774,101.9,1309,663,646,102.6
서울특별시,용산구,7세,2019,1572,828,744,111.3,1369,731,638,114.6
서울특별시,용산구,8세,2019,1492,781,711,109.8,1301,680,621,109.5
서울특별시,용산구,9세,2019,1437,738,699,105.6,1287,672,615,109.3
서울특별시,용산구,10~14세,2019,7049,3543,3506,101.1,6450,3254,3196,101.8
서울특별시,용산구,10세,2019,1400,670,730,91.8,1262,605,657,92.1
서울특별시,용산구,11세,2019,1483,733,750,97.7,1350,674,676,99.7
서울특별시,용산구,12세,2019,1476,767,709,108.2,1351,703,648,108.5
서울특별시,용산구,13세,2019,1325,660,665,99.2,1223,612,611,100.2
서울특별시,용산구,14세,2019,1365,713,652,109.4,1264,660,604,109.3
서울특별시,용산구,15~19세,2019,8722,4383,4339,101,8087,4004,4083,98.1
서울특별시,용산구,15세,2019,1462,783,679,115.3,1380,739,641,115.3
서울특별시,용산구,16세,2019,1424,739,685,107.9,1353,700,653,107.2
서울특별시,용산구,17세,2019,1570,838,732,114.5,1490,790,700,112.9
서울특별시,용산구,18세,2019,1823,929,894,103.9,1732,873,859,101.6
서울특별시,용산구,19세,2019,2443,1094,1349,81.1,2132,902,1230,73.3
서울특별시,용산구,20~24세,2019,15289,6954,8335,83.4,12896,5506,7390,74.5
서울특별시,용산구,20세,2019,2575,1156,1419,81.5,2168,947,1221,77.6
서울특별시,용산구,21세,2019,2887,1322,1565,84.5,2441,1065,1376,77.4
서울특별시,용산구,22세,2019,3048,1408,1640,85.9,2571,1101,1470,74.9
서울특별시,용산구,23세,2019,3188,1475,1713,86.1,2691,1155,1536,75.2
서울특별시,용산구,24세,2019,3591,1593,1998,79.7,3025,1238,1787,69.3
서울특별시,용산구,25~29세,2019,20431,10232,10199,100.3,17661,8571,9090,94.3
서울특별시,용산구,25세,2019,3813,1815,1998,90.8,3253,1470,1783,82.4
서울특별시,용산구,26세,2019,3934,1935,1999,96.8,3385,1597,1788,89.3
서울특별시,용산구,27세,2019,4245,2112,2133,99,3681,1790,1891,94.7
서울특별시,용산구,28세,2019,4312,2210,2102,105.1,3754,1882,1872,100.5
서울특별시,용산구,29세,2019,4127,2160,1967,109.8,3588,1832,1756,104.3
서울특별시,용산구,30~34세,2019,19789,10207,9582,106.5,17185,8600,8585,100.2
서울특별시,용산구,30세,2019,4060,2107,1953,107.9,3546,1783,1763,101.1
서울특별시,용산구,31세,2019,4075,2127,1948,109.2,3489,1761,1728,101.9
서울특별시,용산구,32세,2019,3851,1929,1922,100.4,3355,1638,1717,95.4
서울특별시,용산구,33세,2019,3972,2066,1906,108.4,3471,1746,1725,101.2
서울특별시,용산구,34세,2019,3831,1978,1853,106.7,3324,1672,1652,101.2
서울특별시,용산구,35~39세,2019,20216,10431,9785,106.6,17923,9044,8879,101.9
서울특별시,용산구,35세,2019,3941,2053,1888,108.7,3407,1720,1687,102
서울특별시,용산구,36세,2019,4061,2114,1947,108.6,3576,1817,1759,103.3
서울특별시,용산구,37세,2019,4129,2074,2055,100.9,3705,1827,1878,97.3
서울특별시,용산구,38세,2019,4060,2125,1935,109.8,3652,1891,1761,107.4
서울특별시,용산구,39세,2019,4025,2065,1960,105.4,3583,1789,1794,99.7
서울특별시,용산구,40~44세,2019,16585,8372,8213,101.9,14852,7351,7501,98
서울특별시,용산구,40세,2019,3529,1784,1745,102.2,3145,1553,1592,97.6
서울특별시,용산구,41세,2019,3292,1699,1593,106.7,2906,1464,1442,101.5
서울특별시,용산구,42세,2019,3238,1586,1652,96,2906,1396,1510,92.5
서울특별시,용산구,43세,2019,3194,1606,1588,101.1,2870,1417,1453,97.5
서울특별시,용산구,44세,2019,3332,1697,1635,103.8,3025,1521,1504,101.1
서울특별시,용산구,45~49세,2019,19022,9498,9524,99.7,17564,8667,8897,97.4
서울특별시,용산구,45세,2019,3634,1843,1791,102.9,3341,1666,1675,99.5
서울특별시,용산구,46세,2019,3600,1819,1781,102.1,3311,1656,1655,100.1
서울특별시,용산구,47세,2019,3882,1939,1943,99.8,3555,1760,1795,98.1
서울특별시,용산구,48세,2019,4007,1974,2033,97.1,3736,1819,1917,94.9
서울특별시,용산구,49세,2019,3899,1923,1976,97.3,3621,1766,1855,95.2
서울특별시,용산구,50~54세,2019,17673,8754,8919,98.2,16522,8129,8393,96.9
서울특별시,용산구,50세,2019,3895,1933,1962,98.5,3626,1765,1861,94.8
서울특별시,용산구,51세,2019,3794,1876,1918,97.8,3522,1717,1805,95.1
서울특별시,용산구,52세,2019,3338,1606,1732,92.7,3137,1505,1632,92.2
서울특별시,용산구,53세,2019,3238,1664,1574,105.7,3044,1562,1482,105.4
서울특별시,용산구,54세,2019,3408,1675,1733,96.7,3193,1580,1613,98
서울특별시,용산구,55~59세,2019,17272,8430,8842,95.3,16362,7974,8388,95.1
서울특별시,용산구,55세,2019,3250,1606,1644,97.7,3041,1491,1550,96.2
서울특별시,용산구,56세,2019,3481,1704,1777,95.9,3232,1583,1649,96
서울특별시,용산구,57세,2019,3454,1731,1723,100.5,3286,1644,1642,100.1
서울특별시,용산구,58세,2019,3513,1710,1803,94.8,3382,1645,1737,94.7
서울특별시,용산구,59세,2019,3574,1679,1895,88.6,3421,1611,1810,89
서울특별시,용산구,60~64세,2019,15423,7468,7955,93.9,14842,7200,7642,94.2
서울특별시,용산구,60세,2019,3311,1606,1705,94.2,3197,1550,1647,94.1
서울특별시,용산구,61세,2019,3106,1556,1550,100.4,2963,1485,1478,100.5
서울특별시,용산구,62세,2019,3148,1531,1617,94.7,3013,1468,1545,95
서울특별시,용산구,63세,2019,2900,1390,1510,92.1,2811,1354,1457,92.9
서울특별시,용산구,64세,2019,2958,1385,1573,88,2858,1343,1515,88.6
서울특별시,용산구,65~69세,2019,10344,4838,5506,87.9,10004,4677,5327,87.8
서울특별시,용산구,65세,2019,2455,1188,1267,93.8,2363,1142,1221,93.5
서울특별시,용산구,66세,2019,2154,1041,1113,93.5,2087,1009,1078,93.6
서울특별시,용산구,67세,2019,2216,979,1237,79.1,2138,948,1190,79.7
서울특별시,용산구,68세,2019,1635,759,876,86.6,1570,730,840,86.9
서울특별시,용산구,69세,2019,1884,871,1013,86,1846,848,998,85
서울특별시,용산구,70~74세,2019,8396,3739,4657,80.3,8231,3654,4577,79.8
서울특별시,용산구,70세,2019,1866,875,991,88.3,1819,845,974,86.8
서울특별시,용산구,71세,2019,1846,858,988,86.8,1812,842,970,86.8
서울특별시,용산구,72세,2019,1822,762,1060,71.9,1781,745,1036,71.9
서울특별시,용산구,73세,2019,1453,615,838,73.4,1424,603,821,73.4
서울특별시,용산구,74세,2019,1409,629,780,80.6,1395,619,776,79.8
서울특별시,용산구,75~79세,2019,7180,3052,4128,73.9,7097,3009,4088,73.6
서울특별시,용산구,75세,2019,1416,585,831,70.4,1400,577,823,70.1
서울특별시,용산구,76세,2019,1454,656,798,82.2,1433,645,788,81.9
서울특별시,용산구,77세,2019,1724,745,979,76.1,1710,737,973,75.7
서울특별시,용산구,78세,2019,1370,569,801,71,1356,565,791,71.4
서울특별시,용산구,79세,2019,1216,497,719,69.1,1198,485,713,68
서울특별시,용산구,80~84세,2019,4847,1852,2995,61.8,4794,1832,2962,61.9
서울특별시,용산구,80세,2019,1166,480,686,70,1153,473,680,69.6
서울특별시,용산구,81세,2019,1116,422,694,60.8,1105,418,687,60.8
서울특별시,용산구,82세,2019,958,375,583,64.3,947,373,574,65
서울특별시,용산구,83세,2019,876,300,576,52.1,865,296,569,52
서울특별시,용산구,84세,2019,731,275,456,60.3,724,272,452,60.2
서울특별시,용산구,85세이상,2019,3082,1018,2064,49.3,3036,999,2037,49
서울특별시,용산구,85~89세,2019,2141,759,1382,54.9,2111,746,1365,54.7
서울특별시,용산구,85세,2019,611,207,404,51.2,605,204,401,50.9
서울특별시,용산구,86세,2019,500,177,323,54.8,489,171,318,53.8
서울특별시,용산구,87세,2019,428,151,277,54.5,423,150,273,54.9
서울특별시,용산구,88세,2019,330,125,205,61,325,122,203,60.1
서울특별시,용산구,89세,2019,272,99,173,57.2,269,99,170,58.2
서울특별시,용산구,90~94세,2019,725,192,533,36,715,186,529,35.2
서울특별시,용산구,90세,2019,250,69,181,38.1,248,69,179,38.5
서울특별시,용산구,91세,2019,191,44,147,29.9,189,43,146,29.5
서울특별시,용산구,92세,2019,127,28,99,28.3,126,27,99,27.3
서울특별시,용산구,93세,2019,88,22,66,33.3,87,21,66,31.8
서울특별시,용산구,94세,2019,69,29,40,72.5,65,26,39,66.7
서울특별시,용산구,95~99세,2019,194,62,132,47,190,62,128,48.4
서울특별시,용산구,95세,2019,61,21,40,52.5,60,21,39,53.8
서울특별시,용산구,96세,2019,59,23,36,63.9,56,23,33,69.7
서울특별시,용산구,97세,2019,33,6,27,22.2,33,6,27,22.2
서울특별시,용산구,98세,2019,30,9,21,42.9,30,9,21,42.9
서울특별시,용산구,99세,2019,11,X,8,37.5,11,X,8,37.5
서울특별시,용산구,100세이상,2019,22,5,17,29.4,20,5,15,33.3
서울특별시,용산구,15세미만,2019,22910,11706,11204,104.5,19622,10096,9526,106
서울특별시,용산구,15~64세,2019,170422,84729,85693,98.9,153894,75046,78848,95.2
서울특별시,용산구,65세이상,2019,33849,14499,19350,74.9,33162,14171,18991,74.6
서울특별시,용산구,평균연령,2019,42.5,41.6,43.4,,43.5,42.6,44.2,
서울특별시,용산구,중위연령,2019,41.8,40.9,42.8,,43.4,42.6,44.1,
서울특별시,성동구,합계,2019,299688,146630,153058,95.8,287914,141020,146894,96
서울특별시,성동구,0~4세,2019,11452,5869,5583,105.1,11141,5710,5431,105.1
서울특별시,성동구,0세,2019,2200,1147,1053,108.9,2155,1125,1030,109.2
서울특별시,성동구,1세,2019,2204,1114,1090,102.2,2158,1090,1068,102.1
서울특별시,성동구,2세,2019,2277,1180,1097,107.6,2195,1137,1058,107.5
서울특별시,성동구,3세,2019,2390,1207,1183,102,2323,1175,1148,102.4
서울특별시,성동구,4세,2019,2381,1221,1160,105.3,2310,1183,1127,105
서울특별시,성동구,5~9세,2019,10398,5241,5157,101.6,10210,5151,5059,101.8
서울특별시,성동구,5세,2019,2300,1144,1156,99,2244,1119,1125,99.5
서울특별시,성동구,6세,2019,2171,1102,1069,103.1,2138,1086,1052,103.2
서울특별시,성동구,7세,2019,2110,1053,1057,99.6,2077,1037,1040,99.7
서울특별시,성동구,8세,2019,1976,1028,948,108.4,1950,1014,936,108.3
서울특별시,성동구,9세,2019,1841,914,927,98.6,1801,895,906,98.8
서울특별시,성동구,10~14세,2019,8974,4566,4408,103.6,8888,4522,4366,103.6
서울특별시,성동구,10세,2019,1713,875,838,104.4,1696,867,829,104.6
서울특별시,성동구,11세,2019,1929,984,945,104.1,1913,979,934,104.8
서울특별시,성동구,12세,2019,1894,966,928,104.1,1883,959,924,103.8
서울특별시,성동구,13세,2019,1715,874,841,103.9,1697,864,833,103.7
서울특별시,성동구,14세,2019,1723,867,856,101.3,1699,853,846,100.8
서울특별시,성동구,15~19세,2019,11942,5816,6126,94.9,11434,5597,5837,95.9
서울특별시,성동구,15세,2019,1868,941,927,101.5,1850,932,918,101.5
서울특별시,성동구,16세,2019,1844,849,995,85.3,1819,835,984,84.9
서울특별시,성동구,17세,2019,2012,949,1063,89.3,1977,933,1044,89.4
서울특별시,성동구,18세,2019,2568,1302,1266,102.8,2444,1252,1192,105
서울특별시,성동구,19세,2019,3650,1775,1875,94.7,3344,1645,1699,96.8
서울특별시,성동구,20~24세,2019,22964,11089,11875,93.4,20770,10206,10564,96.6
서울특별시,성동구,20세,2019,3804,1822,1982,91.9,3447,1692,1755,96.4
서울특별시,성동구,21세,2019,4114,1887,2227,84.7,3670,1707,1963,87
서울특별시,성동구,22세,2019,4585,2198,2387,92.1,4129,2022,2107,96
서울특별시,성동구,23세,2019,5195,2544,2651,96,4722,2355,2367,99.5
서울특별시,성동구,24세,2019,5266,2638,2628,100.4,4802,2430,2372,102.4
서울특별시,성동구,25~29세,2019,26568,13490,13078,103.2,25055,12783,12272,104.2
서울특별시,성동구,25세,2019,5391,2715,2676,101.5,5039,2566,2473,103.8
서울특별시,성동구,26세,2019,5433,2870,2563,112,5130,2733,2397,114
서울특별시,성동구,27세,2019,5526,2838,2688,105.6,5233,2701,2532,106.7
서울특별시,성동구,28세,2019,5167,2598,2569,101.1,4898,2464,2434,101.2
서울특별시,성동구,29세,2019,5051,2469,2582,95.6,4755,2319,2436,95.2
서울특별시,성동구,30~34세,2019,24647,12001,12646,94.9,23412,11362,12050,94.3
서울특별시,성동구,30세,2019,4944,2372,2572,92.2,4699,2247,2452,91.6
서울특별시,성동구,31세,2019,4856,2331,2525,92.3,4607,2201,2406,91.5
서울특별시,성동구,32세,2019,4768,2286,2482,92.1,4526,2155,2371,90.9
서울특별시,성동구,33세,2019,4986,2484,2502,99.3,4732,2357,2375,99.2
서울특별시,성동구,34세,2019,5093,2528,2565,98.6,4848,2402,2446,98.2
서울특별시,성동구,35~39세,2019,26456,13420,13036,102.9,25414,12837,12577,102.1
서울특별시,성동구,35세,2019,5082,2544,2538,100.2,4845,2415,2430,99.4
서울특별시,성동구,36세,2019,5308,2710,2598,104.3,5105,2596,2509,103.5
서울특별시,성동구,37세,2019,5483,2788,2695,103.5,5244,2659,2585,102.9
서울특별시,성동구,38세,2019,5303,2701,2602,103.8,5119,2590,2529,102.4
서울특별시,성동구,39세,2019,5280,2677,2603,102.8,5101,2577,2524,102.1
서울특별시,성동구,40~44세,2019,21640,11068,10572,104.7,20842,10645,10197,104.4
서울특별시,성동구,40세,2019,4666,2377,2289,103.8,4503,2293,2210,103.8
서울특별시,성동구,41세,2019,4237,2176,2061,105.6,4078,2084,1994,104.5
서울특별시,성동구,42세,2019,4306,2216,2090,106,4153,2134,2019,105.7
서울특별시,성동구,43세,2019,4187,2181,2006,108.7,4022,2101,1921,109.4
서울특별시,성동구,44세,2019,4244,2118,2126,99.6,4086,2033,2053,99
서울특별시,성동구,45~49세,2019,24238,12076,12162,99.3,23323,11623,11700,99.3
서울특별시,성동구,45세,2019,4580,2317,2263,102.4,4446,2249,2197,102.4
서울특별시,성동구,46세,2019,4693,2378,2315,102.7,4527,2306,2221,103.8
서울특별시,성동구,47세,2019,4786,2376,2410,98.6,4583,2275,2308,98.6
서울특별시,성동구,48세,2019,5112,2505,2607,96.1,4934,2409,2525,95.4
서울특별시,성동구,49세,2019,5067,2500,2567,97.4,4833,2384,2449,97.3
서울특별시,성동구,50~54세,2019,23687,11616,12071,96.2,22764,11135,11629,95.8
서울특별시,성동구,50세,2019,5024,2441,2583,94.5,4847,2351,2496,94.2
서울특별시,성동구,51세,2019,4968,2450,2518,97.3,4777,2348,2429,96.7
서울특별시,성동구,52세,2019,4539,2206,2333,94.6,4386,2123,2263,93.8
서울특별시,성동구,53세,2019,4449,2217,2232,99.3,4261,2119,2142,98.9
서울특별시,성동구,54세,2019,4707,2302,2405,95.7,4493,2194,2299,95.4
서울특별시,성동구,55~59세,2019,24039,11919,12120,98.3,23190,11539,11651,99
서울특별시,성동구,55세,2019,4514,2272,2242,101.3,4331,2180,2151,101.3
서울특별시,성동구,56세,2019,4751,2319,2432,95.4,4545,2231,2314,96.4
서울특별시,성동구,57세,2019,4731,2394,2337,102.4,4549,2305,2244,102.7
서울특별시,성동구,58세,2019,4938,2422,2516,96.3,4815,2372,2443,97.1
서울특별시,성동구,59세,2019,5105,2512,2593,96.9,4950,2451,2499,98.1
서울특별시,성동구,60~64세,2019,20801,10164,10637,95.6,20121,9850,10271,95.9
서울특별시,성동구,60세,2019,4507,2229,2278,97.8,4366,2156,2210,97.6
서울특별시,성동구,61세,2019,4322,2173,2149,101.1,4168,2104,2064,101.9
서울특별시,성동구,62세,2019,4242,2085,2157,96.7,4106,2025,2081,97.3
서울특별시,성동구,63세,2019,3818,1839,1979,92.9,3677,1776,1901,93.4
서울특별시,성동구,64세,2019,3912,1838,2074,88.6,3804,1789,2015,88.8
서울특별시,성동구,65~69세,2019,13760,6534,7226,90.4,13422,6363,7059,90.1
서울특별시,성동구,65세,2019,3294,1592,1702,93.5,3188,1541,1647,93.6
서울특별시,성동구,66세,2019,2792,1356,1436,94.4,2725,1319,1406,93.8
서울특별시,성동구,67세,2019,3006,1429,1577,90.6,2940,1394,1546,90.2
서울특별시,성동구,68세,2019,2222,1028,1194,86.1,2164,1000,1164,85.9
서울특별시,성동구,69세,2019,2446,1129,1317,85.7,2405,1109,1296,85.6
서울특별시,성동구,70~74세,2019,10870,4880,5990,81.5,10770,4846,5924,81.8
서울특별시,성동구,70세,2019,2434,1120,1314,85.2,2404,1110,1294,85.8
서울특별시,성동구,71세,2019,2310,1078,1232,87.5,2290,1073,1217,88.2
서울특별시,성동구,72세,2019,2424,1080,1344,80.4,2410,1075,1335,80.5
서울특별시,성동구,73세,2019,1895,832,1063,78.3,1871,823,1048,78.5
서울특별시,성동구,74세,2019,1807,770,1037,74.3,1795,765,1030,74.3
서울특별시,성동구,75~79세,2019,8810,3869,4941,78.3,8766,3853,4913,78.4
서울특별시,성동구,75세,2019,1824,824,1000,82.4,1814,820,994,82.5
서울특별시,성동구,76세,2019,1808,800,1008,79.4,1798,796,1002,79.4
서울특별시,성동구,77세,2019,2109,951,1158,82.1,2104,948,1156,82
서울특별시,성동구,78세,2019,1670,737,933,79,1662,735,927,79.3
서울특별시,성동구,79세,2019,1399,557,842,66.2,1388,554,834,66.4
서울특별시,성동구,80~84세,2019,5273,2052,3221,63.7,5248,2048,3200,64
서울특별시,성동구,80세,2019,1329,570,759,75.1,1323,569,754,75.5
서울특별시,성동구,81세,2019,1193,463,730,63.4,1190,462,728,63.5
서울특별시,성동구,82세,2019,1078,412,666,61.9,1073,411,662,62.1
서울특별시,성동구,83세,2019,916,331,585,56.6,911,331,580,57.1
서울특별시,성동구,84세,2019,757,276,481,57.4,751,275,476,57.8
서울특별시,성동구,85세이상,2019,3169,960,2209,43.5,3144,950,2194,43.3
서울특별시,성동구,85~89세,2019,2241,717,1524,47,2225,710,1515,46.9
서울특별시,성동구,85세,2019,707,270,437,61.8,700,267,433,61.7
서울특별시,성동구,86세,2019,498,153,345,44.3,497,153,344,44.5
서울특별시,성동구,87세,2019,431,133,298,44.6,429,132,297,44.4
서울특별시,성동구,88세,2019,323,88,235,37.4,319,85,234,36.3
서울특별시,성동구,89세,2019,282,73,209,34.9,280,73,207,35.3
서울특별시,성동구,90~94세,2019,724,194,530,36.6,721,194,527,36.8
서울특별시,성동구,90세,2019,241,75,166,45.2,241,75,166,45.2
서울특별시,성동구,91세,2019,168,47,121,38.8,168,47,121,38.8
서울특별시,성동구,92세,2019,150,37,113,32.7,150,37,113,32.7
서울특별시,성동구,93세,2019,95,20,75,26.7,93,20,73,27.4
서울특별시,성동구,94세,2019,70,15,55,27.3,69,15,54,27.8
서울특별시,성동구,95~99세,2019,181,44,137,32.1,178,43,135,31.9
서울특별시,성동구,95세,2019,57,14,43,32.6,57,14,43,32.6
서울특별시,성동구,96세,2019,53,13,40,32.5,51,12,39,30.8
서울특별시,성동구,97세,2019,35,8,27,29.6,34,8,26,30.8
서울특별시,성동구,98세,2019,23,5,18,27.8,23,5,18,27.8
서울특별시,성동구,99세,2019,13,X,9,44.4,13,X,9,44.4
서울특별시,성동구,100세이상,2019,23,5,18,27.8,20,X,17,17.6
서울특별시,성동구,15세미만,2019,30824,15676,15148,103.5,30239,15383,14856,103.5
서울특별시,성동구,15~64세,2019,226982,112659,114323,98.5,216325,107577,108748,98.9
서울특별시,성동구,65세이상,2019,41882,18295,23587,77.6,41350,18060,23290,77.5
서울특별시,성동구,평균연령,2019,42,41.3,42.7,,42.2,41.4,42.9,
서울특별시,성동구,중위연령,2019,41.4,40.8,42.1,,41.8,41,42.5,
서울특별시,광진구,합계,2019,359766,174027,185739,93.7,338841,164553,174288,94.4
서울특별시,광진구,0~4세,2019,10211,5254,4957,106,9781,5020,4761,105.4
서울특별시,광진구,0세,2019,1949,1020,929,109.8,1855,963,892,108
서울특별시,광진구,1세,2019,1871,963,908,106.1,1792,923,869,106.2
서울특별시,광진구,2세,2019,1957,994,963,103.2,1878,952,926,102.8
서울특별시,광진구,3세,2019,2153,1119,1034,108.2,2052,1064,988,107.7
서울특별시,광진구,4세,2019,2281,1158,1123,103.1,2204,1118,1086,102.9
서울특별시,광진구,5~9세,2019,11392,5879,5513,106.6,11079,5715,5364,106.5
서울특별시,광진구,5세,2019,2155,1126,1029,109.4,2065,1084,981,110.5
서울특별시,광진구,6세,2019,2216,1124,1092,102.9,2159,1099,1060,103.7
서울특별시,광진구,7세,2019,2383,1230,1153,106.7,2318,1191,1127,105.7
서울특별시,광진구,8세,2019,2311,1162,1149,101.1,2260,1130,1130,100
서울특별시,광진구,9세,2019,2327,1237,1090,113.5,2277,1211,1066,113.6
서울특별시,광진구,10~14세,2019,11810,6010,5800,103.6,11641,5915,5726,103.3
서울특별시,광진구,10세,2019,2163,1117,1046,106.8,2118,1097,1021,107.4
서울특별시,광진구,11세,2019,2382,1230,1152,106.8,2345,1207,1138,106.1
서울특별시,광진구,12세,2019,2547,1278,1269,100.7,2510,1254,1256,99.8
서울특별시,광진구,13세,2019,2359,1193,1166,102.3,2333,1179,1154,102.2
서울특별시,광진구,14세,2019,2359,1192,1167,102.1,2335,1178,1157,101.8
서울특별시,광진구,15~19세,2019,15873,7905,7968,99.2,14932,7566,7366,102.7
서울특별시,광진구,15세,2019,2534,1314,1220,107.7,2498,1296,1202,107.8
서울특별시,광진구,16세,2019,2532,1280,1252,102.2,2508,1269,1239,102.4
서울특별시,광진구,17세,2019,2614,1294,1320,98,2549,1267,1282,98.8
서울특별시,광진구,18세,2019,3352,1707,1645,103.8,3112,1627,1485,109.6
서울특별시,광진구,19세,2019,4841,2310,2531,91.3,4265,2107,2158,97.6
서울특별시,광진구,20~24세,2019,31082,14044,17038,82.4,27405,12733,14672,86.8
서울특별시,광진구,20세,2019,5073,2309,2764,83.5,4418,2100,2318,90.6
서울특별시,광진구,21세,2019,5701,2475,3226,76.7,4962,2210,2752,80.3
서울특별시,광진구,22세,2019,6202,2838,3364,84.4,5415,2549,2866,88.9
서울특별시,광진구,23세,2019,6906,3089,3817,80.9,6127,2818,3309,85.2
서울특별시,광진구,24세,2019,7200,3333,3867,86.2,6483,3056,3427,89.2
서울특별시,광진구,25~29세,2019,37355,18230,19125,95.3,34831,17153,17678,97
서울특별시,광진구,25세,2019,7563,3525,4038,87.3,6962,3292,3670,89.7
서울특별시,광진구,26세,2019,7797,3869,3928,98.5,7275,3641,3634,100.2
서울특별시,광진구,27세,2019,7769,3794,3975,95.4,7319,3611,3708,97.4
서울특별시,광진구,28세,2019,7272,3612,3660,98.7,6838,3415,3423,99.8
서울특별시,광진구,29세,2019,6954,3430,3524,97.3,6437,3194,3243,98.5
서울특별시,광진구,30~34세,2019,30527,15147,15380,98.5,28404,14064,14340,98.1
서울특별시,광진구,30세,2019,6636,3253,3383,96.2,6195,3036,3159,96.1
서울특별시,광진구,31세,2019,6251,3056,3195,95.6,5793,2825,2968,95.2
서울특별시,광진구,32세,2019,6099,3029,3070,98.7,5653,2792,2861,97.6
서울특별시,광진구,33세,2019,5915,2972,2943,101,5509,2764,2745,100.7
서울특별시,광진구,34세,2019,5626,2837,2789,101.7,5254,2647,2607,101.5
서울특별시,광진구,35~39세,2019,28970,14525,14445,100.6,27441,13737,13704,100.2
서울특별시,광진구,35세,2019,5561,2786,2775,100.4,5221,2603,2618,99.4
서울특별시,광진구,36세,2019,5914,2980,2934,101.6,5575,2817,2758,102.1
서울특별시,광진구,37세,2019,6082,3007,3075,97.8,5750,2841,2909,97.7
서울특별시,광진구,38세,2019,5778,2916,2862,101.9,5511,2775,2736,101.4
서울특별시,광진구,39세,2019,5635,2836,2799,101.3,5384,2701,2683,100.7
서울특별시,광진구,40~44세,2019,25167,12611,12556,100.4,23944,11954,11990,99.7
서울특별시,광진구,40세,2019,5387,2667,2720,98.1,5141,2546,2595,98.1
서울특별시,광진구,41세,2019,4759,2434,2325,104.7,4496,2286,2210,103.4
서울특별시,광진구,42세,2019,5098,2555,2543,100.5,4846,2410,2436,98.9
서울특별시,광진구,43세,2019,4858,2454,2404,102.1,4621,2327,2294,101.4
서울특별시,광진구,44세,2019,5065,2501,2564,97.5,4840,2385,2455,97.1
서울특별시,광진구,45~49세,2019,29148,14285,14863,96.1,27594,13526,14068,96.1
서울특별시,광진구,45세,2019,5460,2700,2760,97.8,5207,2576,2631,97.9
서울특별시,광진구,46세,2019,5620,2724,2896,94.1,5328,2578,2750,93.7
서울특별시,광진구,47세,2019,5788,2900,2888,100.4,5499,2760,2739,100.8
서울특별시,광진구,48세,2019,6221,3062,3159,96.9,5875,2889,2986,96.8
서울특별시,광진구,49세,2019,6059,2899,3160,91.7,5685,2723,2962,91.9
서울특별시,광진구,50~54세,2019,28712,13839,14873,93,26870,12961,13909,93.2
서울특별시,광진구,50세,2019,6017,2852,3165,90.1,5628,2662,2966,89.8
서울특별시,광진구,51세,2019,6125,2942,3183,92.4,5759,2777,2982,93.1
서울특별시,광진구,52세,2019,5535,2655,2880,92.2,5216,2492,2724,91.5
서울특별시,광진구,53세,2019,5406,2624,2782,94.3,5036,2453,2583,95
서울특별시,광진구,54세,2019,5629,2766,2863,96.6,5231,2577,2654,97.1
서울특별시,광진구,55~59세,2019,28433,13753,14680,93.7,26378,12814,13564,94.5
서울특별시,광진구,55세,2019,5260,2581,2679,96.3,4804,2360,2444,96.6
서울특별시,광진구,56세,2019,5737,2844,2893,98.3,5184,2588,2596,99.7
서울특별시,광진구,57세,2019,5588,2721,2867,94.9,5180,2540,2640,96.2
서울특별시,광진구,58세,2019,5857,2740,3117,87.9,5597,2636,2961,89
서울특별시,광진구,59세,2019,5991,2867,3124,91.8,5613,2690,2923,92
서울특별시,광진구,60~64세,2019,24756,11783,12973,90.8,23292,11087,12205,90.8
서울특별시,광진구,60세,2019,5353,2535,2818,90,5025,2381,2644,90.1
서울특별시,광진구,61세,2019,5216,2492,2724,91.5,4865,2328,2537,91.8
서울특별시,광진구,62세,2019,5015,2413,2602,92.7,4697,2260,2437,92.7
서울특별시,광진구,63세,2019,4530,2143,2387,89.8,4295,2028,2267,89.5
서울특별시,광진구,64세,2019,4642,2200,2442,90.1,4410,2090,2320,90.1
서울특별시,광진구,65~69세,2019,16022,7599,8423,90.2,15356,7301,8055,90.6
서울특별시,광진구,65세,2019,3814,1845,1969,93.7,3616,1753,1863,94.1
서울특별시,광진구,66세,2019,3358,1614,1744,92.5,3194,1534,1660,92.4
서울특별시,광진구,67세,2019,3659,1733,1926,90,3541,1680,1861,90.3
서울특별시,광진구,68세,2019,2513,1149,1364,84.2,2408,1111,1297,85.7
서울특별시,광진구,69세,2019,2678,1258,1420,88.6,2597,1223,1374,89
서울특별시,광진구,70~74세,2019,12204,5700,6504,87.6,11993,5606,6387,87.8
서울특별시,광진구,70세,2019,2732,1287,1445,89.1,2670,1261,1409,89.5
서울특별시,광진구,71세,2019,2737,1280,1457,87.9,2683,1252,1431,87.5
서울특별시,광진구,72세,2019,2673,1206,1467,82.2,2637,1191,1446,82.4
서울특별시,광진구,73세,2019,2113,994,1119,88.8,2075,978,1097,89.2
서울특별시,광진구,74세,2019,1949,933,1016,91.8,1928,924,1004,92
서울특별시,광진구,75~79세,2019,9273,4237,5036,84.1,9167,4200,4967,84.6
서울특별시,광진구,75세,2019,2038,917,1121,81.8,2020,910,1110,82
서울특별시,광진구,76세,2019,1901,870,1031,84.4,1874,862,1012,85.2
서울특별시,광진구,77세,2019,2152,998,1154,86.5,2121,988,1133,87.2
서울특별시,광진구,78세,2019,1691,768,923,83.2,1679,762,917,83.1
서울특별시,광진구,79세,2019,1491,684,807,84.8,1473,678,795,85.3
서울특별시,광진구,80~84세,2019,5452,2201,3251,67.7,5388,2185,3203,68.2
서울특별시,광진구,80세,2019,1416,633,783,80.8,1403,631,772,81.7
서울특별시,광진구,81세,2019,1267,528,739,71.4,1250,524,726,72.2
서울특별시,광진구,82세,2019,1061,431,630,68.4,1044,425,619,68.7
서울특별시,광진구,83세,2019,888,316,572,55.2,875,313,562,55.7
서울특별시,광진구,84세,2019,820,293,527,55.6,816,292,524,55.7
서울특별시,광진구,85세이상,2019,3379,1025,2354,43.5,3345,1016,2329,43.6
서울특별시,광진구,85~89세,2019,2355,761,1594,47.7,2327,754,1573,47.9
서울특별시,광진구,85세,2019,673,238,435,54.7,666,236,430,54.9
서울특별시,광진구,86세,2019,554,185,369,50.1,539,182,357,51
서울특별시,광진구,87세,2019,488,154,334,46.1,486,154,332,46.4
서울특별시,광진구,88세,2019,332,100,232,43.1,331,100,231,43.3
서울특별시,광진구,89세,2019,308,84,224,37.5,305,82,223,36.8
서울특별시,광진구,90~94세,2019,804,218,586,37.2,802,216,586,36.9
서울특별시,광진구,90세,2019,267,79,188,42,265,77,188,41
서울특별시,광진구,91세,2019,197,47,150,31.3,197,47,150,31.3
서울특별시,광진구,92세,2019,161,49,112,43.8,161,49,112,43.8
서울특별시,광진구,93세,2019,95,17,78,21.8,95,17,78,21.8
서울특별시,광진구,94세,2019,84,26,58,44.8,84,26,58,44.8
서울특별시,광진구,95~99세,2019,188,41,147,27.9,185,41,144,28.5
서울특별시,광진구,95세,2019,68,16,52,30.8,67,16,51,31.4
서울특별시,광진구,96세,2019,45,8,37,21.6,43,8,35,22.9
서울특별시,광진구,97세,2019,40,5,35,14.3,40,5,35,14.3
서울특별시,광진구,98세,2019,23,8,15,53.3,23,8,15,53.3
서울특별시,광진구,99세,2019,12,X,8,50,12,X,8,50
서울특별시,광진구,100세이상,2019,32,5,27,18.5,31,5,26,19.2
서울특별시,광진구,15세미만,2019,33413,17143,16270,105.4,32501,16650,15851,105
서울특별시,광진구,15~64세,2019,280023,136122,143901,94.6,261091,127595,133496,95.6
서울특별시,광진구,65세이상,2019,46330,20762,25568,81.2,45249,20308,24941,81.4
서울특별시,광진구,평균연령,2019,41.5,40.9,42,,41.6,41,42.2,
서울특별시,광진구,중위연령,2019,40.5,40,41,,40.8,40.1,41.4,
서울특별시,동대문구,합계,2019,355094,174161,180933,96.3,334045,165309,168736,98
서울특별시,동대문구,0~4세,2019,10642,5452,5190,105,10375,5322,5053,105.3
서울특별시,동대문구,0세,2019,1914,969,945,102.5,1869,946,923,102.5
서울특별시,동대문구,1세,2019,1932,1001,931,107.5,1886,976,910,107.3
서울특별시,동대문구,2세,2019,2093,1086,1007,107.8,2055,1061,994,106.7
서울특별시,동대문구,3세,2019,2335,1211,1124,107.7,2264,1180,1084,108.9
서울특별시,동대문구,4세,2019,2368,1185,1183,100.2,2301,1159,1142,101.5
서울특별시,동대문구,5~9세,2019,11244,5781,5463,105.8,11112,5716,5396,105.9
서울특별시,동대문구,5세,2019,2252,1157,1095,105.7,2225,1146,1079,106.2
서울특별시,동대문구,6세,2019,2273,1184,1089,108.7,2236,1169,1067,109.6
서울특별시,동대문구,7세,2019,2278,1170,1108,105.6,2251,1158,1093,105.9
서울특별시,동대문구,8세,2019,2271,1140,1131,100.8,2250,1125,1125,100
서울특별시,동대문구,9세,2019,2170,1130,1040,108.7,2150,1118,1032,108.3
서울특별시,동대문구,10~14세,2019,10709,5493,5216,105.3,10595,5442,5153,105.6
서울특별시,동대문구,10세,2019,2087,1083,1004,107.9,2064,1073,991,108.3
서울특별시,동대문구,11세,2019,2258,1126,1132,99.5,2231,1111,1120,99.2
서울특별시,동대문구,12세,2019,2255,1183,1072,110.4,2236,1173,1063,110.3
서울특별시,동대문구,13세,2019,2098,1088,1010,107.7,2073,1076,997,107.9
서울특별시,동대문구,14세,2019,2011,1013,998,101.5,1991,1009,982,102.7
서울특별시,동대문구,15~19세,2019,15364,7247,8117,89.3,14166,6864,7302,94
서울특별시,동대문구,15세,2019,2198,1119,1079,103.7,2182,1113,1069,104.1
서울특별시,동대문구,16세,2019,2215,1109,1106,100.3,2202,1102,1100,100.2
서울특별시,동대문구,17세,2019,2262,1133,1129,100.4,2216,1115,1101,101.3
서울특별시,동대문구,18세,2019,3252,1548,1704,90.8,2963,1464,1499,97.7
서울특별시,동대문구,19세,2019,5437,2338,3099,75.4,4603,2070,2533,81.7
서울특별시,동대문구,20~24세,2019,35870,15988,19882,80.4,28903,13590,15313,88.7
서울특별시,동대문구,20세,2019,6160,2545,3615,70.4,4938,2129,2809,75.8
서울특별시,동대문구,21세,2019,6902,2821,4081,69.1,5277,2231,3046,73.2
서울특별시,동대문구,22세,2019,7357,3211,4146,77.4,5811,2708,3103,87.3
서울특별시,동대문구,23세,2019,7884,3684,4200,87.7,6466,3214,3252,98.8
서울특별시,동대문구,24세,2019,7567,3727,3840,97.1,6411,3308,3103,106.6
서울특별시,동대문구,25~29세,2019,32550,17264,15286,112.9,29352,15893,13459,118.1
서울특별시,동대문구,25세,2019,7401,3914,3487,112.2,6499,3561,2938,121.2
서울특별시,동대문구,26세,2019,6882,3661,3221,113.7,6196,3379,2817,120
서울특별시,동대문구,27세,2019,6649,3574,3075,116.2,6049,3315,2734,121.3
서울특별시,동대문구,28세,2019,5972,3181,2791,114,5454,2951,2503,117.9
서울특별시,동대문구,29세,2019,5646,2934,2712,108.2,5154,2687,2467,108.9
서울특별시,동대문구,30~34세,2019,25140,12958,12182,106.4,23106,12041,11065,108.8
서울특별시,동대문구,30세,2019,5253,2731,2522,108.3,4753,2529,2224,113.7
서울특별시,동대문구,31세,2019,5083,2577,2506,102.8,4663,2401,2262,106.1
서울특별시,동대문구,32세,2019,4899,2533,2366,107.1,4468,2328,2140,108.8
서울특별시,동대문구,33세,2019,4994,2604,2390,109,4629,2416,2213,109.2
서울특별시,동대문구,34세,2019,4911,2513,2398,104.8,4593,2367,2226,106.3
서울특별시,동대문구,35~39세,2019,27295,14131,13164,107.3,25899,13425,12474,107.6
서울특별시,동대문구,35세,2019,5041,2596,2445,106.2,4736,2434,2302,105.7
서울특별시,동대문구,36세,2019,5435,2820,2615,107.8,5132,2673,2459,108.7
서울특별시,동대문구,37세,2019,5733,2930,2803,104.5,5432,2786,2646,105.3
서울특별시,동대문구,38세,2019,5579,2889,2690,107.4,5353,2782,2571,108.2
서울특별시,동대문구,39세,2019,5507,2896,2611,110.9,5246,2750,2496,110.2
서울특별시,동대문구,40~44세,2019,24119,12529,11590,108.1,23007,11927,11080,107.6
서울특별시,동대문구,40세,2019,5245,2741,2504,109.5,4974,2598,2376,109.3
서울특별시,동대문구,41세,2019,4649,2433,2216,109.8,4415,2296,2119,108.4
서울특별시,동대문구,42세,2019,4794,2445,2349,104.1,4578,2326,2252,103.3
서울특별시,동대문구,43세,2019,4609,2404,2205,109,4397,2302,2095,109.9
서울특별시,동대문구,44세,2019,4822,2506,2316,108.2,4643,2405,2238,107.5
서울특별시,동대문구,45~49세,2019,26980,13831,13149,105.2,25797,13213,12584,105
서울특별시,동대문구,45세,2019,5089,2636,2453,107.5,4865,2524,2341,107.8
서울특별시,동대문구,46세,2019,5185,2650,2535,104.5,4958,2536,2422,104.7
서울특별시,동대문구,47세,2019,5408,2776,2632,105.5,5162,2638,2524,104.5
서울특별시,동대문구,48세,2019,5736,2963,2773,106.9,5501,2852,2649,107.7
서울특별시,동대문구,49세,2019,5562,2806,2756,101.8,5311,2663,2648,100.6
서울특별시,동대문구,50~54세,2019,26404,13133,13271,99,25257,12600,12657,99.5
서울특별시,동대문구,50세,2019,5499,2674,2825,94.7,5262,2576,2686,95.9
서울특별시,동대문구,51세,2019,5469,2706,2763,97.9,5248,2604,2644,98.5
서울특별시,동대문구,52세,2019,5015,2424,2591,93.6,4823,2342,2481,94.4
서울특별시,동대문구,53세,2019,5114,2677,2437,109.8,4869,2561,2308,111
서울특별시,동대문구,54세,2019,5307,2652,2655,99.9,5055,2517,2538,99.2
서울특별시,동대문구,55~59세,2019,26995,13171,13824,95.3,26021,12701,13320,95.4
서울특별시,동대문구,55세,2019,4889,2387,2502,95.4,4665,2278,2387,95.4
서울특별시,동대문구,56세,2019,5239,2626,2613,100.5,4989,2504,2485,100.8
서울특별시,동대문구,57세,2019,5261,2589,2672,96.9,5067,2497,2570,97.2
서울특별시,동대문구,58세,2019,5708,2775,2933,94.6,5588,2717,2871,94.6
서울특별시,동대문구,59세,2019,5898,2794,3104,90,5712,2705,3007,90
서울특별시,동대문구,60~64세,2019,25424,12228,13196,92.7,24707,11898,12809,92.9
서울특별시,동대문구,60세,2019,5392,2596,2796,92.8,5255,2524,2731,92.4
서울특별시,동대문구,61세,2019,5135,2479,2656,93.3,4974,2414,2560,94.3
서울특별시,동대문구,62세,2019,5158,2478,2680,92.5,4985,2393,2592,92.3
서울특별시,동대문구,63세,2019,4715,2282,2433,93.8,4605,2233,2372,94.1
서울특별시,동대문구,64세,2019,5024,2393,2631,91,4888,2334,2554,91.4
서울특별시,동대문구,65~69세,2019,18196,8678,9518,91.2,17842,8509,9333,91.2
서울특별시,동대문구,65세,2019,4234,2032,2202,92.3,4140,1988,2152,92.4
서울특별시,동대문구,66세,2019,3728,1792,1936,92.6,3643,1759,1884,93.4
서울특별시,동대문구,67세,2019,3987,1854,2133,86.9,3922,1817,2105,86.3
서울특별시,동대문구,68세,2019,2961,1396,1565,89.2,2903,1368,1535,89.1
서울특별시,동대문구,69세,2019,3286,1604,1682,95.4,3234,1577,1657,95.2
서울특별시,동대문구,70~74세,2019,14840,6690,8150,82.1,14697,6625,8072,82.1
서울특별시,동대문구,70세,2019,3185,1467,1718,85.4,3142,1446,1696,85.3
서울특별시,동대문구,71세,2019,3213,1434,1779,80.6,3179,1417,1762,80.4
서울특별시,동대문구,72세,2019,3320,1482,1838,80.6,3289,1468,1821,80.6
서울특별시,동대문구,73세,2019,2596,1190,1406,84.6,2573,1179,1394,84.6
서울특별시,동대문구,74세,2019,2526,1117,1409,79.3,2514,1115,1399,79.7
서울특별시,동대문구,75~79세,2019,12064,5340,6724,79.4,12008,5315,6693,79.4
서울특별시,동대문구,75세,2019,2484,1070,1414,75.7,2469,1063,1406,75.6
서울특별시,동대문구,76세,2019,2548,1177,1371,85.8,2539,1171,1368,85.6
서울특별시,동대문구,77세,2019,2851,1258,1593,79,2843,1256,1587,79.1
서울특별시,동대문구,78세,2019,2229,1009,1220,82.7,2223,1005,1218,82.5
서울특별시,동대문구,79세,2019,1952,826,1126,73.4,1934,820,1114,73.6
서울특별시,동대문구,80~84세,2019,7080,2906,4174,69.6,7043,2896,4147,69.8
서울특별시,동대문구,80세,2019,1823,794,1029,77.2,1816,793,1023,77.5
서울특별시,동대문구,81세,2019,1609,679,930,73,1603,679,924,73.5
서울특별시,동대문구,82세,2019,1350,531,819,64.8,1337,526,811,64.9
서울특별시,동대문구,83세,2019,1221,486,735,66.1,1217,484,733,66
서울특별시,동대문구,84세,2019,1077,416,661,62.9,1070,414,656,63.1
서울특별시,동대문구,85세이상,2019,4178,1341,2837,47.3,4158,1332,2826,47.1
서울특별시,동대문구,85~89세,2019,3010,1012,1998,50.7,2993,1005,1988,50.6
서울특별시,동대문구,85세,2019,903,329,574,57.3,901,327,574,57
서울특별시,동대문구,86세,2019,711,225,486,46.3,706,224,482,46.5
서울특별시,동대문구,87세,2019,609,213,396,53.8,604,210,394,53.3
서울특별시,동대문구,88세,2019,414,132,282,46.8,410,131,279,47
서울특별시,동대문구,89세,2019,373,113,260,43.5,372,113,259,43.6
서울특별시,동대문구,90~94세,2019,913,255,658,38.8,910,253,657,38.5
서울특별시,동대문구,90세,2019,289,83,206,40.3,288,83,205,40.5
서울특별시,동대문구,91세,2019,231,73,158,46.2,231,73,158,46.2
서울특별시,동대문구,92세,2019,179,50,129,38.8,179,50,129,38.8
서울특별시,동대문구,93세,2019,116,25,91,27.5,114,23,91,25.3
서울특별시,동대문구,94세,2019,98,24,74,32.4,98,24,74,32.4
서울특별시,동대문구,95~99세,2019,229,66,163,40.5,229,66,163,40.5
서울특별시,동대문구,95세,2019,66,15,51,29.4,66,15,51,29.4
서울특별시,동대문구,96세,2019,77,28,49,57.1,77,28,49,57.1
서울특별시,동대문구,97세,2019,41,9,32,28.1,41,9,32,28.1
서울특별시,동대문구,98세,2019,22,6,16,37.5,22,6,16,37.5
서울특별시,동대문구,99세,2019,23,8,15,53.3,23,8,15,53.3
서울특별시,동대문구,100세이상,2019,26,8,18,44.4,26,8,18,44.4
서울특별시,동대문구,15세미만,2019,32595,16726,15869,105.4,32082,16480,15602,105.6
서울특별시,동대문구,15~64세,2019,266141,132480,133661,99.1,246215,124152,122063,101.7
서울특별시,동대문구,65세이상,2019,56358,24955,31403,79.5,55748,24677,31071,79.4
서울특별시,동대문구,평균연령,2019,42.5,41.8,43.1,,43.1,42.2,43.9,
서울특별시,동대문구,중위연령,2019,41.8,41,42.5,,42.9,41.8,44.1,
서울특별시,중랑구,합계,2019,386331,190531,195800,97.3,379240,187569,191671,97.9
서울특별시,중랑구,0~4세,2019,11889,6155,5734,107.3,11711,6062,5649,107.3
서울특별시,중랑구,0세,2019,2206,1136,1070,106.2,2172,1119,1053,106.3
서울특별시,중랑구,1세,2019,2203,1154,1049,110,2166,1138,1028,110.7
서울특별시,중랑구,2세,2019,2308,1165,1143,101.9,2263,1144,1119,102.2
서울특별시,중랑구,3세,2019,2550,1321,1229,107.5,2521,1301,1220,106.6
서울특별시,중랑구,4세,2019,2622,1379,1243,110.9,2589,1360,1229,110.7
서울특별시,중랑구,5~9세,2019,12722,6515,6207,105,12585,6449,6136,105.1
서울특별시,중랑구,5세,2019,2464,1249,1215,102.8,2435,1232,1203,102.4
서울특별시,중랑구,6세,2019,2506,1288,1218,105.7,2478,1277,1201,106.3
서울특별시,중랑구,7세,2019,2676,1391,1285,108.2,2634,1372,1262,108.7
서울특별시,중랑구,8세,2019,2604,1337,1267,105.5,2586,1328,1258,105.6
서울특별시,중랑구,9세,2019,2472,1250,1222,102.3,2452,1240,1212,102.3
서울특별시,중랑구,10~14세,2019,12085,6255,5830,107.3,12000,6207,5793,107.1
서울특별시,중랑구,10세,2019,2308,1172,1136,103.2,2282,1162,1120,103.8
서울특별시,중랑구,11세,2019,2499,1255,1244,100.9,2475,1239,1236,100.2
서울특별시,중랑구,12세,2019,2478,1283,1195,107.4,2462,1272,1190,106.9
서울특별시,중랑구,13세,2019,2407,1293,1114,116.1,2400,1289,1111,116
서울특별시,중랑구,14세,2019,2393,1252,1141,109.7,2381,1245,1136,109.6
서울특별시,중랑구,15~19세,2019,15376,7798,7578,102.9,15230,7736,7494,103.2
서울특별시,중랑구,15세,2019,2587,1293,1294,99.9,2570,1285,1285,100
서울특별시,중랑구,16세,2019,2752,1357,1395,97.3,2738,1349,1389,97.1
서울특별시,중랑구,17세,2019,2834,1461,1373,106.4,2819,1450,1369,105.9
서울특별시,중랑구,18세,2019,3373,1773,1600,110.8,3340,1762,1578,111.7
서울특별시,중랑구,19세,2019,3830,1914,1916,99.9,3763,1890,1873,100.9
서울특별시,중랑구,20~24세,2019,23775,12001,11774,101.9,23225,11789,11436,103.1
서울특별시,중랑구,20세,2019,3940,1983,1957,101.3,3869,1953,1916,101.9
서울특별시,중랑구,21세,2019,4256,2271,1985,114.4,4161,2244,1917,117.1
서울특별시,중랑구,22세,2019,4777,2421,2356,102.8,4658,2368,2290,103.4
서울특별시,중랑구,23세,2019,5180,2560,2620,97.7,5061,2515,2546,98.8
서울특별시,중랑구,24세,2019,5622,2766,2856,96.8,5476,2709,2767,97.9
서울특별시,중랑구,25~29세,2019,31201,15373,15828,97.1,30308,15015,15293,98.2
서울특별시,중랑구,25세,2019,5999,2912,3087,94.3,5864,2857,3007,95
서울특별시,중랑구,26세,2019,6279,3165,3114,101.6,6108,3097,3011,102.9
서울특별시,중랑구,27세,2019,6689,3303,3386,97.5,6512,3234,3278,98.7
서울특별시,중랑구,28세,2019,6265,3044,3221,94.5,6061,2962,3099,95.6
서울특별시,중랑구,29세,2019,5969,2949,3020,97.6,5763,2865,2898,98.9
서울특별시,중랑구,30~34세,2019,28326,14365,13961,102.9,27333,13962,13371,104.4
서울특별시,중랑구,30세,2019,5770,2863,2907,98.5,5546,2782,2764,100.7
서울특별시,중랑구,31세,2019,5716,2866,2850,100.6,5511,2781,2730,101.9
서울특별시,중랑구,32세,2019,5631,2839,2792,101.7,5428,2758,2670,103.3
서울특별시,중랑구,33세,2019,5649,2925,2724,107.4,5469,2851,2618,108.9
서울특별시,중랑구,34세,2019,5560,2872,2688,106.8,5379,2790,2589,107.8
서울특별시,중랑구,35~39세,2019,30538,15957,14581,109.4,29822,15655,14167,110.5
서울특별시,중랑구,35세,2019,5667,2937,2730,107.6,5511,2864,2647,108.2
서울특별시,중랑구,36세,2019,5988,3114,2874,108.4,5825,3050,2775,109.9
서울특별시,중랑구,37세,2019,6269,3267,3002,108.8,6129,3206,2923,109.7
서울특별시,중랑구,38세,2019,6270,3329,2941,113.2,6134,3277,2857,114.7
서울특별시,중랑구,39세,2019,6344,3310,3034,109.1,6223,3258,2965,109.9
서울특별시,중랑구,40~44세,2019,26292,13720,12572,109.1,25740,13493,12247,110.2
서울특별시,중랑구,40세,2019,5783,3039,2744,110.8,5655,2990,2665,112.2
서울특별시,중랑구,41세,2019,5028,2675,2353,113.7,4918,2620,2298,114
서울특별시,중랑구,42세,2019,5279,2747,2532,108.5,5180,2711,2469,109.8
서울특별시,중랑구,43세,2019,5021,2620,2401,109.1,4902,2572,2330,110.4
서울특별시,중랑구,44세,2019,5181,2639,2542,103.8,5085,2600,2485,104.6
서울특별시,중랑구,45~49세,2019,30929,15538,15391,101,30272,15263,15009,101.7
서울특별시,중랑구,45세,2019,5710,2916,2794,104.4,5598,2873,2725,105.4
서울특별시,중랑구,46세,2019,5926,2954,2972,99.4,5807,2902,2905,99.9
서울특별시,중랑구,47세,2019,6037,3007,3030,99.2,5906,2953,2953,100
서울특별시,중랑구,48세,2019,6779,3436,3343,102.8,6629,3376,3253,103.8
서울특별시,중랑구,49세,2019,6477,3225,3252,99.2,6332,3159,3173,99.6
서울특별시,중랑구,50~54세,2019,33384,16129,17255,93.5,32729,15854,16875,93.9
서울특별시,중랑구,50세,2019,6862,3361,3501,96,6727,3305,3422,96.6
서울특별시,중랑구,51세,2019,6905,3284,3621,90.7,6770,3221,3549,90.8
서울특별시,중랑구,52세,2019,6500,3075,3425,89.8,6396,3033,3363,90.2
서울특별시,중랑구,53세,2019,6362,3141,3221,97.5,6220,3079,3141,98
서울특별시,중랑구,54세,2019,6755,3268,3487,93.7,6616,3216,3400,94.6
서울특별시,중랑구,55~59세,2019,35584,17380,18204,95.5,34967,17106,17861,95.8
서울특별시,중랑구,55세,2019,6450,3188,3262,97.7,6321,3118,3203,97.3
서울특별시,중랑구,56세,2019,6780,3297,3483,94.7,6618,3231,3387,95.4
서울특별시,중랑구,57세,2019,7031,3502,3529,99.2,6900,3443,3457,99.6
서울특별시,중랑구,58세,2019,7669,3676,3993,92.1,7589,3644,3945,92.4
서울특별시,중랑구,59세,2019,7654,3717,3937,94.4,7539,3670,3869,94.9
서울특별시,중랑구,60~64세,2019,31697,15327,16370,93.6,31225,15127,16098,94
서울특별시,중랑구,60세,2019,6839,3319,3520,94.3,6734,3280,3454,95
서울특별시,중랑구,61세,2019,6452,3153,3299,95.6,6340,3103,3237,95.9
서울특별시,중랑구,62세,2019,6385,3081,3304,93.3,6280,3039,3241,93.8
서울특별시,중랑구,63세,2019,5848,2833,3015,94,5773,2798,2975,94.1
서울특별시,중랑구,64세,2019,6173,2941,3232,91,6098,2907,3191,91.1
서울특별시,중랑구,65~69세,2019,21561,10378,11183,92.8,21318,10281,11037,93.2
서울특별시,중랑구,65세,2019,5138,2515,2623,95.9,5068,2487,2581,96.4
서울특별시,중랑구,66세,2019,4459,2159,2300,93.9,4393,2131,2262,94.2
서울특별시,중랑구,67세,2019,4810,2313,2497,92.6,4760,2289,2471,92.6
서울특별시,중랑구,68세,2019,3439,1598,1841,86.8,3402,1585,1817,87.2
서울특별시,중랑구,69세,2019,3715,1793,1922,93.3,3695,1789,1906,93.9
서울특별시,중랑구,70~74세,2019,16853,7794,9059,86,16740,7745,8995,86.1
서울특별시,중랑구,70세,2019,3829,1817,2012,90.3,3797,1798,1999,89.9
서울특별시,중랑구,71세,2019,3708,1722,1986,86.7,3679,1710,1969,86.8
서울특별시,중랑구,72세,2019,3735,1704,2031,83.9,3714,1693,2021,83.8
서울특별시,중랑구,73세,2019,2888,1334,1554,85.8,2868,1330,1538,86.5
서울특별시,중랑구,74세,2019,2693,1217,1476,82.5,2682,1214,1468,82.7
서울특별시,중랑구,75~79세,2019,12770,5735,7035,81.5,12724,5721,7003,81.7
서울특별시,중랑구,75세,2019,2715,1206,1509,79.9,2704,1204,1500,80.3
서울특별시,중랑구,76세,2019,2590,1171,1419,82.5,2576,1166,1410,82.7
서울특별시,중랑구,77세,2019,3068,1371,1697,80.8,3058,1368,1690,80.9
서울특별시,중랑구,78세,2019,2364,1100,1264,87,2361,1099,1262,87.1
서울특별시,중랑구,79세,2019,2033,887,1146,77.4,2025,884,1141,77.5
서울특별시,중랑구,80~84세,2019,7163,2944,4219,69.8,7144,2942,4202,70
서울특별시,중랑구,80세,2019,1899,836,1063,78.6,1895,834,1061,78.6
서울특별시,중랑구,81세,2019,1621,673,948,71,1614,673,941,71.5
서울특별시,중랑구,82세,2019,1385,584,801,72.9,1379,584,795,73.5
서울특별시,중랑구,83세,2019,1221,485,736,65.9,1220,485,735,66
서울특별시,중랑구,84세,2019,1037,366,671,54.5,1036,366,670,54.6
서울특별시,중랑구,85세이상,2019,4186,1167,3019,38.7,4167,1162,3005,38.7
서울특별시,중랑구,85~89세,2019,2927,896,2031,44.1,2911,891,2020,44.1
서울특별시,중랑구,85세,2019,868,308,560,55,866,307,559,54.9
서울특별시,중랑구,86세,2019,687,216,471,45.9,684,216,468,46.2
서울특별시,중랑구,87세,2019,525,176,349,50.4,522,174,348,50
서울특별시,중랑구,88세,2019,465,115,350,32.9,460,114,346,32.9
서울특별시,중랑구,89세,2019,382,81,301,26.9,379,80,299,26.8
서울특별시,중랑구,90~94세,2019,985,218,767,28.4,982,218,764,28.5
서울특별시,중랑구,90세,2019,304,68,236,28.8,304,68,236,28.8
서울특별시,중랑구,91세,2019,275,59,216,27.3,275,59,216,27.3
서울특별시,중랑구,92세,2019,186,45,141,31.9,184,45,139,32.4
서울특별시,중랑구,93세,2019,126,26,100,26,125,26,99,26.3
서울특별시,중랑구,94세,2019,94,20,74,27,94,20,74,27
서울특별시,중랑구,95~99세,2019,233,50,183,27.3,233,50,183,27.3
서울특별시,중랑구,95세,2019,75,19,56,33.9,75,19,56,33.9
서울특별시,중랑구,96세,2019,73,17,56,30.4,73,17,56,30.4
서울특별시,중랑구,97세,2019,40,X,36,11.1,40,X,36,11.1
서울특별시,중랑구,98세,2019,30,8,22,36.4,30,8,22,36.4
서울특별시,중랑구,99세,2019,15,X,13,15.4,15,X,13,15.4
서울특별시,중랑구,100세이상,2019,41,X,38,7.9,41,X,38,7.9
서울특별시,중랑구,15세미만,2019,36696,18925,17771,106.5,36296,18718,17578,106.5
서울특별시,중랑구,15~64세,2019,287102,143588,143514,100.1,280851,141000,139851,100.8
서울특별시,중랑구,65세이상,2019,62533,28018,34515,81.2,62093,27851,34242,81.3
서울특별시,중랑구,평균연령,2019,44,43.1,44.9,,44.1,43.2,44.9,
서울특별시,중랑구,중위연령,2019,45.2,43.9,46.4,,45.3,44,46.5,
서울특별시,성북구,합계,2019,445327,213832,231495,92.4,429775,207211,222564,93.1
서울특별시,성북구,0~4세,2019,13767,7106,6661,106.7,13499,6957,6542,106.3
서울특별시,성북구,0세,2019,2331,1196,1135,105.4,2293,1173,1120,104.7
서울특별시,성북구,1세,2019,2414,1266,1148,110.3,2353,1232,1121,109.9
서울특별시,성북구,2세,2019,2766,1430,1336,107,2699,1394,1305,106.8
서울특별시,성북구,3세,2019,3066,1573,1493,105.4,3019,1547,1472,105.1
서울특별시,성북구,4세,2019,3190,1641,1549,105.9,3135,1611,1524,105.7
서울특별시,성북구,5~9세,2019,16737,8568,8169,104.9,16550,8475,8075,105
서울특별시,성북구,5세,2019,3168,1631,1537,106.1,3120,1605,1515,105.9
서울특별시,성북구,6세,2019,3184,1593,1591,100.1,3136,1570,1566,100.3
서울특별시,성북구,7세,2019,3498,1836,1662,110.5,3469,1819,1650,110.2
서울특별시,성북구,8세,2019,3504,1793,1711,104.8,3471,1781,1690,105.4
서울특별시,성북구,9세,2019,3383,1715,1668,102.8,3354,1700,1654,102.8
서울특별시,성북구,10~14세,2019,16752,8697,8055,108,16656,8645,8011,107.9
서울특별시,성북구,10세,2019,3166,1630,1536,106.1,3147,1617,1530,105.7
서울특별시,성북구,11세,2019,3412,1783,1629,109.5,3392,1769,1623,109
서울특별시,성북구,12세,2019,3610,1887,1723,109.5,3590,1878,1712,109.7
서울특별시,성북구,13세,2019,3259,1649,1610,102.4,3237,1638,1599,102.4
서울특별시,성북구,14세,2019,3305,1748,1557,112.3,3290,1743,1547,112.7
서울특별시,성북구,15~19세,2019,24004,11478,12526,91.6,22942,11111,11831,93.9
서울특별시,성북구,15세,2019,3705,1915,1790,107,3681,1902,1779,106.9
서울특별시,성북구,16세,2019,3515,1809,1706,106,3496,1800,1696,106.1
서울특별시,성북구,17세,2019,3696,1860,1836,101.3,3651,1840,1811,101.6
서울특별시,성북구,18세,2019,5098,2414,2684,89.9,4797,2298,2499,92
서울특별시,성북구,19세,2019,7990,3480,4510,77.2,7317,3271,4046,80.8
서울특별시,성북구,20~24세,2019,41700,17977,23723,75.8,36770,16281,20489,79.5
서울특별시,성북구,20세,2019,8134,3246,4888,66.4,7146,2973,4173,71.2
서울특별시,성북구,21세,2019,8076,3265,4811,67.9,6993,2889,4104,70.4
서울특별시,성북구,22세,2019,8439,3574,4865,73.5,7386,3211,4175,76.9
서울특별시,성북구,23세,2019,8599,3857,4742,81.3,7634,3481,4153,83.8
서울특별시,성북구,24세,2019,8452,4035,4417,91.4,7611,3727,3884,96
서울특별시,성북구,25~29세,2019,36245,18544,17701,104.8,33923,17552,16371,107.2
서울특별시,성북구,25세,2019,8108,4176,3932,106.2,7494,3926,3568,110
서울특별시,성북구,26세,2019,7631,3978,3653,108.9,7150,3761,3389,111
서울특별시,성북구,27세,2019,7517,3831,3686,103.9,7067,3633,3434,105.8
서울특별시,성북구,28세,2019,6703,3463,3240,106.9,6336,3309,3027,109.3
서울특별시,성북구,29세,2019,6286,3096,3190,97.1,5876,2923,2953,99
서울특별시,성북구,30~34세,2019,28703,14317,14386,99.5,27055,13515,13540,99.8
서울특별시,성북구,30세,2019,5847,2935,2912,100.8,5473,2753,2720,101.2
서울특별시,성북구,31세,2019,5744,2867,2877,99.7,5371,2704,2667,101.4
서울특별시,성북구,32세,2019,5615,2799,2816,99.4,5297,2635,2662,99
서울특별시,성북구,33세,2019,5711,2869,2842,101,5428,2722,2706,100.6
서울특별시,성북구,34세,2019,5786,2847,2939,96.9,5486,2701,2785,97
서울특별시,성북구,35~39세,2019,32997,16456,16541,99.5,31801,15872,15929,99.6
서울특별시,성북구,35세,2019,5966,2989,2977,100.4,5688,2857,2831,100.9
서울특별시,성북구,36세,2019,6409,3202,3207,99.8,6162,3082,3080,100.1
서울특별시,성북구,37세,2019,6841,3389,3452,98.2,6615,3272,3343,97.9
서울특별시,성북구,38세,2019,6977,3547,3430,103.4,6748,3438,3310,103.9
서울특별시,성북구,39세,2019,6804,3329,3475,95.8,6588,3223,3365,95.8
서울특별시,성북구,40~44세,2019,31566,15656,15910,98.4,30668,15214,15454,98.4
서울특별시,성북구,40세,2019,6746,3346,3400,98.4,6547,3250,3297,98.6
서울특별시,성북구,41세,2019,5887,2938,2949,99.6,5681,2838,2843,99.8
서울특별시,성북구,42세,2019,6123,3059,3064,99.8,5947,2969,2978,99.7
서울특별시,성북구,43세,2019,6184,3050,3134,97.3,6028,2966,3062,96.9
서울특별시,성북구,44세,2019,6626,3263,3363,97,6465,3191,3274,97.5
서울특별시,성북구,45~49세,2019,38323,18947,19376,97.8,37423,18489,18934,97.6
서울특별시,성북구,45세,2019,7333,3635,3698,98.3,7182,3549,3633,97.7
서울특별시,성북구,46세,2019,7494,3713,3781,98.2,7315,3610,3705,97.4
서울특별시,성북구,47세,2019,7696,3852,3844,100.2,7496,3772,3724,101.3
서울특별시,성북구,48세,2019,8017,3950,4067,97.1,7826,3851,3975,96.9
서울특별시,성북구,49세,2019,7783,3797,3986,95.3,7604,3707,3897,95.1
서울특별시,성북구,50~54세,2019,34359,17087,17272,98.9,33628,16713,16915,98.8
서울특별시,성북구,50세,2019,7641,3837,3804,100.9,7477,3748,3729,100.5
서울특별시,성북구,51세,2019,7312,3684,3628,101.5,7157,3609,3548,101.7
서울특별시,성북구,52세,2019,6677,3267,3410,95.8,6531,3200,3331,96.1
서울특별시,성북구,53세,2019,6258,3125,3133,99.7,6128,3050,3078,99.1
서울특별시,성북구,54세,2019,6471,3174,3297,96.3,6335,3106,3229,96.2
서울특별시,성북구,55~59세,2019,32880,15694,17186,91.3,32314,15429,16885,91.4
서울특별시,성북구,55세,2019,6226,3010,3216,93.6,6101,2941,3160,93.1
서울특별시,성북구,56세,2019,6395,3077,3318,92.7,6262,3018,3244,93
서울특별시,성북구,57세,2019,6417,3064,3353,91.4,6305,3018,3287,91.8
서울특별시,성북구,58세,2019,6819,3299,3520,93.7,6740,3261,3479,93.7
서울특별시,성북구,59세,2019,7023,3244,3779,85.8,6906,3191,3715,85.9
서울특별시,성북구,60~64세,2019,30064,14298,15766,90.7,29685,14118,15567,90.7
서울특별시,성북구,60세,2019,6394,3120,3274,95.3,6317,3082,3235,95.3
서울특별시,성북구,61세,2019,6097,2939,3158,93.1,6030,2908,3122,93.1
서울특별시,성북구,62세,2019,6119,2883,3236,89.1,6030,2844,3186,89.3
서울특별시,성북구,63세,2019,5631,2663,2968,89.7,5562,2624,2938,89.3
서울특별시,성북구,64세,2019,5823,2693,3130,86,5746,2660,3086,86.2
서울특별시,성북구,65~69세,2019,21029,9807,11222,87.4,20838,9712,11126,87.3
서울특별시,성북구,65세,2019,4846,2311,2535,91.2,4801,2290,2511,91.2
서울특별시,성북구,66세,2019,4315,2006,2309,86.9,4269,1985,2284,86.9
서울특별시,성북구,67세,2019,4718,2205,2513,87.7,4673,2180,2493,87.4
서울특별시,성북구,68세,2019,3294,1526,1768,86.3,3265,1510,1755,86
서울특별시,성북구,69세,2019,3856,1759,2097,83.9,3830,1747,2083,83.9
서울특별시,성북구,70~74세,2019,17447,7637,9810,77.8,17375,7606,9769,77.9
서울특별시,성북구,70세,2019,3890,1729,2161,80,3865,1721,2144,80.3
서울특별시,성북구,71세,2019,3663,1587,2076,76.4,3650,1582,2068,76.5
서울특별시,성북구,72세,2019,3886,1715,2171,79,3873,1710,2163,79.1
서울특별시,성북구,73세,2019,3057,1311,1746,75.1,3045,1303,1742,74.8
서울특별시,성북구,74세,2019,2951,1295,1656,78.2,2942,1290,1652,78.1
서울특별시,성북구,75~79세,2019,14594,6356,8238,77.2,14549,6338,8211,77.2
서울특별시,성북구,75세,2019,2959,1291,1668,77.4,2944,1285,1659,77.5
서울특별시,성북구,76세,2019,3036,1348,1688,79.9,3026,1344,1682,79.9
서울특별시,성북구,77세,2019,3466,1525,1941,78.6,3459,1522,1937,78.6
서울특별시,성북구,78세,2019,2720,1194,1526,78.2,2716,1193,1523,78.3
서울특별시,성북구,79세,2019,2413,998,1415,70.5,2404,994,1410,70.5
서울특별시,성북구,80~84세,2019,8902,3571,5331,67,8871,3559,5312,67
서울특별시,성북구,80세,2019,2309,966,1343,71.9,2294,961,1333,72.1
서울특별시,성북구,81세,2019,1971,822,1149,71.5,1969,821,1148,71.5
서울특별시,성북구,82세,2019,1730,682,1048,65.1,1727,680,1047,64.9
서울특별시,성북구,83세,2019,1493,571,922,61.9,1484,568,916,62
서울특별시,성북구,84세,2019,1399,530,869,61,1397,529,868,60.9
서울특별시,성북구,85세이상,2019,5258,1636,3622,45.2,5228,1625,3603,45.1
서울특별시,성북구,85~89세,2019,3665,1253,2412,51.9,3644,1244,2400,51.8
서울특별시,성북구,85세,2019,1061,390,671,58.1,1055,387,668,57.9
서울특별시,성북구,86세,2019,871,318,553,57.5,863,315,548,57.5
서울특별시,성북구,87세,2019,700,236,464,50.9,697,235,462,50.9
서울특별시,성북구,88세,2019,547,166,381,43.6,545,165,380,43.4
서울특별시,성북구,89세,2019,486,143,343,41.7,484,142,342,41.5
서울특별시,성북구,90~94세,2019,1299,309,990,31.2,1293,308,985,31.3
서울특별시,성북구,90세,2019,409,113,296,38.2,407,113,294,38.4
서울특별시,성북구,91세,2019,332,80,252,31.7,332,80,252,31.7
서울특별시,성북구,92세,2019,271,59,212,27.8,270,59,211,28
서울특별시,성북구,93세,2019,172,38,134,28.4,169,37,132,28
서울특별시,성북구,94세,2019,115,19,96,19.8,115,19,96,19.8
서울특별시,성북구,95~99세,2019,267,64,203,31.5,266,64,202,31.7
서울특별시,성북구,95세,2019,70,14,56,25,70,14,56,25
서울특별시,성북구,96세,2019,83,21,62,33.9,82,21,61,34.4
서울특별시,성북구,97세,2019,59,17,42,40.5,59,17,42,40.5
서울특별시,성북구,98세,2019,30,7,23,30.4,30,7,23,30.4
서울특별시,성북구,99세,2019,25,5,20,25,25,5,20,25
서울특별시,성북구,100세이상,2019,27,10,17,58.8,25,9,16,56.3
서울특별시,성북구,15세미만,2019,47256,24371,22885,106.5,46705,24077,22628,106.4
서울특별시,성북구,15~64세,2019,330841,160454,170387,94.2,316209,154294,161915,95.3
서울특별시,성북구,65세이상,2019,67230,29007,38223,75.9,66861,28840,38021,75.9
서울특별시,성북구,평균연령,2019,41.9,41.1,42.6,,42.2,41.4,43,
서울특별시,성북구,중위연령,2019,41.9,41.1,42.5,,42.6,41.7,43.4,
서울특별시,강북구,합계,2019,303871,147112,156759,93.8,298525,145024,153501,94.5
서울특별시,강북구,0~4세,2019,7766,3986,3780,105.4,7682,3946,3736,105.6
서울특별시,강북구,0세,2019,1243,652,591,110.3,1230,645,585,110.3
서울특별시,강북구,1세,2019,1409,734,675,108.7,1382,720,662,108.8
서울특별시,강북구,2세,2019,1596,794,802,99,1577,786,791,99.4
서울특별시,강북구,3세,2019,1757,900,857,105,1742,892,850,104.9
서울특별시,강북구,4세,2019,1761,906,855,106,1751,903,848,106.5
서울특별시,강북구,5~9세,2019,9461,4877,4584,106.4,9414,4852,4562,106.4
서울특별시,강북구,5세,2019,1763,890,873,101.9,1753,885,868,102
서울특별시,강북구,6세,2019,1836,975,861,113.2,1826,969,857,113.1
서울특별시,강북구,7세,2019,1960,1015,945,107.4,1947,1006,941,106.9
서울특별시,강북구,8세,2019,1979,1007,972,103.6,1975,1007,968,104
서울특별시,강북구,9세,2019,1923,990,933,106.1,1913,985,928,106.1
서울특별시,강북구,10~14세,2019,9885,5075,4810,105.5,9862,5065,4797,105.6
서울특별시,강북구,10세,2019,1950,1006,944,106.6,1945,1004,941,106.7
서울특별시,강북구,11세,2019,1953,977,976,100.1,1948,974,974,100
서울특별시,강북구,12세,2019,2037,1052,985,106.8,2030,1049,981,106.9
서울특별시,강북구,13세,2019,1976,1031,945,109.1,1973,1029,944,109
서울특별시,강북구,14세,2019,1969,1009,960,105.1,1966,1009,957,105.4
서울특별시,강북구,15~19세,2019,12804,6476,6328,102.3,12687,6433,6254,102.9
서울특별시,강북구,15세,2019,2122,1054,1068,98.7,2117,1052,1065,98.8
서울특별시,강북구,16세,2019,2290,1188,1102,107.8,2282,1184,1098,107.8
서울특별시,강북구,17세,2019,2332,1231,1101,111.8,2322,1226,1096,111.9
서울특별시,강북구,18세,2019,2786,1422,1364,104.3,2767,1417,1350,105
서울특별시,강북구,19세,2019,3274,1581,1693,93.4,3199,1554,1645,94.5
서울특별시,강북구,20~24세,2019,20200,9349,10851,86.2,19514,9120,10394,87.7
서울특별시,강북구,20세,2019,3458,1572,1886,83.4,3342,1534,1808,84.8
서울특별시,강북구,21세,2019,3837,1764,2073,85.1,3695,1715,1980,86.6
서울특별시,강북구,22세,2019,4158,1901,2257,84.2,4022,1849,2173,85.1
서울특별시,강북구,23세,2019,4315,1983,2332,85,4180,1943,2237,86.9
서울특별시,강북구,24세,2019,4432,2129,2303,92.4,4275,2079,2196,94.7
서울특별시,강북구,25~29세,2019,22618,11348,11270,100.7,21852,11098,10754,103.2
서울특별시,강북구,25세,2019,4749,2316,2433,95.2,4592,2265,2327,97.3
서울특별시,강북구,26세,2019,4673,2381,2292,103.9,4545,2337,2208,105.8
서울특별시,강북구,27세,2019,4796,2416,2380,101.5,4642,2366,2276,104
서울특별시,강북구,28세,2019,4414,2169,2245,96.6,4259,2115,2144,98.6
서울특별시,강북구,29세,2019,3986,2066,1920,107.6,3814,2015,1799,112
서울특별시,강북구,30~34세,2019,18756,9693,9063,107,18061,9435,8626,109.4
서울특별시,강북구,30세,2019,3948,2007,1941,103.4,3779,1951,1828,106.7
서울특별시,강북구,31세,2019,3702,1886,1816,103.9,3554,1821,1733,105.1
서울특별시,강북구,32세,2019,3667,1938,1729,112.1,3537,1891,1646,114.9
서울특별시,강북구,33세,2019,3716,1955,1761,111,3586,1912,1674,114.2
서울특별시,강북구,34세,2019,3723,1907,1816,105,3605,1860,1745,106.6
서울특별시,강북구,35~39세,2019,21602,11372,10230,111.2,21074,11153,9921,112.4
서울특별시,강북구,35세,2019,3879,2047,1832,111.7,3769,2010,1759,114.3
서울특별시,강북구,36세,2019,4172,2164,2008,107.8,4061,2118,1943,109
서울특별시,강북구,37세,2019,4526,2345,2181,107.5,4412,2299,2113,108.8
서울특별시,강북구,38세,2019,4413,2380,2033,117.1,4315,2331,1984,117.5
서울특별시,강북구,39세,2019,4612,2436,2176,111.9,4517,2395,2122,112.9
서울특별시,강북구,40~44세,2019,20834,10730,10104,106.2,20433,10564,9869,107
서울특별시,강북구,40세,2019,4400,2306,2094,110.1,4325,2276,2049,111.1
서울특별시,강북구,41세,2019,3916,1988,1928,103.1,3824,1949,1875,103.9
서울특별시,강북구,42세,2019,4126,2129,1997,106.6,4046,2094,1952,107.3
서울특별시,강북구,43세,2019,4051,2072,1979,104.7,3981,2044,1937,105.5
서울특별시,강북구,44세,2019,4341,2235,2106,106.1,4257,2201,2056,107.1
서울특별시,강북구,45~49세,2019,25824,12981,12843,101.1,25398,12800,12598,101.6
서울특별시,강북구,45세,2019,4840,2433,2407,101.1,4768,2405,2363,101.8
서울특별시,강북구,46세,2019,5047,2506,2541,98.6,4960,2470,2490,99.2
서울특별시,강북구,47세,2019,5148,2658,2490,106.7,5053,2621,2432,107.8
서울특별시,강북구,48세,2019,5483,2752,2731,100.8,5390,2707,2683,100.9
서울특별시,강북구,49세,2019,5306,2632,2674,98.4,5227,2597,2630,98.7
서울특별시,강북구,50~54세,2019,25310,12153,13157,92.4,24889,11968,12921,92.6
서울특별시,강북구,50세,2019,5301,2548,2753,92.6,5216,2505,2711,92.4
서울특별시,강북구,51세,2019,5316,2533,2783,91,5231,2498,2733,91.4
서울특별시,강북구,52세,2019,4934,2380,2554,93.2,4859,2348,2511,93.5
서울특별시,강북구,53세,2019,4738,2317,2421,95.7,4649,2280,2369,96.2
서울특별시,강북구,54세,2019,5021,2375,2646,89.8,4934,2337,2597,90
서울특별시,강북구,55~59세,2019,26389,12609,13780,91.5,25915,12413,13502,91.9
서울특별시,강북구,55세,2019,4710,2285,2425,94.2,4619,2253,2366,95.2
서울특별시,강북구,56세,2019,5154,2590,2564,101,5029,2527,2502,101
서울특별시,강북구,57세,2019,5044,2447,2597,94.2,4949,2415,2534,95.3
서울특별시,강북구,58세,2019,5668,2639,3029,87.1,5609,2615,2994,87.3
서울특별시,강북구,59세,2019,5813,2648,3165,83.7,5709,2603,3106,83.8
서울특별시,강북구,60~64세,2019,24633,11663,12970,89.9,24290,11514,12776,90.1
서울특별시,강북구,60세,2019,5186,2480,2706,91.6,5111,2451,2660,92.1
서울특별시,강북구,61세,2019,5065,2381,2684,88.7,4986,2348,2638,89
서울특별시,강북구,62세,2019,4914,2387,2527,94.5,4830,2346,2484,94.4
서울특별시,강북구,63세,2019,4541,2115,2426,87.2,4498,2096,2402,87.3
서울특별시,강북구,64세,2019,4927,2300,2627,87.6,4865,2273,2592,87.7
서울특별시,강북구,65~69세,2019,18025,8108,9917,81.8,17825,8024,9801,81.9
서울특별시,강북구,65세,2019,4103,1856,2247,82.6,4051,1835,2216,82.8
서울특별시,강북구,66세,2019,3585,1631,1954,83.5,3534,1610,1924,83.7
서울특별시,강북구,67세,2019,4023,1841,2182,84.4,3986,1825,2161,84.5
서울특별시,강북구,68세,2019,3037,1363,1674,81.4,3009,1352,1657,81.6
서울특별시,강북구,69세,2019,3277,1417,1860,76.2,3245,1402,1843,76.1
서울특별시,강북구,70~74세,2019,15698,6796,8902,76.3,15624,6765,8859,76.4
서울특별시,강북구,70세,2019,3510,1548,1962,78.9,3492,1538,1954,78.7
서울특별시,강북구,71세,2019,3441,1508,1933,78,3426,1499,1927,77.8
서울특별시,강북구,72세,2019,3461,1506,1955,77,3446,1503,1943,77.4
서울특별시,강북구,73세,2019,2647,1131,1516,74.6,2630,1123,1507,74.5
서울특별시,강북구,74세,2019,2639,1103,1536,71.8,2630,1102,1528,72.1
서울특별시,강북구,75~79세,2019,12869,5711,7158,79.8,12836,5696,7140,79.8
서울특별시,강북구,75세,2019,2632,1196,1436,83.3,2623,1190,1433,83
서울특별시,강북구,76세,2019,2702,1149,1553,74,2694,1146,1548,74
서울특별시,강북구,77세,2019,3114,1414,1700,83.2,3111,1413,1698,83.2
서울특별시,강북구,78세,2019,2430,1092,1338,81.6,2423,1089,1334,81.6
서울특별시,강북구,79세,2019,1991,860,1131,76,1985,858,1127,76.1
서울특별시,강북구,80~84세,2019,7302,2968,4334,68.5,7293,2965,4328,68.5
서울특별시,강북구,80세,2019,1912,775,1137,68.2,1910,774,1136,68.1
서울특별시,강북구,81세,2019,1676,687,989,69.5,1672,686,986,69.6
서울특별시,강북구,82세,2019,1377,582,795,73.2,1376,582,794,73.3
서울특별시,강북구,83세,2019,1289,513,776,66.1,1289,513,776,66.1
서울특별시,강북구,84세,2019,1048,411,637,64.5,1046,410,636,64.5
서울특별시,강북구,85세이상,2019,3895,1217,2678,45.4,3876,1213,2663,45.6
서울특별시,강북구,85~89세,2019,2706,897,1809,49.6,2698,897,1801,49.8
서울특별시,강북구,85세,2019,802,302,500,60.4,800,302,498,60.6
서울특별시,강북구,86세,2019,619,223,396,56.3,617,223,394,56.6
서울특별시,강북구,87세,2019,556,178,378,47.1,555,178,377,47.2
서울특별시,강북구,88세,2019,374,106,268,39.6,373,106,267,39.7
서울특별시,강북구,89세,2019,355,88,267,33,353,88,265,33.2
서울특별시,강북구,90~94세,2019,936,257,679,37.8,930,253,677,37.4
서울특별시,강북구,90세,2019,321,93,228,40.8,319,91,228,39.9
서울특별시,강북구,91세,2019,239,76,163,46.6,239,76,163,46.6
서울특별시,강북구,92세,2019,161,37,124,29.8,161,37,124,29.8
서울특별시,강북구,93세,2019,127,35,92,38,125,34,91,37.4
서울특별시,강북구,94세,2019,88,16,72,22.2,86,15,71,21.1
서울특별시,강북구,95~99세,2019,233,60,173,34.7,229,60,169,35.5
서울특별시,강북구,95세,2019,75,13,62,21,74,13,61,21.3
서울특별시,강북구,96세,2019,63,22,41,53.7,63,22,41,53.7
서울특별시,강북구,97세,2019,46,12,34,35.3,45,12,33,36.4
서울특별시,강북구,98세,2019,31,10,21,47.6,30,10,20,50
서울특별시,강북구,99세,2019,18,X,15,20,17,X,14,21.4
서울특별시,강북구,100세이상,2019,20,X,17,17.6,19,X,16,18.8
서울특별시,강북구,15세미만,2019,27112,13938,13174,105.8,26958,13863,13095,105.9
서울특별시,강북구,15~64세,2019,218970,108374,110596,98,214113,106498,107615,99
서울특별시,강북구,65세이상,2019,57789,24800,32989,75.2,57454,24663,32791,75.2
서울특별시,강북구,평균연령,2019,45.2,44.1,46.2,,45.3,44.1,46.4,
서울특별시,강북구,중위연령,2019,46.6,45.3,48,,46.8,45.4,48.2,
서울특별시,도봉구,합계,2019,323543,156961,166582,94.2,320223,155581,164642,94.5
서울특별시,도봉구,0~4세,2019,9185,4771,4414,108.1,9115,4730,4385,107.9
서울특별시,도봉구,0세,2019,1560,831,729,114,1549,822,727,113.1
서울특별시,도봉구,1세,2019,1630,884,746,118.5,1614,874,740,118.1
서울특별시,도봉구,2세,2019,1793,920,873,105.4,1779,915,864,105.9
서울특별시,도봉구,3세,2019,2052,1031,1021,101,2037,1025,1012,101.3
서울특별시,도봉구,4세,2019,2150,1105,1045,105.7,2136,1094,1042,105
서울특별시,도봉구,5~9세,2019,11077,5719,5358,106.7,11047,5702,5345,106.7
서울특별시,도봉구,5세,2019,2122,1083,1039,104.2,2115,1077,1038,103.8
서울특별시,도봉구,6세,2019,2089,1097,992,110.6,2083,1095,988,110.8
서울특별시,도봉구,7세,2019,2320,1198,1122,106.8,2315,1197,1118,107.1
서울특별시,도봉구,8세,2019,2300,1177,1123,104.8,2292,1172,1120,104.6
서울특별시,도봉구,9세,2019,2246,1164,1082,107.6,2242,1161,1081,107.4
서울특별시,도봉구,10~14세,2019,11481,5920,5561,106.5,11459,5908,5551,106.4
서울특별시,도봉구,10세,2019,2186,1130,1056,107,2180,1124,1056,106.4
서울특별시,도봉구,11세,2019,2257,1177,1080,109,2254,1177,1077,109.3
서울특별시,도봉구,12세,2019,2518,1296,1222,106.1,2515,1295,1220,106.1
서울특별시,도봉구,13세,2019,2270,1182,1088,108.6,2265,1179,1086,108.6
서울특별시,도봉구,14세,2019,2250,1135,1115,101.8,2245,1133,1112,101.9
서울특별시,도봉구,15~19세,2019,15447,7721,7726,99.9,15373,7686,7687,100
서울특별시,도봉구,15세,2019,2665,1388,1277,108.7,2662,1386,1276,108.6
서울특별시,도봉구,16세,2019,2561,1287,1274,101,2556,1285,1271,101.1
서울특별시,도봉구,17세,2019,2826,1436,1390,103.3,2817,1431,1386,103.2
서울특별시,도봉구,18세,2019,3330,1741,1589,109.6,3318,1734,1584,109.5
서울특별시,도봉구,19세,2019,4065,1869,2196,85.1,4020,1850,2170,85.3
서울특별시,도봉구,20~24세,2019,21299,10340,10959,94.4,20888,10195,10693,95.3
서울특별시,도봉구,20세,2019,4088,1920,2168,88.6,4030,1903,2127,89.5
서울특별시,도봉구,21세,2019,3901,1927,1974,97.6,3820,1893,1927,98.2
서울특별시,도봉구,22세,2019,4336,2141,2195,97.5,4254,2121,2133,99.4
서울특별시,도봉구,23세,2019,4451,2125,2326,91.4,4353,2086,2267,92
서울특별시,도봉구,24세,2019,4523,2227,2296,97,4431,2192,2239,97.9
서울특별시,도봉구,25~29세,2019,22651,11480,11171,102.8,22169,11289,10880,103.8
서울특별시,도봉구,25세,2019,4539,2304,2235,103.1,4453,2267,2186,103.7
서울특별시,도봉구,26세,2019,4759,2453,2306,106.4,4665,2409,2256,106.8
서울특별시,도봉구,27세,2019,4766,2389,2377,100.5,4664,2351,2313,101.6
서울특별시,도봉구,28세,2019,4482,2255,2227,101.3,4391,2224,2167,102.6
서울특별시,도봉구,29세,2019,4105,2079,2026,102.6,3996,2038,1958,104.1
서울특별시,도봉구,30~34세,2019,19403,9870,9533,103.5,18912,9668,9244,104.6
서울특별시,도봉구,30세,2019,4014,2034,1980,102.7,3910,1998,1912,104.5
서울특별시,도봉구,31세,2019,3898,1987,1911,104,3795,1939,1856,104.5
서울특별시,도봉구,32세,2019,3730,1914,1816,105.4,3629,1877,1752,107.1
서울특별시,도봉구,33세,2019,3806,1935,1871,103.4,3718,1893,1825,103.7
서울특별시,도봉구,34세,2019,3955,2000,1955,102.3,3860,1961,1899,103.3
서울특별시,도봉구,35~39세,2019,22736,11661,11075,105.3,22383,11514,10869,105.9
서울특별시,도봉구,35세,2019,3988,2076,1912,108.6,3908,2046,1862,109.9
서울특별시,도봉구,36세,2019,4439,2313,2126,108.8,4352,2279,2073,109.9
서울특별시,도봉구,37세,2019,4810,2439,2371,102.9,4738,2401,2337,102.7
서울특별시,도봉구,38세,2019,4749,2413,2336,103.3,4683,2385,2298,103.8
서울특별시,도봉구,39세,2019,4750,2420,2330,103.9,4702,2403,2299,104.5
서울특별시,도봉구,40~44세,2019,21622,10764,10858,99.1,21335,10657,10678,99.8
서울특별시,도봉구,40세,2019,4508,2271,2237,101.5,4439,2238,2201,101.7
서울특별시,도봉구,41세,2019,4021,2006,2015,99.6,3953,1979,1974,100.3
서울특별시,도봉구,42세,2019,4273,2185,2088,104.6,4222,2167,2055,105.5
서울특별시,도봉구,43세,2019,4254,2121,2133,99.4,4199,2105,2094,100.5
서울특별시,도봉구,44세,2019,4566,2181,2385,91.4,4522,2168,2354,92.1
서울특별시,도봉구,45~49세,2019,27430,13370,14060,95.1,27149,13234,13915,95.1
서울특별시,도봉구,45세,2019,5060,2540,2520,100.8,5011,2516,2495,100.8
서울특별시,도봉구,46세,2019,5308,2528,2780,90.9,5256,2501,2755,90.8
서울특별시,도봉구,47세,2019,5379,2688,2691,99.9,5323,2657,2666,99.7
서울특별시,도봉구,48세,2019,5890,2832,3058,92.6,5823,2800,3023,92.6
서울특별시,도봉구,49세,2019,5793,2782,3011,92.4,5736,2760,2976,92.7
서울특별시,도봉구,50~54세,2019,27835,13136,14699,89.4,27592,13031,14561,89.5
서울특별시,도봉구,50세,2019,5766,2712,3054,88.8,5724,2691,3033,88.7
서울특별시,도봉구,51세,2019,5888,2778,3110,89.3,5834,2755,3079,89.5
서울특별시,도봉구,52세,2019,5412,2516,2896,86.9,5358,2492,2866,87
서울특별시,도봉구,53세,2019,5276,2565,2711,94.6,5232,2550,2682,95.1
서울특별시,도봉구,54세,2019,5493,2565,2928,87.6,5444,2543,2901,87.7
서울특별시,도봉구,55~59세,2019,29049,13752,15297,89.9,28837,13654,15183,89.9
서울특별시,도봉구,55세,2019,5165,2472,2693,91.8,5130,2454,2676,91.7
서울특별시,도봉구,56세,2019,5604,2761,2843,97.1,5555,2737,2818,97.1
서울특별시,도봉구,57세,2019,5685,2679,3006,89.1,5639,2665,2974,89.6
서울특별시,도봉구,58세,2019,6176,2839,3337,85.1,6134,2818,3316,85
서울특별시,도봉구,59세,2019,6419,3001,3418,87.8,6379,2980,3399,87.7
서울특별시,도봉구,60~64세,2019,27529,13100,14429,90.8,27359,13029,14330,90.9
서울특별시,도봉구,60세,2019,5847,2738,3109,88.1,5819,2730,3089,88.4
서울특별시,도봉구,61세,2019,5556,2628,2928,89.8,5518,2613,2905,89.9
서울특별시,도봉구,62세,2019,5677,2773,2904,95.5,5638,2753,2885,95.4
서울특별시,도봉구,63세,2019,5068,2398,2670,89.8,5026,2377,2649,89.7
서울특별시,도봉구,64세,2019,5381,2563,2818,91,5358,2556,2802,91.2
서울특별시,도봉구,65~69세,2019,18470,8973,9497,94.5,18371,8931,9440,94.6
서울특별시,도봉구,65세,2019,4308,2122,2186,97.1,4283,2112,2171,97.3
서울특별시,도봉구,66세,2019,3776,1853,1923,96.4,3759,1846,1913,96.5
서울특별시,도봉구,67세,2019,4159,1990,2169,91.7,4132,1976,2156,91.7
서울특별시,도봉구,68세,2019,2976,1441,1535,93.9,2958,1435,1523,94.2
서울특별시,도봉구,69세,2019,3251,1567,1684,93.1,3239,1562,1677,93.1
서울특별시,도봉구,70~74세,2019,14546,6784,7762,87.4,14498,6766,7732,87.5
서울특별시,도봉구,70세,2019,3152,1494,1658,90.1,3139,1487,1652,90
서울특별시,도봉구,71세,2019,3252,1547,1705,90.7,3244,1544,1700,90.8
서울특별시,도봉구,72세,2019,3250,1486,1764,84.2,3238,1483,1755,84.5
서울특별시,도봉구,73세,2019,2474,1151,1323,87,2469,1150,1319,87.2
서울특별시,도봉구,74세,2019,2418,1106,1312,84.3,2408,1102,1306,84.4
서울특별시,도봉구,75~79세,2019,11922,5353,6569,81.5,11898,5345,6553,81.6
서울특별시,도봉구,75세,2019,2384,1060,1324,80.1,2379,1058,1321,80.1
서울특별시,도봉구,76세,2019,2453,1090,1363,80,2448,1088,1360,80
서울특별시,도봉구,77세,2019,2861,1321,1540,85.8,2855,1320,1535,86
서울특별시,도봉구,78세,2019,2255,1031,1224,84.2,2252,1030,1222,84.3
서울특별시,도봉구,79세,2019,1969,851,1118,76.1,1964,849,1115,76.1
서울특별시,도봉구,80~84세,2019,7181,2858,4323,66.1,7169,2856,4313,66.2
서울특별시,도봉구,80세,2019,1894,804,1090,73.8,1889,803,1086,73.9
서울특별시,도봉구,81세,2019,1575,650,925,70.3,1573,650,923,70.4
서울특별시,도봉구,82세,2019,1428,560,868,64.5,1426,560,866,64.7
서울특별시,도봉구,83세,2019,1201,448,753,59.5,1200,447,753,59.4
서울특별시,도봉구,84세,2019,1083,396,687,57.6,1081,396,685,57.8
서울특별시,도봉구,85세이상,2019,4680,1389,3291,42.2,4669,1386,3283,42.2
서울특별시,도봉구,85~89세,2019,3262,1016,2246,45.2,3256,1016,2240,45.4
서울특별시,도봉구,85세,2019,882,283,599,47.2,882,283,599,47.2
서울특별시,도봉구,86세,2019,779,252,527,47.8,778,252,526,47.9
서울특별시,도봉구,87세,2019,679,206,473,43.6,679,206,473,43.6
서울특별시,도봉구,88세,2019,509,154,355,43.4,506,154,352,43.8
서울특별시,도봉구,89세,2019,413,121,292,41.4,411,121,290,41.7
서울특별시,도봉구,90~94세,2019,1119,304,815,37.3,1117,304,813,37.4
서울특별시,도봉구,90세,2019,368,103,265,38.9,367,103,264,39
서울특별시,도봉구,91세,2019,293,86,207,41.5,293,86,207,41.5
서울특별시,도봉구,92세,2019,215,58,157,36.9,215,58,157,36.9
서울특별시,도봉구,93세,2019,140,36,104,34.6,139,36,103,35
서울특별시,도봉구,94세,2019,103,21,82,25.6,103,21,82,25.6
서울특별시,도봉구,95~99세,2019,268,58,210,27.6,267,57,210,27.1
서울특별시,도봉구,95세,2019,77,13,64,20.3,77,13,64,20.3
서울특별시,도봉구,96세,2019,91,26,65,40,90,25,65,38.5
서울특별시,도봉구,97세,2019,52,13,39,33.3,52,13,39,33.3
서울특별시,도봉구,98세,2019,27,5,22,22.7,27,5,22,22.7
서울특별시,도봉구,99세,2019,21,X,20,5,21,X,20,5
서울특별시,도봉구,100세이상,2019,31,11,20,55,29,9,20,45
서울특별시,도봉구,15세미만,2019,31743,16410,15333,107,31621,16340,15281,106.9
서울특별시,도봉구,15~64세,2019,235001,115194,119807,96.1,231997,113957,118040,96.5
서울특별시,도봉구,65세이상,2019,56799,25357,31442,80.6,56605,25284,31321,80.7
서울특별시,도봉구,평균연령,2019,44.6,43.5,45.5,,44.6,43.6,45.6,
서울특별시,도봉구,중위연령,2019,46.3,45.1,47.5,,46.5,45.2,47.7,
서울특별시,노원구,합계,2019,522480,252662,269818,93.6,516201,249784,266417,93.8
서울특별시,노원구,0~4세,2019,15325,7858,7467,105.2,15197,7782,7415,104.9
서울특별시,노원구,0세,2019,2577,1341,1236,108.5,2553,1325,1228,107.9
서울특별시,노원구,1세,2019,2736,1418,1318,107.6,2708,1404,1304,107.7
서울특별시,노원구,2세,2019,3057,1528,1529,99.9,3024,1504,1520,98.9
서울특별시,노원구,3세,2019,3329,1687,1642,102.7,3311,1676,1635,102.5
서울특별시,노원구,4세,2019,3626,1884,1742,108.2,3601,1873,1728,108.4
서울특별시,노원구,5~9세,2019,19807,10238,9569,107,19708,10187,9521,107
서울특별시,노원구,5세,2019,3639,1880,1759,106.9,3611,1866,1745,106.9
서울특별시,노원구,6세,2019,3646,1896,1750,108.3,3625,1882,1743,108
서울특별시,노원구,7세,2019,4139,2158,1981,108.9,4118,2149,1969,109.1
서울특별시,노원구,8세,2019,4136,2119,2017,105.1,4123,2113,2010,105.1
서울특별시,노원구,9세,2019,4247,2185,2062,106,4231,2177,2054,106
서울특별시,노원구,10~14세,2019,24001,12466,11535,108.1,23968,12447,11521,108
서울특별시,노원구,10세,2019,4177,2136,2041,104.7,4166,2130,2036,104.6
서울특별시,노원구,11세,2019,4780,2489,2291,108.6,4777,2487,2290,108.6
서울특별시,노원구,12세,2019,5113,2637,2476,106.5,5107,2633,2474,106.4
서울특별시,노원구,13세,2019,4883,2574,2309,111.5,4877,2571,2306,111.5
서울특별시,노원구,14세,2019,5048,2630,2418,108.8,5041,2626,2415,108.7
서울특별시,노원구,15~19세,2019,32051,16510,15541,106.2,31706,16357,15349,106.6
서울특별시,노원구,15세,2019,5600,2907,2693,107.9,5589,2901,2688,107.9
서울특별시,노원구,16세,2019,5540,2911,2629,110.7,5527,2904,2623,110.7
서울특별시,노원구,17세,2019,5771,2992,2779,107.7,5749,2981,2768,107.7
서울특별시,노원구,18세,2019,6926,3580,3346,107,6832,3543,3289,107.7
서울특별시,노원구,19세,2019,8214,4120,4094,100.6,8009,4028,3981,101.2
서울특별시,노원구,20~24세,2019,41209,20761,20448,101.5,39751,20072,19679,102
서울특별시,노원구,20세,2019,7829,3753,4076,92.1,7500,3616,3884,93.1
서울특별시,노원구,21세,2019,8196,3975,4221,94.2,7840,3816,4024,94.8
서울특별시,노원구,22세,2019,8455,4225,4230,99.9,8172,4072,4100,99.3
서울특별시,노원구,23세,2019,8479,4390,4089,107.4,8227,4262,3965,107.5
서울특별시,노원구,24세,2019,8250,4418,3832,115.3,8012,4306,3706,116.2
서울특별시,노원구,25~29세,2019,35048,18323,16725,109.6,34158,17900,16258,110.1
서울특별시,노원구,25세,2019,7807,4217,3590,117.5,7581,4108,3473,118.3
서울특별시,노원구,26세,2019,7461,3993,3468,115.1,7281,3902,3379,115.5
서울특별시,노원구,27세,2019,7100,3708,3392,109.3,6936,3630,3306,109.8
서울특별시,노원구,28세,2019,6518,3291,3227,102,6364,3222,3142,102.5
서울특별시,노원구,29세,2019,6162,3114,3048,102.2,5996,3038,2958,102.7
서울특별시,노원구,30~34세,2019,29778,14949,14829,100.8,29011,14615,14396,101.5
서울특별시,노원구,30세,2019,5908,2988,2920,102.3,5744,2918,2826,103.3
서울특별시,노원구,31세,2019,5848,2922,2926,99.9,5698,2864,2834,101.1
서울특별시,노원구,32세,2019,5842,2932,2910,100.8,5681,2859,2822,101.3
서울특별시,노원구,33세,2019,6090,3025,3065,98.7,5946,2960,2986,99.1
서울특별시,노원구,34세,2019,6090,3082,3008,102.5,5942,3014,2928,102.9
서울특별시,노원구,35~39세,2019,35890,17724,18166,97.6,35320,17476,17844,97.9
서울특별시,노원구,35세,2019,6187,3071,3116,98.6,6070,3014,3056,98.6
서울특별시,노원구,36세,2019,6952,3476,3476,100,6824,3421,3403,100.5
서울특별시,노원구,37세,2019,7447,3700,3747,98.7,7330,3651,3679,99.2
서울특별시,노원구,38세,2019,7443,3724,3719,100.1,7321,3668,3653,100.4
서울특별시,노원구,39세,2019,7861,3753,4108,91.4,7775,3722,4053,91.8
서울특별시,노원구,40~44세,2019,37997,18185,19812,91.8,37516,17947,19569,91.7
서울특별시,노원구,40세,2019,7600,3724,3876,96.1,7497,3672,3825,96
서울특별시,노원구,41세,2019,7001,3395,3606,94.1,6900,3342,3558,93.9
서울특별시,노원구,42세,2019,7607,3570,4037,88.4,7512,3527,3985,88.5
서울특별시,노원구,43세,2019,7423,3588,3835,93.6,7338,3548,3790,93.6
서울특별시,노원구,44세,2019,8366,3908,4458,87.7,8269,3858,4411,87.5
서울특별시,노원구,45~49세,2019,49258,23507,25751,91.3,48848,23310,25538,91.3
서울특별시,노원구,45세,2019,9119,4324,4795,90.2,9043,4288,4755,90.2
서울특별시,노원구,46세,2019,9635,4585,5050,90.8,9566,4560,5006,91.1
서울특별시,노원구,47세,2019,9707,4612,5095,90.5,9634,4569,5065,90.2
서울특별시,노원구,48세,2019,10666,5111,5555,92,10567,5062,5505,92
서울특별시,노원구,49세,2019,10131,4875,5256,92.8,10038,4831,5207,92.8
서울특별시,노원구,50~54세,2019,44860,21811,23049,94.6,44478,21635,22843,94.7
서울특별시,노원구,50세,2019,9932,4858,5074,95.7,9836,4812,5024,95.8
서울특별시,노원구,51세,2019,9653,4627,5026,92.1,9576,4590,4986,92.1
서울특별시,노원구,52세,2019,8680,4233,4447,95.2,8612,4204,4408,95.4
서울특별시,노원구,53세,2019,8262,4100,4162,98.5,8192,4063,4129,98.4
서울특별시,노원구,54세,2019,8333,3993,4340,92,8262,3966,4296,92.3
서울특별시,노원구,55~59세,2019,42037,20129,21908,91.9,41718,20010,21708,92.2
서울특별시,노원구,55세,2019,7752,3811,3941,96.7,7678,3783,3895,97.1
서울특별시,노원구,56세,2019,8279,3935,4344,90.6,8193,3909,4284,91.2
서울특별시,노원구,57세,2019,8310,4031,4279,94.2,8245,4001,4244,94.3
서울특별시,노원구,58세,2019,8816,4220,4596,91.8,8774,4205,4569,92
서울특별시,노원구,59세,2019,8880,4132,4748,87,8828,4112,4716,87.2
서울특별시,노원구,60~64세,2019,37500,17453,20047,87.1,37323,17386,19937,87.2
서울특별시,노원구,60세,2019,8023,3728,4295,86.8,7985,3710,4275,86.8
서울특별시,노원구,61세,2019,7678,3608,4070,88.6,7640,3594,4046,88.8
서울특별시,노원구,62세,2019,7603,3557,4046,87.9,7569,3543,4026,88
서울특별시,노원구,63세,2019,6973,3250,3723,87.3,6938,3241,3697,87.7
서울특별시,노원구,64세,2019,7223,3310,3913,84.6,7191,3298,3893,84.7
서울특별시,노원구,65~69세,2019,25548,12011,13537,88.7,25438,11967,13471,88.8
서울특별시,노원구,65세,2019,6050,2860,3190,89.7,6018,2847,3171,89.8
서울특별시,노원구,66세,2019,5175,2471,2704,91.4,5149,2462,2687,91.6
서울특별시,노원구,67세,2019,5769,2719,3050,89.1,5741,2708,3033,89.3
서울특별시,노원구,68세,2019,4076,1880,2196,85.6,4060,1874,2186,85.7
서울특별시,노원구,69세,2019,4478,2081,2397,86.8,4470,2076,2394,86.7
서울특별시,노원구,70~74세,2019,19651,8714,10937,79.7,19604,8690,10914,79.6
서울특별시,노원구,70세,2019,4519,2054,2465,83.3,4503,2045,2458,83.2
서울특별시,노원구,71세,2019,4265,1949,2316,84.2,4255,1947,2308,84.4
서울특별시,노원구,72세,2019,4338,1878,2460,76.3,4330,1873,2457,76.2
서울특별시,노원구,73세,2019,3356,1431,1925,74.3,3347,1425,1922,74.1
서울특별시,노원구,74세,2019,3173,1402,1771,79.2,3169,1400,1769,79.1
서울특별시,노원구,75~79세,2019,15818,6549,9269,70.7,15784,6536,9248,70.7
서울특별시,노원구,75세,2019,3198,1345,1853,72.6,3186,1338,1848,72.4
서울특별시,노원구,76세,2019,3284,1394,1890,73.8,3276,1392,1884,73.9
서울특별시,노원구,77세,2019,3722,1566,2156,72.6,3717,1564,2153,72.6
서울특별시,노원구,78세,2019,2954,1158,1796,64.5,2949,1157,1792,64.6
서울특별시,노원구,79세,2019,2660,1086,1574,69,2656,1085,1571,69.1
서울특별시,노원구,80~84세,2019,10034,3585,6449,55.6,10021,3583,6438,55.7
서울특별시,노원구,80세,2019,2523,975,1548,63,2518,974,1544,63.1
서울특별시,노원구,81세,2019,2264,823,1441,57.1,2261,822,1439,57.1
서울특별시,노원구,82세,2019,1977,712,1265,56.3,1976,712,1264,56.3
서울특별시,노원구,83세,2019,1706,591,1115,53,1703,591,1112,53.1
서울특별시,노원구,84세,2019,1564,484,1080,44.8,1563,484,1079,44.9
서울특별시,노원구,85세이상,2019,6668,1889,4779,39.5,6652,1884,4768,39.5
서울특별시,노원구,85~89세,2019,4688,1421,3267,43.5,4680,1418,3262,43.5
서울특별시,노원구,85세,2019,1314,419,895,46.8,1310,417,893,46.7
서울특별시,노원구,86세,2019,1068,334,734,45.5,1068,334,734,45.5
서울특별시,노원구,87세,2019,948,289,659,43.9,945,288,657,43.8
서울특별시,노원구,88세,2019,698,189,509,37.1,697,189,508,37.2
서울특별시,노원구,89세,2019,660,190,470,40.4,660,190,470,40.4
서울특별시,노원구,90~94세,2019,1568,373,1195,31.2,1563,371,1192,31.1
서울특별시,노원구,90세,2019,494,145,349,41.5,491,143,348,41.1
서울특별시,노원구,91세,2019,412,99,313,31.6,412,99,313,31.6
서울특별시,노원구,92세,2019,319,67,252,26.6,318,67,251,26.7
서울특별시,노원구,93세,2019,202,38,164,23.2,201,38,163,23.3
서울특별시,노원구,94세,2019,141,24,117,20.5,141,24,117,20.5
서울특별시,노원구,95~99세,2019,362,89,273,32.6,361,89,272,32.7
서울특별시,노원구,95세,2019,124,31,93,33.3,124,31,93,33.3
서울특별시,노원구,96세,2019,102,25,77,32.5,102,25,77,32.5
서울특별시,노원구,97세,2019,55,16,39,41,55,16,39,41
서울특별시,노원구,98세,2019,46,5,41,12.2,45,5,40,12.5
서울특별시,노원구,99세,2019,35,12,23,52.2,35,12,23,52.2
서울특별시,노원구,100세이상,2019,50,6,44,13.6,48,6,42,14.3
서울특별시,노원구,15세미만,2019,59133,30562,28571,107,58873,30416,28457,106.9
서울특별시,노원구,15~64세,2019,385628,189352,196276,96.5,379829,186708,193121,96.7
서울특별시,노원구,65세이상,2019,77719,32748,44971,72.8,77499,32660,44839,72.8
서울특별시,노원구,평균연령,2019,42.3,41,43.6,,42.4,41.1,43.7,
서울특별시,노원구,중위연령,2019,43.8,42.1,45.2,,44,42.3,45.3,
서울특별시,은평구,합계,2019,461530,222076,239454,92.7,455140,219283,235857,93
서울특별시,은평구,0~4세,2019,14470,7394,7076,104.5,14301,7307,6994,104.5
서울특별시,은평구,0세,2019,2452,1274,1178,108.1,2428,1261,1167,108.1
서울특별시,은평구,1세,2019,2658,1337,1321,101.2,2622,1321,1301,101.5
서울특별시,은평구,2세,2019,2820,1467,1353,108.4,2776,1441,1335,107.9
서울특별시,은평구,3세,2019,3167,1601,1566,102.2,3135,1587,1548,102.5
서울특별시,은평구,4세,2019,3373,1715,1658,103.4,3340,1697,1643,103.3
서울특별시,은평구,5~9세,2019,16751,8651,8100,106.8,16655,8603,8052,106.8
서울특별시,은평구,5세,2019,3188,1664,1524,109.2,3167,1656,1511,109.6
서울특별시,은평구,6세,2019,3192,1668,1524,109.4,3167,1657,1510,109.7
서울특별시,은평구,7세,2019,3536,1834,1702,107.8,3504,1816,1688,107.6
서울특별시,은평구,8세,2019,3422,1748,1674,104.4,3415,1745,1670,104.5
서울특별시,은평구,9세,2019,3413,1737,1676,103.6,3402,1729,1673,103.3
서울특별시,은평구,10~14세,2019,17385,9023,8362,107.9,17312,8981,8331,107.8
서울특별시,은평구,10세,2019,3363,1728,1635,105.7,3352,1723,1629,105.8
서울특별시,은평구,11세,2019,3484,1776,1708,104,3469,1768,1701,103.9
서울특별시,은평구,12세,2019,3730,1971,1759,112.1,3716,1962,1754,111.9
서울특별시,은평구,13세,2019,3472,1775,1697,104.6,3460,1768,1692,104.5
서울특별시,은평구,14세,2019,3336,1773,1563,113.4,3315,1760,1555,113.2
서울특별시,은평구,15~19세,2019,21869,11085,10784,102.8,21630,10972,10658,102.9
서울특별시,은평구,15세,2019,3901,1988,1913,103.9,3873,1974,1899,103.9
서울특별시,은평구,16세,2019,4083,2111,1972,107,4056,2098,1958,107.2
서울특별시,은평구,17세,2019,4315,2192,2123,103.3,4278,2175,2103,103.4
서울특별시,은평구,18세,2019,4644,2305,2339,98.5,4581,2285,2296,99.5
서울특별시,은평구,19세,2019,4926,2489,2437,102.1,4842,2440,2402,101.6
서울특별시,은평구,20~24세,2019,27888,13650,14238,95.9,27414,13493,13921,96.9
서울특별시,은평구,20세,2019,5047,2554,2493,102.4,4996,2536,2460,103.1
서울특별시,은평구,21세,2019,5112,2591,2521,102.8,5015,2552,2463,103.6
서울특별시,은평구,22세,2019,5567,2709,2858,94.8,5475,2686,2789,96.3
서울특별시,은평구,23세,2019,5922,2791,3131,89.1,5807,2761,3046,90.6
서울특별시,은평구,24세,2019,6240,3005,3235,92.9,6121,2958,3163,93.5
서울특별시,은평구,25~29세,2019,34413,16508,17905,92.2,33611,16187,17424,92.9
서울특별시,은평구,25세,2019,6660,3164,3496,90.5,6516,3106,3410,91.1
서울특별시,은평구,26세,2019,7009,3336,3673,90.8,6848,3275,3573,91.7
서울특별시,은평구,27세,2019,7175,3476,3699,94,7029,3410,3619,94.2
서울특별시,은평구,28세,2019,6989,3378,3611,93.5,6826,3313,3513,94.3
서울특별시,은평구,29세,2019,6580,3154,3426,92.1,6392,3083,3309,93.2
서울특별시,은평구,30~34세,2019,31221,15167,16054,94.5,30322,14800,15522,95.3
서울특별시,은평구,30세,2019,6255,3001,3254,92.2,6071,2930,3141,93.3
서울특별시,은평구,31세,2019,6146,2983,3163,94.3,5974,2921,3053,95.7
서울특별시,은평구,32세,2019,6247,3007,3240,92.8,6053,2926,3127,93.6
서울특별시,은평구,33세,2019,6206,3006,3200,93.9,6021,2925,3096,94.5
서울특별시,은평구,34세,2019,6367,3170,3197,99.2,6203,3098,3105,99.8
서울특별시,은평구,35~39세,2019,36871,18576,18295,101.5,36152,18256,17896,102
서울특별시,은평구,35세,2019,6540,3231,3309,97.6,6379,3153,3226,97.7
서울특별시,은평구,36세,2019,7144,3583,3561,100.6,7015,3529,3486,101.2
서울특별시,은평구,37세,2019,7679,3914,3765,104,7513,3837,3676,104.4
서울특별시,은평구,38세,2019,7709,3923,3786,103.6,7579,3869,3710,104.3
서울특별시,은평구,39세,2019,7799,3925,3874,101.3,7666,3868,3798,101.8
서울특별시,은평구,40~44세,2019,34139,16983,17156,99,33644,16741,16903,99
서울특별시,은평구,40세,2019,7192,3607,3585,100.6,7069,3553,3516,101.1
서울특별시,은평구,41세,2019,6382,3159,3223,98,6295,3122,3173,98.4
서울특별시,은평구,42세,2019,6829,3393,3436,98.7,6742,3344,3398,98.4
서울특별시,은평구,43세,2019,6712,3377,3335,101.3,6609,3322,3287,101.1
서울특별시,은평구,44세,2019,7024,3447,3577,96.4,6929,3400,3529,96.3
서울특별시,은평구,45~49세,2019,40411,19876,20535,96.8,39903,19647,20256,97
서울특별시,은평구,45세,2019,7837,3866,3971,97.4,7745,3827,3918,97.7
서울특별시,은평구,46세,2019,7992,3956,4036,98,7910,3916,3994,98
서울특별시,은평구,47세,2019,8067,4004,4063,98.5,7961,3952,4009,98.6
서울특별시,은평구,48세,2019,8572,4214,4358,96.7,8460,4164,4296,96.9
서울특별시,은평구,49세,2019,7943,3836,4107,93.4,7827,3788,4039,93.8
서울특별시,은평구,50~54세,2019,37344,18001,19343,93.1,36836,17767,19069,93.2
서울특별시,은평구,50세,2019,8206,4014,4192,95.8,8092,3954,4138,95.6
서울특별시,은평구,51세,2019,7854,3768,4086,92.2,7733,3721,4012,92.7
서울특별시,은평구,52세,2019,7274,3503,3771,92.9,7190,3459,3731,92.7
서울특별시,은평구,53세,2019,6914,3365,3549,94.8,6839,3327,3512,94.7
서울특별시,은평구,54세,2019,7096,3351,3745,89.5,6982,3306,3676,89.9
서울특별시,은평구,55~59세,2019,37378,17630,19748,89.3,36874,17390,19484,89.3
서울특별시,은평구,55세,2019,6866,3293,3573,92.2,6747,3236,3511,92.2
서울특별시,은평구,56세,2019,7193,3437,3756,91.5,7054,3369,3685,91.4
서울특별시,은평구,57세,2019,7296,3494,3802,91.9,7198,3448,3750,91.9
서울특별시,은평구,58세,2019,7928,3705,4223,87.7,7850,3668,4182,87.7
서울특별시,은평구,59세,2019,8095,3701,4394,84.2,8025,3669,4356,84.2
서울특별시,은평구,60~64세,2019,34572,16207,18365,88.2,34119,16001,18118,88.3
서울특별시,은평구,60세,2019,7487,3551,3936,90.2,7377,3497,3880,90.1
서울특별시,은평구,61세,2019,7007,3248,3759,86.4,6920,3209,3711,86.5
서울특별시,은평구,62세,2019,6906,3223,3683,87.5,6820,3184,3636,87.6
서울특별시,은평구,63세,2019,6444,3032,3412,88.9,6357,2991,3366,88.9
서울특별시,은평구,64세,2019,6728,3153,3575,88.2,6645,3120,3525,88.5
서울특별시,은평구,65~69세,2019,24430,11116,13314,83.5,24206,11016,13190,83.5
서울특별시,은평구,65세,2019,5677,2544,3133,81.2,5608,2519,3089,81.5
서울특별시,은평구,66세,2019,5081,2277,2804,81.2,5038,2253,2785,80.9
서울특별시,은평구,67세,2019,5292,2506,2786,89.9,5239,2482,2757,90
서울특별시,은평구,68세,2019,3972,1773,2199,80.6,3939,1756,2183,80.4
서울특별시,은평구,69세,2019,4408,2016,2392,84.3,4382,2006,2376,84.4
서울특별시,은평구,70~74세,2019,20445,9097,11348,80.2,20347,9057,11290,80.2
서울특별시,은평구,70세,2019,4546,2009,2537,79.2,4522,2004,2518,79.6
서울특별시,은평구,71세,2019,4461,2006,2455,81.7,4434,1997,2437,81.9
서울특별시,은평구,72세,2019,4514,2019,2495,80.9,4495,2009,2486,80.8
서울특별시,은평구,73세,2019,3529,1572,1957,80.3,3511,1561,1950,80.1
서울특별시,은평구,74세,2019,3395,1491,1904,78.3,3385,1486,1899,78.3
서울특별시,은평구,75~79세,2019,16466,7324,9142,80.1,16403,7301,9102,80.2
서울특별시,은평구,75세,2019,3356,1459,1897,76.9,3340,1456,1884,77.3
서울특별시,은평구,76세,2019,3428,1481,1947,76.1,3416,1475,1941,76
서울특별시,은평구,77세,2019,3923,1745,2178,80.1,3912,1739,2173,80
서울특별시,은평구,78세,2019,3033,1376,1657,83,3019,1372,1647,83.3
서울특별시,은평구,79세,2019,2726,1263,1463,86.3,2716,1259,1457,86.4
서울특별시,은평구,80~84세,2019,9857,4026,5831,69,9818,4010,5808,69
서울특별시,은평구,80세,2019,2533,1057,1476,71.6,2525,1053,1472,71.5
서울특별시,은평구,81세,2019,2168,912,1256,72.6,2157,907,1250,72.6
서울특별시,은평구,82세,2019,1998,825,1173,70.3,1987,821,1166,70.4
서울특별시,은평구,83세,2019,1688,652,1036,62.9,1683,651,1032,63.1
서울특별시,은평구,84세,2019,1470,580,890,65.2,1466,578,888,65.1
서울특별시,은평구,85세이상,2019,5620,1762,3858,45.7,5593,1754,3839,45.7
서울특별시,은평구,85~89세,2019,3916,1319,2597,50.8,3898,1313,2585,50.8
서울특별시,은평구,85세,2019,1160,438,722,60.7,1155,437,718,60.9
서울특별시,은평구,86세,2019,886,307,579,53,883,307,576,53.3
서울특별시,은평구,87세,2019,775,265,510,52,768,261,507,51.5
서울특별시,은평구,88세,2019,602,175,427,41,601,175,426,41.1
서울특별시,은평구,89세,2019,493,134,359,37.3,491,133,358,37.2
서울특별시,은평구,90~94세,2019,1375,362,1013,35.7,1367,360,1007,35.7
서울특별시,은평구,90세,2019,444,140,304,46.1,443,140,303,46.2
서울특별시,은평구,91세,2019,357,101,256,39.5,356,101,255,39.6
서울특별시,은평구,92세,2019,274,55,219,25.1,270,54,216,25
서울특별시,은평구,93세,2019,165,41,124,33.1,164,40,124,32.3
서울특별시,은평구,94세,2019,135,25,110,22.7,134,25,109,22.9
서울특별시,은평구,95~99세,2019,299,77,222,34.7,298,77,221,34.8
서울특별시,은평구,95세,2019,116,31,85,36.5,116,31,85,36.5
서울특별시,은평구,96세,2019,86,24,62,38.7,85,24,61,39.3
서울특별시,은평구,97세,2019,50,12,38,31.6,50,12,38,31.6
서울특별시,은평구,98세,2019,29,6,23,26.1,29,6,23,26.1
서울특별시,은평구,99세,2019,18,X,14,28.6,18,X,14,28.6
서울특별시,은평구,100세이상,2019,30,X,26,15.4,30,X,26,15.4
서울특별시,은평구,15세미만,2019,48606,25068,23538,106.5,48268,24891,23377,106.5
서울특별시,은평구,15~64세,2019,336106,163683,172423,94.9,330505,161254,169251,95.3
서울특별시,은평구,65세이상,2019,76818,33325,43493,76.6,76367,33138,43229,76.7
서울특별시,은평구,평균연령,2019,43.5,42.5,44.5,,43.6,42.5,44.5,
서울특별시,은평구,중위연령,2019,44.4,43.2,45.4,,44.5,43.3,45.6,
서울특별시,서대문구,합계,2019,319394,149113,170281,87.6,303075,143082,159993,89.4
서울특별시,서대문구,0~4세,2019,9696,5003,4693,106.6,9253,4780,4473,106.9
서울특별시,서대문구,0세,2019,1646,847,799,106,1606,823,783,105.1
서울특별시,서대문구,1세,2019,1818,977,841,116.2,1752,943,809,116.6
서울특별시,서대문구,2세,2019,1875,1005,870,115.5,1774,944,830,113.7
서울특별시,서대문구,3세,2019,2152,1075,1077,99.8,2023,1025,998,102.7
서울특별시,서대문구,4세,2019,2205,1099,1106,99.4,2098,1045,1053,99.2
서울특별시,서대문구,5~9세,2019,10510,5338,5172,103.2,10229,5188,5041,102.9
서울특별시,서대문구,5세,2019,2158,1080,1078,100.2,2092,1047,1045,100.2
서울특별시,서대문구,6세,2019,2046,1051,995,105.6,1982,1016,966,105.2
서울특별시,서대문구,7세,2019,2190,1107,1083,102.2,2138,1083,1055,102.7
서울특별시,서대문구,8세,2019,2076,1033,1043,99,2024,1000,1024,97.7
서울특별시,서대문구,9세,2019,2040,1067,973,109.7,1993,1042,951,109.6
서울특별시,서대문구,10~14세,2019,10389,5218,5171,100.9,10166,5114,5052,101.2
서울특별시,서대문구,10세,2019,2075,1034,1041,99.3,2039,1020,1019,100.1
서울특별시,서대문구,11세,2019,2016,1021,995,102.6,1965,995,970,102.6
서울특별시,서대문구,12세,2019,2122,1055,1067,98.9,2076,1036,1040,99.6
서울특별시,서대문구,13세,2019,2138,1093,1045,104.6,2088,1067,1021,104.5
서울특별시,서대문구,14세,2019,2038,1015,1023,99.2,1998,996,1002,99.4
서울특별시,서대문구,15~19세,2019,16127,7193,8934,80.5,15117,6909,8208,84.2
서울특별시,서대문구,15세,2019,2308,1167,1141,102.3,2261,1141,1120,101.9
서울특별시,서대문구,16세,2019,2545,1311,1234,106.2,2501,1285,1216,105.7
서울특별시,서대문구,17세,2019,2549,1316,1233,106.7,2472,1281,1191,107.6
서울특별시,서대문구,18세,2019,3389,1551,1838,84.4,3151,1494,1657,90.2
서울특별시,서대문구,19세,2019,5336,1848,3488,53,4732,1708,3024,56.5
서울특별시,서대문구,20~24세,2019,33354,12781,20573,62.1,28382,11505,16877,68.2
서울특별시,서대문구,20세,2019,6105,2158,3947,54.7,5184,1952,3232,60.4
서울특별시,서대문구,21세,2019,6331,2257,4074,55.4,5301,1973,3328,59.3
서울특별시,서대문구,22세,2019,6738,2488,4250,58.5,5687,2214,3473,63.7
서울특별시,서대문구,23세,2019,7123,2841,4282,66.3,6095,2580,3515,73.4
서울특별시,서대문구,24세,2019,7057,3037,4020,75.5,6115,2786,3329,83.7
서울특별시,서대문구,25~29세,2019,29777,14446,15331,94.2,27149,13605,13544,100.5
서울특별시,서대문구,25세,2019,6603,3029,3574,84.8,5936,2847,3089,92.2
서울특별시,서대문구,26세,2019,6547,3175,3372,94.2,5925,2984,2941,101.5
서울특별시,서대문구,27세,2019,6010,3003,3007,99.9,5515,2853,2662,107.2
서울특별시,서대문구,28세,2019,5642,2775,2867,96.8,5217,2621,2596,101
서울특별시,서대문구,29세,2019,4975,2464,2511,98.1,4556,2300,2256,102
서울특별시,서대문구,30~34세,2019,21915,10846,11069,98,20299,10152,10147,100
서울특별시,서대문구,30세,2019,4634,2319,2315,100.2,4234,2169,2065,105
서울특별시,서대문구,31세,2019,4397,2129,2268,93.9,4071,1988,2083,95.4
서울특별시,서대문구,32세,2019,4359,2163,2196,98.5,4026,2013,2013,100
서울특별시,서대문구,33세,2019,4204,2112,2092,101,3924,1978,1946,101.6
서울특별시,서대문구,34세,2019,4321,2123,2198,96.6,4044,2004,2040,98.2
서울특별시,서대문구,35~39세,2019,23282,11535,11747,98.2,22173,11013,11160,98.7
서울특별시,서대문구,35세,2019,4213,2041,2172,94,3991,1939,2052,94.5
서울특별시,서대문구,36세,2019,4632,2368,2264,104.6,4375,2239,2136,104.8
서울특별시,서대문구,37세,2019,4816,2328,2488,93.6,4590,2219,2371,93.6
서울특별시,서대문구,38세,2019,4813,2435,2378,102.4,4604,2337,2267,103.1
서울특별시,서대문구,39세,2019,4808,2363,2445,96.6,4613,2279,2334,97.6
서울특별시,서대문구,40~44세,2019,21249,10623,10626,100,20427,10237,10190,100.5
서울특별시,서대문구,40세,2019,4465,2226,2239,99.4,4265,2141,2124,100.8
서울특별시,서대문구,41세,2019,4034,2012,2022,99.5,3866,1930,1936,99.7
서울특별시,서대문구,42세,2019,4223,2107,2116,99.6,4055,2016,2039,98.9
서울특별시,서대문구,43세,2019,4158,2086,2072,100.7,4030,2033,1997,101.8
서울특별시,서대문구,44세,2019,4369,2192,2177,100.7,4211,2117,2094,101.1
서울특별시,서대문구,45~49세,2019,25370,12489,12881,97,24491,12032,12459,96.6
서울특별시,서대문구,45세,2019,4790,2344,2446,95.8,4631,2257,2374,95.1
서울특별시,서대문구,46세,2019,4788,2293,2495,91.9,4622,2206,2416,91.3
서울특별시,서대문구,47세,2019,5086,2564,2522,101.7,4899,2467,2432,101.4
서울특별시,서대문구,48세,2019,5491,2759,2732,101,5288,2657,2631,101
서울특별시,서대문구,49세,2019,5215,2529,2686,94.2,5051,2445,2606,93.8
서울특별시,서대문구,50~54세,2019,24088,11566,12522,92.4,23411,11240,12171,92.4
서울특별시,서대문구,50세,2019,5145,2439,2706,90.1,5004,2375,2629,90.3
서울특별시,서대문구,51세,2019,5055,2433,2622,92.8,4901,2353,2548,92.3
서울특별시,서대문구,52세,2019,4705,2201,2504,87.9,4596,2152,2444,88.1
서울특별시,서대문구,53세,2019,4476,2317,2159,107.3,4340,2254,2086,108.1
서울특별시,서대문구,54세,2019,4707,2176,2531,86,4570,2106,2464,85.5
서울특별시,서대문구,55~59세,2019,23621,11310,12311,91.9,22982,11004,11978,91.9
서울특별시,서대문구,55세,2019,4429,2110,2319,91,4303,2040,2263,90.1
서울특별시,서대문구,56세,2019,4661,2275,2386,95.3,4505,2203,2302,95.7
서울특별시,서대문구,57세,2019,4615,2243,2372,94.6,4477,2182,2295,95.1
서울특별시,서대문구,58세,2019,4965,2361,2604,90.7,4843,2306,2537,90.9
서울특별시,서대문구,59세,2019,4951,2321,2630,88.3,4854,2273,2581,88.1
서울특별시,서대문구,60~64세,2019,21070,9998,11072,90.3,20590,9775,10815,90.4
서울특별시,서대문구,60세,2019,4589,2174,2415,90,4494,2130,2364,90.1
서울특별시,서대문구,61세,2019,4371,2129,2242,95,4251,2075,2176,95.4
서울특별시,서대문구,62세,2019,4210,2003,2207,90.8,4112,1951,2161,90.3
서울특별시,서대문구,63세,2019,3844,1800,2044,88.1,3769,1771,1998,88.6
서울특별시,서대문구,64세,2019,4056,1892,2164,87.4,3964,1848,2116,87.3
서울특별시,서대문구,65~69세,2019,14587,6678,7909,84.4,14312,6542,7770,84.2
서울특별시,서대문구,65세,2019,3357,1580,1777,88.9,3282,1545,1737,88.9
서울특별시,서대문구,66세,2019,3012,1402,1610,87.1,2934,1365,1569,87
서울특별시,서대문구,67세,2019,3171,1441,1730,83.3,3120,1418,1702,83.3
서울특별시,서대문구,68세,2019,2353,1104,1249,88.4,2317,1079,1238,87.2
서울특별시,서대문구,69세,2019,2694,1151,1543,74.6,2659,1135,1524,74.5
서울특별시,서대문구,70~74세,2019,12555,5422,7133,76,12429,5360,7069,75.8
서울특별시,서대문구,70세,2019,2692,1142,1550,73.7,2656,1124,1532,73.4
서울특별시,서대문구,71세,2019,2575,1098,1477,74.3,2550,1088,1462,74.4
서울특별시,서대문구,72세,2019,2914,1271,1643,77.4,2889,1261,1628,77.5
서울특별시,서대문구,73세,2019,2210,985,1225,80.4,2191,974,1217,80
서울특별시,서대문구,74세,2019,2164,926,1238,74.8,2143,913,1230,74.2
서울특별시,서대문구,75~79세,2019,10755,4600,6155,74.7,10703,4587,6116,75
서울특별시,서대문구,75세,2019,2122,913,1209,75.5,2113,912,1201,75.9
서울특별시,서대문구,76세,2019,2181,916,1265,72.4,2174,914,1260,72.5
서울특별시,서대문구,77세,2019,2587,1136,1451,78.3,2578,1134,1444,78.5
서울특별시,서대문구,78세,2019,2019,874,1145,76.3,1999,868,1131,76.7
서울특별시,서대문구,79세,2019,1846,761,1085,70.1,1839,759,1080,70.3
서울특별시,서대문구,80~84세,2019,7003,2795,4208,66.4,6959,2779,4180,66.5
서울특별시,서대문구,80세,2019,1832,752,1080,69.6,1819,749,1070,70
서울특별시,서대문구,81세,2019,1532,624,908,68.7,1528,622,906,68.7
서울특별시,서대문구,82세,2019,1336,532,804,66.2,1326,531,795,66.8
서울특별시,서대문구,83세,2019,1195,478,717,66.7,1181,470,711,66.1
서울특별시,서대문구,84세,2019,1108,409,699,58.5,1105,407,698,58.3
서울특별시,서대문구,85세이상,2019,4046,1272,2774,45.9,4003,1260,2743,45.9
서울특별시,서대문구,85~89세,2019,2836,960,1876,51.2,2809,953,1856,51.3
서울특별시,서대문구,85세,2019,833,313,520,60.2,823,310,513,60.4
서울특별시,서대문구,86세,2019,663,229,434,52.8,658,226,432,52.3
서울특별시,서대문구,87세,2019,546,179,367,48.8,542,179,363,49.3
서울특별시,서대문구,88세,2019,405,122,283,43.1,399,121,278,43.5
서울특별시,서대문구,89세,2019,389,117,272,43,387,117,270,43.3
서울특별시,서대문구,90~94세,2019,966,263,703,37.4,957,261,696,37.5
서울특별시,서대문구,90세,2019,314,104,210,49.5,311,103,208,49.5
서울특별시,서대문구,91세,2019,242,69,173,39.9,240,69,171,40.4
서울특별시,서대문구,92세,2019,187,37,150,24.7,185,36,149,24.2
서울특별시,서대문구,93세,2019,122,30,92,32.6,122,30,92,32.6
서울특별시,서대문구,94세,2019,101,23,78,29.5,99,23,76,30.3
서울특별시,서대문구,95~99세,2019,206,40,166,24.1,201,39,162,24.1
서울특별시,서대문구,95세,2019,75,14,61,23,73,14,59,23.7
서울특별시,서대문구,96세,2019,49,12,37,32.4,48,11,37,29.7
서울특별시,서대문구,97세,2019,50,9,41,22,48,9,39,23.1
서울특별시,서대문구,98세,2019,23,X,20,15,23,X,20,15
서울특별시,서대문구,99세,2019,9,X,7,28.6,9,X,7,28.6
서울특별시,서대문구,100세이상,2019,38,9,29,31,36,7,29,24.1
서울특별시,서대문구,15세미만,2019,30595,15559,15036,103.5,29648,15082,14566,103.5
서울특별시,서대문구,15~64세,2019,239853,112787,127066,88.8,225021,107472,117549,91.4
서울특별시,서대문구,65세이상,2019,48946,20767,28179,73.7,48406,20528,27878,73.6
서울특별시,서대문구,평균연령,2019,41.9,41.5,42.3,,42.4,41.8,43,
서울특별시,서대문구,중위연령,2019,41,41,41.1,,42.2,41.6,42.7,
서울특별시,마포구,합계,2019,369327,173893,195434,89,355020,167814,187206,89.6
서울특별시,마포구,0~4세,2019,13006,6658,6348,104.9,12658,6483,6175,105
서울특별시,마포구,0세,2019,2465,1279,1186,107.8,2424,1258,1166,107.9
서울특별시,마포구,1세,2019,2518,1287,1231,104.5,2449,1250,1199,104.3
서울특별시,마포구,2세,2019,2482,1265,1217,103.9,2409,1232,1177,104.7
서울특별시,마포구,3세,2019,2782,1428,1354,105.5,2711,1392,1319,105.5
서울특별시,마포구,4세,2019,2759,1399,1360,102.9,2665,1351,1314,102.8
서울특별시,마포구,5~9세,2019,13141,6590,6551,100.6,12897,6464,6433,100.5
서울특별시,마포구,5세,2019,2640,1304,1336,97.6,2582,1271,1311,96.9
서울특별시,마포구,6세,2019,2591,1287,1304,98.7,2526,1253,1273,98.4
서울특별시,마포구,7세,2019,2757,1401,1356,103.3,2701,1373,1328,103.4
서울특별시,마포구,8세,2019,2624,1313,1311,100.2,2591,1298,1293,100.4
서울특별시,마포구,9세,2019,2529,1285,1244,103.3,2497,1269,1228,103.3
서울특별시,마포구,10~14세,2019,13091,6648,6443,103.2,12942,6565,6377,102.9
서울특별시,마포구,10세,2019,2537,1317,1220,108,2501,1299,1202,108.1
서울특별시,마포구,11세,2019,2757,1402,1355,103.5,2722,1384,1338,103.4
서울특별시,마포구,12세,2019,2805,1415,1390,101.8,2779,1401,1378,101.7
서울특별시,마포구,13세,2019,2467,1225,1242,98.6,2439,1207,1232,98
서울특별시,마포구,14세,2019,2525,1289,1236,104.3,2501,1274,1227,103.8
서울특별시,마포구,15~19세,2019,15816,7727,8089,95.5,15171,7534,7637,98.7
서울특별시,마포구,15세,2019,2716,1359,1357,100.1,2684,1343,1341,100.1
서울특별시,마포구,16세,2019,2585,1363,1222,111.5,2563,1353,1210,111.8
서울특별시,마포구,17세,2019,2592,1298,1294,100.3,2550,1281,1269,100.9
서울특별시,마포구,18세,2019,3275,1609,1666,96.6,3133,1575,1558,101.1
서울특별시,마포구,19세,2019,4648,2098,2550,82.3,4241,1982,2259,87.7
서울특별시,마포구,20~24세,2019,29685,12820,16865,76,26370,11870,14500,81.9
서울특별시,마포구,20세,2019,4924,2140,2784,76.9,4365,1973,2392,82.5
서울특별시,마포구,21세,2019,5211,2202,3009,73.2,4581,2019,2562,78.8
서울특별시,마포구,22세,2019,5935,2518,3417,73.7,5199,2308,2891,79.8
서울특별시,마포구,23세,2019,6665,2894,3771,76.7,5932,2701,3231,83.6
서울특별시,마포구,24세,2019,6950,3066,3884,78.9,6293,2869,3424,83.8
서울특별시,마포구,25~29세,2019,36087,16593,19494,85.1,33761,15724,18037,87.2
서울특별시,마포구,25세,2019,7154,3259,3895,83.7,6580,3069,3511,87.4
서울특별시,마포구,26세,2019,7379,3454,3925,88,6867,3271,3596,91
서울특별시,마포구,27세,2019,7517,3482,4035,86.3,7077,3300,3777,87.4
서울특별시,마포구,28세,2019,7259,3343,3916,85.4,6873,3202,3671,87.2
서울특별시,마포구,29세,2019,6778,3055,3723,82.1,6364,2882,3482,82.8
서울특별시,마포구,30~34세,2019,32214,14920,17294,86.3,30522,14112,16410,86
서울특별시,마포구,30세,2019,6605,3067,3538,86.7,6236,2891,3345,86.4
서울특별시,마포구,31세,2019,6446,2964,3482,85.1,6088,2803,3285,85.3
서울특별시,마포구,32세,2019,6394,2871,3523,81.5,6055,2712,3343,81.1
서울특별시,마포구,33세,2019,6386,2929,3457,84.7,6056,2767,3289,84.1
서울특별시,마포구,34세,2019,6383,3089,3294,93.8,6087,2939,3148,93.4
서울특별시,마포구,35~39세,2019,33136,16279,16857,96.6,31811,15558,16253,95.7
서울특별시,마포구,35세,2019,6581,3199,3382,94.6,6268,3030,3238,93.6
서울특별시,마포구,36세,2019,6645,3250,3395,95.7,6370,3099,3271,94.7
서울특별시,마포구,37세,2019,6935,3403,3532,96.3,6658,3258,3400,95.8
서울특별시,마포구,38세,2019,6591,3278,3313,98.9,6341,3143,3198,98.3
서울특별시,마포구,39세,2019,6384,3149,3235,97.3,6174,3028,3146,96.2
서울특별시,마포구,40~44세,2019,28687,13949,14738,94.6,27706,13405,14301,93.7
서울특별시,마포구,40세,2019,6117,2994,3123,95.9,5873,2856,3017,94.7
서울특별시,마포구,41세,2019,5412,2640,2772,95.2,5206,2528,2678,94.4
서울특별시,마포구,42세,2019,5729,2738,2991,91.5,5546,2636,2910,90.6
서울특별시,마포구,43세,2019,5655,2716,2939,92.4,5485,2623,2862,91.6
서울특별시,마포구,44세,2019,5774,2861,2913,98.2,5596,2762,2834,97.5
서울특별시,마포구,45~49세,2019,31497,15528,15969,97.2,30652,15078,15574,96.8
서울특별시,마포구,45세,2019,6140,3073,3067,100.2,5988,2990,2998,99.7
서울특별시,마포구,46세,2019,6298,3036,3262,93.1,6116,2931,3185,92
서울특별시,마포구,47세,2019,6379,3200,3179,100.7,6217,3115,3102,100.4
서울특별시,마포구,48세,2019,6530,3183,3347,95.1,6343,3077,3266,94.2
서울특별시,마포구,49세,2019,6150,3036,3114,97.5,5988,2965,3023,98.1
서울특별시,마포구,50~54세,2019,27012,13175,13837,95.2,26263,12798,13465,95
서울특별시,마포구,50세,2019,6020,3010,3010,100,5876,2924,2952,99.1
서울특별시,마포구,51세,2019,5714,2723,2991,91,5544,2636,2908,90.6
서울특별시,마포구,52세,2019,5146,2473,2673,92.5,4999,2398,2601,92.2
서울특별시,마포구,53세,2019,4851,2430,2421,100.4,4715,2364,2351,100.6
서울특별시,마포구,54세,2019,5281,2539,2742,92.6,5129,2476,2653,93.3
서울특별시,마포구,55~59세,2019,25204,12200,13004,93.8,24539,11892,12647,94
서울특별시,마포구,55세,2019,4790,2311,2479,93.2,4629,2240,2389,93.8
서울특별시,마포구,56세,2019,5022,2433,2589,94,4861,2364,2497,94.7
서울특별시,마포구,57세,2019,4886,2403,2483,96.8,4752,2332,2420,96.4
서울특별시,마포구,58세,2019,5204,2534,2670,94.9,5123,2498,2625,95.2
서울특별시,마포구,59세,2019,5302,2519,2783,90.5,5174,2458,2716,90.5
서울특별시,마포구,60~64세,2019,21889,10174,11715,86.8,21384,9940,11444,86.9
서울특별시,마포구,60세,2019,4771,2250,2521,89.3,4671,2207,2464,89.6
서울특별시,마포구,61세,2019,4386,2045,2341,87.4,4265,1993,2272,87.7
서울특별시,마포구,62세,2019,4496,2054,2442,84.1,4386,1995,2391,83.4
서울특별시,마포구,63세,2019,4035,1856,2179,85.2,3950,1816,2134,85.1
서울특별시,마포구,64세,2019,4201,1969,2232,88.2,4112,1929,2183,88.4
서울특별시,마포구,65~69세,2019,14793,6684,8109,82.4,14520,6545,7975,82.1
서울특별시,마포구,65세,2019,3439,1584,1855,85.4,3356,1540,1816,84.8
서울특별시,마포구,66세,2019,3035,1395,1640,85.1,2977,1368,1609,85
서울특별시,마포구,67세,2019,3311,1518,1793,84.7,3258,1491,1767,84.4
서울특별시,마포구,68세,2019,2291,1006,1285,78.3,2250,986,1264,78
서울특별시,마포구,69세,2019,2717,1181,1536,76.9,2679,1160,1519,76.4
서울특별시,마포구,70~74세,2019,12696,5345,7351,72.7,12577,5291,7286,72.6
서울특별시,마포구,70세,2019,2812,1193,1619,73.7,2784,1174,1610,72.9
서울특별시,마포구,71세,2019,2757,1168,1589,73.5,2727,1157,1570,73.7
서울특별시,마포구,72세,2019,2805,1184,1621,73,2778,1177,1601,73.5
서울특별시,마포구,73세,2019,2116,874,1242,70.4,2101,868,1233,70.4
서울특별시,마포구,74세,2019,2206,926,1280,72.3,2187,915,1272,71.9
서울특별시,마포구,75~79세,2019,10639,4585,6054,75.7,10577,4559,6018,75.8
서울특별시,마포구,75세,2019,2173,920,1253,73.4,2156,912,1244,73.3
서울특별시,마포구,76세,2019,2177,963,1214,79.3,2165,958,1207,79.4
서울특별시,마포구,77세,2019,2561,1123,1438,78.1,2552,1122,1430,78.5
서울특별시,마포구,78세,2019,1934,831,1103,75.3,1920,825,1095,75.3
서울특별시,마포구,79세,2019,1794,748,1046,71.5,1784,742,1042,71.2
서울특별시,마포구,80~84세,2019,6669,2681,3988,67.2,6638,2671,3967,67.3
서울특별시,마포구,80세,2019,1655,707,948,74.6,1650,706,944,74.8
서울특별시,마포구,81세,2019,1431,598,833,71.8,1426,598,828,72.2
서울특별시,마포구,82세,2019,1396,549,847,64.8,1391,549,842,65.2
서울특별시,마포구,83세,2019,1143,450,693,64.9,1133,445,688,64.7
서울특별시,마포구,84세,2019,1044,377,667,56.5,1038,373,665,56.1
서울특별시,마포구,85세이상,2019,4065,1337,2728,49,4032,1325,2707,48.9
서울특별시,마포구,85~89세,2019,2902,1000,1902,52.6,2882,994,1888,52.6
서울특별시,마포구,85세,2019,785,260,525,49.5,784,260,524,49.6
서울특별시,마포구,86세,2019,708,275,433,63.5,703,274,429,63.9
서울특별시,마포구,87세,2019,581,208,373,55.8,577,206,371,55.5
서울특별시,마포구,88세,2019,435,141,294,48,432,140,292,47.9
서울특별시,마포구,89세,2019,393,116,277,41.9,386,114,272,41.9
서울특별시,마포구,90~94세,2019,920,270,650,41.5,913,266,647,41.1
서울특별시,마포구,90세,2019,300,94,206,45.6,299,93,206,45.1
서울특별시,마포구,91세,2019,245,74,171,43.3,244,73,171,42.7
서울특별시,마포구,92세,2019,175,48,127,37.8,173,48,125,38.4
서울특별시,마포구,93세,2019,113,33,80,41.3,112,32,80,40
서울특별시,마포구,94세,2019,87,21,66,31.8,85,20,65,30.8
서울특별시,마포구,95~99세,2019,210,62,148,41.9,206,60,146,41.1
서울특별시,마포구,95세,2019,64,18,46,39.1,64,18,46,39.1
서울특별시,마포구,96세,2019,65,21,44,47.7,65,21,44,47.7
서울특별시,마포구,97세,2019,39,8,31,25.8,39,8,31,25.8
서울특별시,마포구,98세,2019,23,11,12,91.7,19,9,10,90
서울특별시,마포구,99세,2019,19,X,15,26.7,19,X,15,26.7
서울특별시,마포구,100세이상,2019,33,5,28,17.9,31,5,26,19.2
서울특별시,마포구,15세미만,2019,39238,19896,19342,102.9,38497,19512,18985,102.8
서울특별시,마포구,15~64세,2019,281227,133365,147862,90.2,268179,127911,140268,91.2
서울특별시,마포구,65세이상,2019,48862,20632,28230,73.1,48344,20391,27953,72.9
서울특별시,마포구,평균연령,2019,41,40.3,41.5,,41.2,40.5,41.9,
서울특별시,마포구,중위연령,2019,39.8,39.6,39.9,,40.2,39.9,40.6,
서울특별시,양천구,합계,2019,440354,216078,224276,96.3,434133,213211,220922,96.5
서울특별시,양천구,0~4세,2019,13201,6771,6430,105.3,13095,6721,6374,105.4
서울특별시,양천구,0세,2019,2219,1188,1031,115.2,2204,1181,1023,115.4
서울특별시,양천구,1세,2019,2237,1128,1109,101.7,2213,1115,1098,101.5
서울특별시,양천구,2세,2019,2611,1337,1274,104.9,2589,1325,1264,104.8
서울특별시,양천구,3세,2019,2991,1484,1507,98.5,2959,1472,1487,99
서울특별시,양천구,4세,2019,3143,1634,1509,108.3,3130,1628,1502,108.4
서울특별시,양천구,5~9세,2019,19101,9844,9257,106.3,19013,9803,9210,106.4
서울특별시,양천구,5세,2019,3330,1685,1645,102.4,3314,1678,1636,102.6
서울특별시,양천구,6세,2019,3577,1856,1721,107.8,3554,1846,1708,108.1
서울특별시,양천구,7세,2019,3951,2025,1926,105.1,3935,2017,1918,105.2
서울특별시,양천구,8세,2019,4046,2103,1943,108.2,4030,2095,1935,108.3
서울특별시,양천구,9세,2019,4197,2175,2022,107.6,4180,2167,2013,107.7
서울특별시,양천구,10~14세,2019,23432,12215,11217,108.9,23374,12188,11186,109
서울특별시,양천구,10세,2019,4164,2172,1992,109,4152,2166,1986,109.1
서울특별시,양천구,11세,2019,4711,2439,2272,107.4,4694,2432,2262,107.5
서울특별시,양천구,12세,2019,5113,2658,2455,108.3,5104,2653,2451,108.2
서울특별시,양천구,13세,2019,4628,2405,2223,108.2,4617,2400,2217,108.3
서울특별시,양천구,14세,2019,4816,2541,2275,111.7,4807,2537,2270,111.8
서울특별시,양천구,15~19세,2019,25774,13378,12396,107.9,25672,13321,12351,107.9
서울특별시,양천구,15세,2019,5208,2764,2444,113.1,5197,2758,2439,113.1
서울특별시,양천구,16세,2019,4857,2487,2370,104.9,4849,2483,2366,104.9
서울특별시,양천구,17세,2019,5063,2619,2444,107.2,5048,2609,2439,107
서울특별시,양천구,18세,2019,5485,2832,2653,106.7,5463,2822,2641,106.9
서울특별시,양천구,19세,2019,5161,2676,2485,107.7,5115,2649,2466,107.4
서울특별시,양천구,20~24세,2019,27157,14111,13046,108.2,26734,13946,12788,109.1
서울특별시,양천구,20세,2019,5203,2786,2417,115.3,5141,2750,2391,115
서울특별시,양천구,21세,2019,5209,2801,2408,116.3,5146,2778,2368,117.3
서울특별시,양천구,22세,2019,5419,2852,2567,111.1,5338,2822,2516,112.2
서울특별시,양천구,23세,2019,5607,2823,2784,101.4,5498,2782,2716,102.4
서울특별시,양천구,24세,2019,5719,2849,2870,99.3,5611,2814,2797,100.6
서울특별시,양천구,25~29세,2019,29182,14578,14604,99.8,28540,14289,14251,100.3
서울특별시,양천구,25세,2019,5931,2931,3000,97.7,5810,2877,2933,98.1
서울특별시,양천구,26세,2019,5986,3000,2986,100.5,5876,2954,2922,101.1
서울특별시,양천구,27세,2019,5978,2975,3003,99.1,5849,2922,2927,99.8
서울특별시,양천구,28세,2019,5864,2916,2948,98.9,5723,2854,2869,99.5
서울특별시,양천구,29세,2019,5423,2756,2667,103.3,5282,2682,2600,103.2
서울특별시,양천구,30~34세,2019,26089,12969,13120,98.8,25265,12569,12696,99
서울특별시,양천구,30세,2019,5298,2628,2670,98.4,5115,2537,2578,98.4
서울특별시,양천구,31세,2019,5099,2524,2575,98,4951,2459,2492,98.7
서울특별시,양천구,32세,2019,5089,2488,2601,95.7,4901,2389,2512,95.1
서울특별시,양천구,33세,2019,5270,2671,2599,102.8,5105,2599,2506,103.7
서울특별시,양천구,34세,2019,5333,2658,2675,99.4,5193,2585,2608,99.1
서울특별시,양천구,35~39세,2019,32025,15697,16328,96.1,31424,15395,16029,96
서울특별시,양천구,35세,2019,5637,2804,2833,99,5490,2736,2754,99.3
서울특별시,양천구,36세,2019,6133,3022,3111,97.1,6003,2956,3047,97
서울특별시,양천구,37세,2019,6580,3235,3345,96.7,6459,3174,3285,96.6
서울특별시,양천구,38세,2019,6715,3256,3459,94.1,6620,3207,3413,94
서울특별시,양천구,39세,2019,6960,3380,3580,94.4,6852,3322,3530,94.1
서울특별시,양천구,40~44세,2019,34663,16286,18377,88.6,34136,16057,18079,88.8
서울특별시,양천구,40세,2019,6956,3312,3644,90.9,6836,3262,3574,91.3
서울특별시,양천구,41세,2019,6519,3040,3479,87.4,6419,2999,3420,87.7
서울특별시,양천구,42세,2019,6815,3177,3638,87.3,6700,3128,3572,87.6
서울특별시,양천구,43세,2019,6947,3311,3636,91.1,6858,3271,3587,91.2
서울특별시,양천구,44세,2019,7426,3446,3980,86.6,7323,3397,3926,86.5
서울특별시,양천구,45~49세,2019,43431,21020,22411,93.8,42801,20704,22097,93.7
서울특별시,양천구,45세,2019,8268,4005,4263,93.9,8153,3947,4206,93.8
서울특별시,양천구,46세,2019,8429,4009,4420,90.7,8317,3952,4365,90.5
서울특별시,양천구,47세,2019,8582,4124,4458,92.5,8450,4059,4391,92.4
서울특별시,양천구,48세,2019,9341,4603,4738,97.2,9203,4535,4668,97.2
서울특별시,양천구,49세,2019,8811,4279,4532,94.4,8678,4211,4467,94.3
서울특별시,양천구,50~54세,2019,39440,19547,19893,98.3,38809,19263,19546,98.6
서울특별시,양천구,50세,2019,8831,4425,4406,100.4,8708,4365,4343,100.5
서울특별시,양천구,51세,2019,8333,4126,4207,98.1,8203,4065,4138,98.2
서울특별시,양천구,52세,2019,7543,3704,3839,96.5,7429,3647,3782,96.4
서울특별시,양천구,53세,2019,7285,3662,3623,101.1,7159,3611,3548,101.8
서울특별시,양천구,54세,2019,7448,3630,3818,95.1,7310,3575,3735,95.7
서울특별시,양천구,55~59세,2019,36506,18075,18431,98.1,35890,17788,18102,98.3
서울특별시,양천구,55세,2019,7005,3505,3500,100.1,6872,3449,3423,100.8
서울특별시,양천구,56세,2019,7230,3602,3628,99.3,7071,3535,3536,100
서울특별시,양천구,57세,2019,7177,3619,3558,101.7,7062,3555,3507,101.4
서울특별시,양천구,58세,2019,7567,3699,3868,95.6,7479,3654,3825,95.5
서울특별시,양천구,59세,2019,7527,3650,3877,94.1,7406,3595,3811,94.3
서울특별시,양천구,60~64세,2019,31605,15134,16471,91.9,31110,14909,16201,92
서울특별시,양천구,60세,2019,6820,3290,3530,93.2,6708,3233,3475,93
서울특별시,양천구,61세,2019,6449,3095,3354,92.3,6349,3050,3299,92.5
서울특별시,양천구,62세,2019,6338,3038,3300,92.1,6244,2999,3245,92.4
서울특별시,양천구,63세,2019,5777,2722,3055,89.1,5684,2682,3002,89.3
서울특별시,양천구,64세,2019,6221,2989,3232,92.5,6125,2945,3180,92.6
서울특별시,양천구,65~69세,2019,21513,10503,11010,95.4,21248,10387,10861,95.6
서울특별시,양천구,65세,2019,5044,2480,2564,96.7,4964,2446,2518,97.1
서울특별시,양천구,66세,2019,4483,2152,2331,92.3,4442,2139,2303,92.9
서울특별시,양천구,67세,2019,4787,2326,2461,94.5,4729,2297,2432,94.4
서울특별시,양천구,68세,2019,3411,1659,1752,94.7,3368,1641,1727,95
서울특별시,양천구,69세,2019,3788,1886,1902,99.2,3745,1864,1881,99.1
서울특별시,양천구,70~74세,2019,15498,7405,8093,91.5,15382,7362,8020,91.8
서울특별시,양천구,70세,2019,3682,1768,1914,92.4,3648,1757,1891,92.9
서울특별시,양천구,71세,2019,3484,1688,1796,94,3455,1680,1775,94.6
서울특별시,양천구,72세,2019,3401,1637,1764,92.8,3374,1622,1752,92.6
서울특별시,양천구,73세,2019,2572,1218,1354,90,2555,1212,1343,90.2
서울특별시,양천구,74세,2019,2359,1094,1265,86.5,2350,1091,1259,86.7
서울특별시,양천구,75~79세,2019,10824,4887,5937,82.3,10778,4873,5905,82.5
서울특별시,양천구,75세,2019,2351,1083,1268,85.4,2337,1079,1258,85.8
서울특별시,양천구,76세,2019,2292,1083,1209,89.6,2282,1079,1203,89.7
서울특별시,양천구,77세,2019,2488,1106,1382,80,2483,1104,1379,80.1
서울특별시,양천구,78세,2019,1988,913,1075,84.9,1980,912,1068,85.4
서울특별시,양천구,79세,2019,1705,702,1003,70,1696,699,997,70.1
서울특별시,양천구,80~84세,2019,6505,2415,4090,59,6472,2402,4070,59
서울특별시,양천구,80세,2019,1647,671,976,68.8,1639,666,973,68.4
서울특별시,양천구,81세,2019,1421,575,846,68,1416,573,843,68
서울특별시,양천구,82세,2019,1334,466,868,53.7,1328,464,864,53.7
서울특별시,양천구,83세,2019,1097,373,724,51.5,1091,372,719,51.7
서울특별시,양천구,84세,2019,1006,330,676,48.8,998,327,671,48.7
서울특별시,양천구,85세이상,2019,4408,1243,3165,39.3,4390,1234,3156,39.1
서울특별시,양천구,85~89세,2019,3074,890,2184,40.8,3060,884,2176,40.6
서울특별시,양천구,85세,2019,832,268,564,47.5,828,267,561,47.6
서울특별시,양천구,86세,2019,744,235,509,46.2,741,233,508,45.9
서울특별시,양천구,87세,2019,616,181,435,41.6,616,181,435,41.6
서울특별시,양천구,88세,2019,462,111,351,31.6,458,109,349,31.2
서울특별시,양천구,89세,2019,420,95,325,29.2,417,94,323,29.1
서울특별시,양천구,90~94세,2019,1054,289,765,37.8,1052,288,764,37.7
서울특별시,양천구,90세,2019,336,99,237,41.8,336,99,237,41.8
서울특별시,양천구,91세,2019,274,86,188,45.7,272,85,187,45.5
서울특별시,양천구,92세,2019,186,58,128,45.3,186,58,128,45.3
서울특별시,양천구,93세,2019,145,21,124,16.9,145,21,124,16.9
서울특별시,양천구,94세,2019,113,25,88,28.4,113,25,88,28.4
서울특별시,양천구,95~99세,2019,244,54,190,28.4,243,53,190,27.9
서울특별시,양천구,95세,2019,60,10,50,20,60,10,50,20
서울특별시,양천구,96세,2019,89,24,65,36.9,89,24,65,36.9
서울특별시,양천구,97세,2019,49,8,41,19.5,49,8,41,19.5
서울특별시,양천구,98세,2019,26,7,19,36.8,26,7,19,36.8
서울특별시,양천구,99세,2019,20,5,15,33.3,19,X,15,26.7
서울특별시,양천구,100세이상,2019,36,10,26,38.5,35,9,26,34.6
서울특별시,양천구,15세미만,2019,55734,28830,26904,107.2,55482,28712,26770,107.3
서울특별시,양천구,15~64세,2019,325872,160795,165077,97.4,320381,158241,162140,97.6
서울특별시,양천구,65세이상,2019,58748,26453,32295,81.9,58270,26258,32012,82
서울특별시,양천구,평균연령,2019,41.8,40.9,42.7,,41.8,40.9,42.6,
서울특별시,양천구,중위연령,2019,43.6,42.7,44.3,,43.6,42.7,44.4,
서울특별시,강서구,합계,2019,574097,277365,296732,93.5,565054,273209,291845,93.6
서울특별시,강서구,0~4세,2019,20971,10769,10202,105.6,20723,10644,10079,105.6
서울특별시,강서구,0세,2019,3796,1990,1806,110.2,3751,1967,1784,110.3
서울특별시,강서구,1세,2019,3822,1960,1862,105.3,3779,1937,1842,105.2
서울특별시,강서구,2세,2019,4050,2075,1975,105.1,3999,2051,1948,105.3
서울특별시,강서구,3세,2019,4648,2389,2259,105.8,4598,2366,2232,106
서울특별시,강서구,4세,2019,4655,2355,2300,102.4,4596,2323,2273,102.2
서울특별시,강서구,5~9세,2019,22443,11480,10963,104.7,22312,11421,10891,104.9
서울특별시,강서구,5세,2019,4488,2254,2234,100.9,4455,2235,2220,100.7
서울특별시,강서구,6세,2019,4500,2290,2210,103.6,4475,2280,2195,103.9
서울특별시,강서구,7세,2019,4789,2462,2327,105.8,4762,2449,2313,105.9
서울특별시,강서구,8세,2019,4460,2297,2163,106.2,4436,2290,2146,106.7
서울특별시,강서구,9세,2019,4206,2177,2029,107.3,4184,2167,2017,107.4
서울특별시,강서구,10~14세,2019,20706,10582,10124,104.5,20630,10543,10087,104.5
서울특별시,강서구,10세,2019,4012,2075,1937,107.1,3992,2061,1931,106.7
서울특별시,강서구,11세,2019,4412,2224,2188,101.6,4390,2213,2177,101.7
서울특별시,강서구,12세,2019,4332,2220,2112,105.1,4320,2214,2106,105.1
서울특별시,강서구,13세,2019,4015,2067,1948,106.1,4006,2063,1943,106.2
서울특별시,강서구,14세,2019,3935,1996,1939,102.9,3922,1992,1930,103.2
서울특별시,강서구,15~19세,2019,24423,12230,12193,100.3,24312,12178,12134,100.4
서울특별시,강서구,15세,2019,4425,2263,2162,104.7,4412,2256,2156,104.6
서울특별시,강서구,16세,2019,4547,2251,2296,98,4537,2249,2288,98.3
서울특별시,강서구,17세,2019,4702,2361,2341,100.9,4688,2354,2334,100.9
서울특별시,강서구,18세,2019,5183,2590,2593,99.9,5158,2579,2579,100
서울특별시,강서구,19세,2019,5566,2765,2801,98.7,5517,2740,2777,98.7
서울특별시,강서구,20~24세,2019,32955,15712,17243,91.1,32492,15501,16991,91.2
서울특별시,강서구,20세,2019,5506,2787,2719,102.5,5443,2752,2691,102.3
서울특별시,강서구,21세,2019,5787,2996,2791,107.3,5710,2961,2749,107.7
서울특별시,강서구,22세,2019,6452,3089,3363,91.9,6367,3051,3316,92
서울특별시,강서구,23세,2019,7106,3267,3839,85.1,7004,3221,3783,85.1
서울특별시,강서구,24세,2019,8104,3573,4531,78.9,7968,3516,4452,79
서울특별시,강서구,25~29세,2019,50078,23179,26899,86.2,49030,22723,26307,86.4
서울특별시,강서구,25세,2019,8950,3916,5034,77.8,8787,3862,4925,78.4
서울특별시,강서구,26세,2019,9899,4497,5402,83.2,9693,4409,5284,83.4
서울특별시,강서구,27세,2019,10568,4897,5671,86.4,10366,4813,5553,86.7
서울특별시,강서구,28세,2019,10428,4877,5551,87.9,10218,4787,5431,88.1
서울특별시,강서구,29세,2019,10233,4992,5241,95.2,9966,4852,5114,94.9
서울특별시,강서구,30~34세,2019,48967,24354,24613,98.9,47634,23753,23881,99.5
서울특별시,강서구,30세,2019,9833,4814,5019,95.9,9592,4711,4881,96.5
서울특별시,강서구,31세,2019,9864,4822,5042,95.6,9591,4697,4894,96
서울특별시,강서구,32세,2019,9713,4871,4842,100.6,9422,4730,4692,100.8
서울특별시,강서구,33세,2019,9790,4862,4928,98.7,9518,4749,4769,99.6
서울특별시,강서구,34세,2019,9767,4985,4782,104.2,9511,4866,4645,104.8
서울특별시,강서구,35~39세,2019,52180,26851,25329,106,51172,26373,24799,106.3
서울특별시,강서구,35세,2019,9769,5006,4763,105.1,9527,4889,4638,105.4
서울특별시,강서구,36세,2019,10520,5443,5077,107.2,10313,5347,4966,107.7
서울특별시,강서구,37세,2019,10923,5555,5368,103.5,10724,5452,5272,103.4
서울특별시,강서구,38세,2019,10543,5553,4990,111.3,10351,5470,4881,112.1
서울특별시,강서구,39세,2019,10425,5294,5131,103.2,10257,5215,5042,103.4
서울특별시,강서구,40~44세,2019,43845,22096,21749,101.6,43142,21744,21398,101.6
서울특별시,강서구,40세,2019,9870,5037,4833,104.2,9703,4960,4743,104.6
서울특별시,강서구,41세,2019,8488,4255,4233,100.5,8326,4169,4157,100.3
서울특별시,강서구,42세,2019,8674,4389,4285,102.4,8546,4325,4221,102.5
서울특별시,강서구,43세,2019,8224,4116,4108,100.2,8096,4046,4050,99.9
서울특별시,강서구,44세,2019,8589,4299,4290,100.2,8471,4244,4227,100.4
서울특별시,강서구,45~49세,2019,46027,22956,23071,99.5,45277,22598,22679,99.6
서울특별시,강서구,45세,2019,9355,4647,4708,98.7,9242,4590,4652,98.7
서울특별시,강서구,46세,2019,9274,4712,4562,103.3,9123,4636,4487,103.3
서울특별시,강서구,47세,2019,9072,4549,4523,100.6,8911,4487,4424,101.4
서울특별시,강서구,48세,2019,9372,4651,4721,98.5,9216,4561,4655,98
서울특별시,강서구,49세,2019,8954,4397,4557,96.5,8785,4324,4461,96.9
서울특별시,강서구,50~54세,2019,42383,20264,22119,91.6,41559,19891,21668,91.8
서울특별시,강서구,50세,2019,8981,4415,4566,96.7,8837,4349,4488,96.9
서울특별시,강서구,51세,2019,8839,4234,4605,91.9,8674,4161,4513,92.2
서울특별시,강서구,52세,2019,8087,3828,4259,89.9,7946,3761,4185,89.9
서울특별시,강서구,53세,2019,7984,3782,4202,90,7800,3701,4099,90.3
서울특별시,강서구,54세,2019,8492,4005,4487,89.3,8302,3919,4383,89.4
서울특별시,강서구,55~59세,2019,45340,21177,24163,87.6,44462,20782,23680,87.8
서울특별시,강서구,55세,2019,7952,3701,4251,87.1,7761,3618,4143,87.3
서울특별시,강서구,56세,2019,8691,4126,4565,90.4,8468,4033,4435,90.9
서울특별시,강서구,57세,2019,8926,4248,4678,90.8,8740,4161,4579,90.9
서울특별시,강서구,58세,2019,9838,4538,5300,85.6,9719,4486,5233,85.7
서울특별시,강서구,59세,2019,9933,4564,5369,85,9774,4484,5290,84.8
서울특별시,강서구,60~64세,2019,42996,19894,23102,86.1,42240,19539,22701,86.1
서울특별시,강서구,60세,2019,9263,4361,4902,89,9118,4291,4827,88.9
서울특별시,강서구,61세,2019,8720,4023,4697,85.7,8559,3956,4603,85.9
서울특별시,강서구,62세,2019,8790,4104,4686,87.6,8615,4023,4592,87.6
서울특별시,강서구,63세,2019,7859,3632,4227,85.9,7716,3559,4157,85.6
서울특별시,강서구,64세,2019,8364,3774,4590,82.2,8232,3710,4522,82
서울특별시,강서구,65~69세,2019,29173,13733,15440,88.9,28753,13540,15213,89
서울특별시,강서구,65세,2019,6791,3122,3669,85.1,6662,3067,3595,85.3
서울특별시,강서구,66세,2019,6147,2922,3225,90.6,6058,2876,3182,90.4
서울특별시,강서구,67세,2019,6492,3067,3425,89.5,6417,3031,3386,89.5
서울특별시,강서구,68세,2019,4554,2160,2394,90.2,4485,2128,2357,90.3
서울특별시,강서구,69세,2019,5189,2462,2727,90.3,5131,2438,2693,90.5
서울특별시,강서구,70~74세,2019,21766,10463,11303,92.6,21620,10409,11211,92.8
서울특별시,강서구,70세,2019,5127,2452,2675,91.7,5084,2436,2648,92
서울특별시,강서구,71세,2019,4820,2330,2490,93.6,4796,2321,2475,93.8
서울특별시,강서구,72세,2019,4867,2327,2540,91.6,4833,2315,2518,91.9
서울특별시,강서구,73세,2019,3564,1728,1836,94.1,3544,1721,1823,94.4
서울특별시,강서구,74세,2019,3388,1626,1762,92.3,3363,1616,1747,92.5
서울특별시,강서구,75~79세,2019,14687,6608,8079,81.8,14614,6578,8036,81.9
서울특별시,강서구,75세,2019,3168,1512,1656,91.3,3147,1502,1645,91.3
서울특별시,강서구,76세,2019,3006,1369,1637,83.6,2990,1364,1626,83.9
서울특별시,강서구,77세,2019,3409,1552,1857,83.6,3398,1546,1852,83.5
서울특별시,강서구,78세,2019,2655,1130,1525,74.1,2648,1126,1522,74
서울특별시,강서구,79세,2019,2449,1045,1404,74.4,2431,1040,1391,74.8
서울특별시,강서구,80~84세,2019,8915,3284,5631,58.3,8879,3271,5608,58.3
서울특별시,강서구,80세,2019,2304,898,1406,63.9,2291,894,1397,64
서울특별시,강서구,81세,2019,1960,776,1184,65.5,1957,776,1181,65.7
서울특별시,강서구,82세,2019,1701,593,1108,53.5,1693,592,1101,53.8
서울특별시,강서구,83세,2019,1482,511,971,52.6,1474,507,967,52.4
서울특별시,강서구,84세,2019,1468,506,962,52.6,1464,502,962,52.2
서울특별시,강서구,85세이상,2019,6242,1733,4509,38.4,6203,1721,4482,38.4
서울특별시,강서구,85~89세,2019,4226,1261,2965,42.5,4196,1251,2945,42.5
서울특별시,강서구,85세,2019,1118,356,762,46.7,1113,354,759,46.6
서울특별시,강서구,86세,2019,1006,324,682,47.5,998,322,676,47.6
서울특별시,강서구,87세,2019,832,243,589,41.3,827,242,585,41.4
서울특별시,강서구,88세,2019,637,180,457,39.4,629,176,453,38.9
서울특별시,강서구,89세,2019,633,158,475,33.3,629,157,472,33.3
서울특별시,강서구,90~94세,2019,1622,367,1255,29.2,1615,366,1249,29.3
서울특별시,강서구,90세,2019,532,129,403,32,531,129,402,32.1
서울특별시,강서구,91세,2019,399,79,320,24.7,397,78,319,24.5
서울특별시,강서구,92세,2019,320,82,238,34.5,319,82,237,34.6
서울특별시,강서구,93세,2019,212,40,172,23.3,210,40,170,23.5
서울특별시,강서구,94세,2019,159,37,122,30.3,158,37,121,30.6
서울특별시,강서구,95~99세,2019,354,97,257,37.7,352,96,256,37.5
서울특별시,강서구,95세,2019,126,38,88,43.2,124,37,87,42.5
서울특별시,강서구,96세,2019,92,22,70,31.4,92,22,70,31.4
서울특별시,강서구,97세,2019,68,14,54,25.9,68,14,54,25.9
서울특별시,강서구,98세,2019,42,13,29,44.8,42,13,29,44.8
서울특별시,강서구,99세,2019,26,10,16,62.5,26,10,16,62.5
서울특별시,강서구,100세이상,2019,40,8,32,25,40,8,32,25
서울특별시,강서구,15세미만,2019,64120,32831,31289,104.9,63665,32608,31057,105
서울특별시,강서구,15~64세,2019,429194,208713,220481,94.7,421320,205082,216238,94.8
서울특별시,강서구,65세이상,2019,80783,35821,44962,79.7,80069,35519,44550,79.7
서울특별시,강서구,평균연령,2019,42,41.2,42.8,,42,41.2,42.8,
서울특별시,강서구,중위연령,2019,41.5,40.7,42.4,,41.5,40.7,42.4,
서울특별시,구로구,합계,2019,435560,217373,218187,99.6,389524,192276,197248,97.5
서울특별시,구로구,0~4세,2019,15426,7867,7559,104.1,14240,7288,6952,104.8
서울특별시,구로구,0세,2019,2755,1413,1342,105.3,2512,1297,1215,106.7
서울특별시,구로구,1세,2019,2955,1543,1412,109.3,2740,1439,1301,110.6
서울특별시,구로구,2세,2019,3077,1564,1513,103.4,2794,1429,1365,104.7
서울특별시,구로구,3세,2019,3289,1685,1604,105,3043,1554,1489,104.4
서울특별시,구로구,4세,2019,3350,1662,1688,98.5,3151,1569,1582,99.2
서울특별시,구로구,5~9세,2019,16224,8256,7968,103.6,15489,7862,7627,103.1
서울특별시,구로구,5세,2019,3191,1656,1535,107.9,3027,1564,1463,106.9
서울특별시,구로구,6세,2019,3338,1695,1643,103.2,3147,1605,1542,104.1
서울특별시,구로구,7세,2019,3317,1651,1666,99.1,3155,1563,1592,98.2
서울특별시,구로구,8세,2019,3242,1631,1611,101.2,3133,1574,1559,101
서울특별시,구로구,9세,2019,3136,1623,1513,107.3,3027,1556,1471,105.8
서울특별시,구로구,10~14세,2019,14346,7352,6994,105.1,13905,7135,6770,105.4
서울특별시,구로구,10세,2019,2926,1460,1466,99.6,2831,1416,1415,100.1
서울특별시,구로구,11세,2019,3036,1529,1507,101.5,2939,1478,1461,101.2
서울특별시,구로구,12세,2019,3020,1513,1507,100.4,2906,1463,1443,101.4
서울특별시,구로구,13세,2019,2773,1451,1322,109.8,2707,1422,1285,110.7
서울특별시,구로구,14세,2019,2591,1399,1192,117.4,2522,1356,1166,116.3
서울특별시,구로구,15~19세,2019,16547,8671,7876,110.1,16128,8457,7671,110.2
서울특별시,구로구,15세,2019,2880,1498,1382,108.4,2814,1457,1357,107.4
서울특별시,구로구,16세,2019,2995,1585,1410,112.4,2949,1563,1386,112.8
서울특별시,구로구,17세,2019,3200,1724,1476,116.8,3142,1686,1456,115.8
서울특별시,구로구,18세,2019,3570,1936,1634,118.5,3494,1896,1598,118.6
서울특별시,구로구,19세,2019,3902,1928,1974,97.7,3729,1855,1874,99
서울특별시,구로구,20~24세,2019,23721,11641,12080,96.4,22418,11020,11398,96.7
서울특별시,구로구,20세,2019,3900,1989,1911,104.1,3712,1894,1818,104.2
서울특별시,구로구,21세,2019,4306,2259,2047,110.4,4080,2148,1932,111.2
서울특별시,구로구,22세,2019,4690,2326,2364,98.4,4440,2204,2236,98.6
서울특별시,구로구,23세,2019,5188,2439,2749,88.7,4895,2292,2603,88.1
서울특별시,구로구,24세,2019,5637,2628,3009,87.3,5291,2482,2809,88.4
서울특별시,구로구,25~29세,2019,33061,16241,16820,96.6,30072,14761,15311,96.4
서울특별시,구로구,25세,2019,6192,3024,3168,95.5,5779,2822,2957,95.4
서울특별시,구로구,26세,2019,6450,3147,3303,95.3,5975,2920,3055,95.6
서울특별시,구로구,27세,2019,6883,3367,3516,95.8,6253,3055,3198,95.5
서울특별시,구로구,28세,2019,6719,3315,3404,97.4,6084,3000,3084,97.3
서울특별시,구로구,29세,2019,6817,3388,3429,98.8,5981,2964,3017,98.2
서울특별시,구로구,30~34세,2019,33550,17034,16516,103.1,28929,14579,14350,101.6
서울특별시,구로구,30세,2019,6638,3345,3293,101.6,5771,2902,2869,101.2
서울특별시,구로구,31세,2019,6695,3395,3300,102.9,5776,2911,2865,101.6
서울특별시,구로구,32세,2019,6897,3414,3483,98,5862,2883,2979,96.8
서울특별시,구로구,33세,2019,6709,3432,3277,104.7,5739,2902,2837,102.3
서울특별시,구로구,34세,2019,6611,3448,3163,109,5781,2981,2800,106.5
서울특별시,구로구,35~39세,2019,36930,19287,17643,109.3,33119,17037,16082,105.9
서울특별시,구로구,35세,2019,6895,3566,3329,107.1,6073,3087,2986,103.4
서울특별시,구로구,36세,2019,7390,3928,3462,113.5,6549,3429,3120,109.9
서울특별시,구로구,37세,2019,7730,4052,3678,110.2,6886,3552,3334,106.5
서울특별시,구로구,38세,2019,7454,3874,3580,108.2,6818,3491,3327,104.9
서울특별시,구로구,39세,2019,7461,3867,3594,107.6,6793,3478,3315,104.9
서울특별시,구로구,40~44세,2019,32844,17434,15410,113.1,29421,15258,14163,107.7
서울특별시,구로구,40세,2019,7173,3811,3362,113.4,6442,3341,3101,107.7
서울특별시,구로구,41세,2019,6464,3429,3035,113,5726,2972,2754,107.9
서울특별시,구로구,42세,2019,6420,3430,2990,114.7,5803,3043,2760,110.3
서울특별시,구로구,43세,2019,6419,3355,3064,109.5,5738,2910,2828,102.9
서울특별시,구로구,44세,2019,6368,3409,2959,115.2,5712,2992,2720,110
서울특별시,구로구,45~49세,2019,36697,19182,17515,109.5,31765,16226,15539,104.4
서울특별시,구로구,45세,2019,7059,3717,3342,111.2,6279,3214,3065,104.9
서울특별시,구로구,46세,2019,7285,3864,3421,112.9,6380,3296,3084,106.9
서울특별시,구로구,47세,2019,7252,3847,3405,113,6287,3246,3041,106.7
서울특별시,구로구,48세,2019,7628,3958,3670,107.8,6539,3353,3186,105.2
서울특별시,구로구,49세,2019,7473,3796,3677,103.2,6280,3117,3163,98.5
서울특별시,구로구,50~54세,2019,35888,18099,17789,101.7,29898,14670,15228,96.3
서울특별시,구로구,50세,2019,7421,3746,3675,101.9,6262,3070,3192,96.2
서울특별시,구로구,51세,2019,7349,3627,3722,97.4,6169,2932,3237,90.6
서울특별시,구로구,52세,2019,6897,3510,3387,103.6,5863,2929,2934,99.8
서울특별시,구로구,53세,2019,6826,3492,3334,104.7,5633,2784,2849,97.7
서울특별시,구로구,54세,2019,7395,3724,3671,101.4,5971,2955,3016,98
서울특별시,구로구,55~59세,2019,38244,18889,19355,97.6,31522,15254,16268,93.8
서울특별시,구로구,55세,2019,7153,3577,3576,100,5664,2782,2882,96.5
서울특별시,구로구,56세,2019,7734,3887,3847,101,5980,2935,3045,96.4
서울특별시,구로구,57세,2019,7496,3724,3772,98.7,6159,3006,3153,95.3
서울특별시,구로구,58세,2019,7565,3706,3859,96,6776,3290,3486,94.4
서울특별시,구로구,59세,2019,8296,3995,4301,92.9,6943,3241,3702,87.5
서울특별시,구로구,60~64세,2019,35090,16877,18213,92.7,29759,14027,15732,89.2
서울특별시,구로구,60세,2019,7428,3606,3822,94.3,6315,2979,3336,89.3
서울특별시,구로구,61세,2019,7174,3494,3680,94.9,5990,2871,3119,92
서울특별시,구로구,62세,2019,7219,3496,3723,93.9,6008,2843,3165,89.8
서울특별시,구로구,63세,2019,6505,3050,3455,88.3,5537,2558,2979,85.9
서울특별시,구로구,64세,2019,6764,3231,3533,91.5,5909,2776,3133,88.6
서울특별시,구로구,65~69세,2019,24449,11593,12856,90.2,21842,10280,11562,88.9
서울특별시,구로구,65세,2019,5832,2767,3065,90.3,5009,2343,2666,87.9
서울특별시,구로구,66세,2019,5208,2435,2773,87.8,4614,2138,2476,86.3
서울특별시,구로구,67세,2019,5197,2471,2726,90.6,4689,2223,2466,90.1
서울특별시,구로구,68세,2019,3907,1852,2055,90.1,3541,1680,1861,90.3
서울특별시,구로구,69세,2019,4305,2068,2237,92.4,3989,1896,2093,90.6
서울특별시,구로구,70~74세,2019,18075,8727,9348,93.4,17284,8394,8890,94.4
서울특별시,구로구,70세,2019,4280,2057,2223,92.5,4012,1924,2088,92.1
서울특별시,구로구,71세,2019,3930,1934,1996,96.9,3760,1868,1892,98.7
서울특별시,구로구,72세,2019,4055,1987,2068,96.1,3901,1920,1981,96.9
서울특별시,구로구,73세,2019,2990,1414,1576,89.7,2874,1371,1503,91.2
서울특별시,구로구,74세,2019,2820,1335,1485,89.9,2737,1311,1426,91.9
서울특별시,구로구,75~79세,2019,12823,5914,6909,85.6,12458,5814,6644,87.5
서울특별시,구로구,75세,2019,2753,1314,1439,91.3,2668,1283,1385,92.6
서울특별시,구로구,76세,2019,2703,1248,1455,85.8,2631,1233,1398,88.2
서울특별시,구로구,77세,2019,3067,1416,1651,85.8,2987,1391,1596,87.2
서울특별시,구로구,78세,2019,2274,1067,1207,88.4,2218,1051,1167,90.1
서울특별시,구로구,79세,2019,2026,869,1157,75.1,1954,856,1098,78
서울특별시,구로구,80~84세,2019,7428,3050,4378,69.7,7174,2988,4186,71.4
서울특별시,구로구,80세,2019,1950,852,1098,77.6,1877,837,1040,80.5
서울특별시,구로구,81세,2019,1708,705,1003,70.3,1649,688,961,71.6
서울특별시,구로구,82세,2019,1399,582,817,71.2,1355,571,784,72.8
서울특별시,구로구,83세,2019,1226,501,725,69.1,1180,489,691,70.8
서울특별시,구로구,84세,2019,1145,410,735,55.8,1113,403,710,56.8
서울특별시,구로구,85세이상,2019,4217,1259,2958,42.6,4101,1226,2875,42.6
서울특별시,구로구,85~89세,2019,3001,978,2023,48.3,2913,954,1959,48.7
서울특별시,구로구,85세,2019,864,286,578,49.5,836,279,557,50.1
서울특별시,구로구,86세,2019,730,277,453,61.1,713,269,444,60.6
서울특별시,구로구,87세,2019,574,185,389,47.6,555,180,375,48
서울특별시,구로구,88세,2019,435,123,312,39.4,420,121,299,40.5
서울특별시,구로구,89세,2019,398,107,291,36.8,389,105,284,37
서울특별시,구로구,90~94세,2019,976,224,752,29.8,955,217,738,29.4
서울특별시,구로구,90세,2019,311,85,226,37.6,303,84,219,38.4
서울특별시,구로구,91세,2019,255,57,198,28.8,248,54,194,27.8
서울특별시,구로구,92세,2019,185,41,144,28.5,182,39,143,27.3
서울특별시,구로구,93세,2019,136,26,110,23.6,134,25,109,22.9
서울특별시,구로구,94세,2019,89,15,74,20.3,88,15,73,20.5
서울특별시,구로구,95~99세,2019,223,55,168,32.7,216,53,163,32.5
서울특별시,구로구,95세,2019,63,15,48,31.3,61,15,46,32.6
서울특별시,구로구,96세,2019,73,20,53,37.7,70,18,52,34.6
서울특별시,구로구,97세,2019,45,8,37,21.6,45,8,37,21.6
서울특별시,구로구,98세,2019,24,7,17,41.2,22,7,15,46.7
서울특별시,구로구,99세,2019,18,5,13,38.5,18,5,13,38.5
서울특별시,구로구,100세이상,2019,17,X,15,13.3,17,X,15,13.3
서울특별시,구로구,15세미만,2019,45996,23475,22521,104.2,43634,22285,21349,104.4
서울특별시,구로구,15~64세,2019,322572,163355,159217,102.6,283031,141289,141742,99.7
서울특별시,구로구,65세이상,2019,66992,30543,36449,83.8,62859,28702,34157,84
서울특별시,구로구,평균연령,2019,43.4,42.7,44.1,,43.1,42.3,43.8,
서울특별시,구로구,중위연령,2019,44.2,43.5,45.1,,43.4,42.6,44.4,
서울특별시,금천구,합계,2019,249747,127242,122505,103.9,222193,112286,109907,102.2
서울특별시,금천구,0~4세,2019,7379,3800,3579,106.2,6634,3404,3230,105.4
서울특별시,금천구,0세,2019,1293,686,607,113,1143,605,538,112.5
서울특별시,금천구,1세,2019,1401,715,686,104.2,1251,633,618,102.4
서울특별시,금천구,2세,2019,1482,746,736,101.4,1318,667,651,102.5
서울특별시,금천구,3세,2019,1599,837,762,109.8,1434,746,688,108.4
서울특별시,금천구,4세,2019,1604,816,788,103.6,1488,753,735,102.4
서울특별시,금천구,5~9세,2019,7297,3721,3576,104.1,6807,3478,3329,104.5
서울특별시,금천구,5세,2019,1483,771,712,108.3,1362,711,651,109.2
서울특별시,금천구,6세,2019,1392,704,688,102.3,1293,654,639,102.3
서울특별시,금천구,7세,2019,1578,797,781,102,1478,750,728,103
서울특별시,금천구,8세,2019,1450,721,729,98.9,1355,674,681,99
서울특별시,금천구,9세,2019,1394,728,666,109.3,1319,689,630,109.4
서울특별시,금천구,10~14세,2019,6869,3478,3391,102.6,6625,3347,3278,102.1
서울특별시,금천구,10세,2019,1323,660,663,99.5,1262,632,630,100.3
서울특별시,금천구,11세,2019,1346,701,645,108.7,1301,676,625,108.2
서울특별시,금천구,12세,2019,1429,714,715,99.9,1379,684,695,98.4
서울특별시,금천구,13세,2019,1378,686,692,99.1,1334,664,670,99.1
서울특별시,금천구,14세,2019,1393,717,676,106.1,1349,691,658,105
서울특별시,금천구,15~19세,2019,8671,4331,4340,99.8,8506,4258,4248,100.2
서울특별시,금천구,15세,2019,1461,731,730,100.1,1435,721,714,101
서울특별시,금천구,16세,2019,1565,759,806,94.2,1540,747,793,94.2
서울특별시,금천구,17세,2019,1692,867,825,105.1,1668,858,810,105.9
서울특별시,금천구,18세,2019,1889,928,961,96.6,1865,914,951,96.1
서울특별시,금천구,19세,2019,2064,1046,1018,102.8,1998,1018,980,103.9
서울특별시,금천구,20~24세,2019,14393,7182,7211,99.6,13725,6853,6872,99.7
서울특별시,금천구,20세,2019,2320,1199,1121,107,2233,1157,1076,107.5
서울특별시,금천구,21세,2019,2562,1315,1247,105.5,2475,1273,1202,105.9
서울특별시,금천구,22세,2019,2865,1401,1464,95.7,2732,1335,1397,95.6
서울특별시,금천구,23세,2019,3212,1573,1639,96,3035,1476,1559,94.7
서울특별시,금천구,24세,2019,3434,1694,1740,97.4,3250,1612,1638,98.4
서울특별시,금천구,25~29세,2019,22364,11716,10648,110,20508,10774,9734,110.7
서울특별시,금천구,25세,2019,4168,2094,2074,101,3921,1984,1937,102.4
서울특별시,금천구,26세,2019,4454,2294,2160,106.2,4137,2140,1997,107.2
서울특별시,금천구,27세,2019,4653,2459,2194,112.1,4307,2273,2034,111.8
서울특별시,금천구,28세,2019,4679,2487,2192,113.5,4245,2260,1985,113.9
서울특별시,금천구,29세,2019,4410,2382,2028,117.5,3898,2117,1781,118.9
서울특별시,금천구,30~34세,2019,20001,11041,8960,123.2,17266,9571,7695,124.4
서울특별시,금천구,30세,2019,4223,2316,1907,121.4,3717,2061,1656,124.5
서울특별시,금천구,31세,2019,3981,2197,1784,123.2,3428,1910,1518,125.8
서울특별시,금천구,32세,2019,4078,2211,1867,118.4,3488,1904,1584,120.2
서울특별시,금천구,33세,2019,3973,2246,1727,130.1,3397,1921,1476,130.1
서울특별시,금천구,34세,2019,3746,2071,1675,123.6,3236,1775,1461,121.5
서울특별시,금천구,35~39세,2019,19341,10704,8637,123.9,17090,9421,7669,122.8
서울특별시,금천구,35세,2019,3850,2106,1744,120.8,3328,1822,1506,121
서울특별시,금천구,36세,2019,3872,2133,1739,122.7,3404,1877,1527,122.9
서울특별시,금천구,37세,2019,4012,2240,1772,126.4,3522,1935,1587,121.9
서울특별시,금천구,38세,2019,3811,2119,1692,125.2,3418,1900,1518,125.2
서울특별시,금천구,39세,2019,3796,2106,1690,124.6,3418,1887,1531,123.3
서울특별시,금천구,40~44세,2019,16710,9064,7646,118.5,14655,7781,6874,113.2
서울특별시,금천구,40세,2019,3593,1964,1629,120.6,3164,1692,1472,114.9
서울특별시,금천구,41세,2019,3282,1771,1511,117.2,2861,1503,1358,110.7
서울특별시,금천구,42세,2019,3177,1783,1394,127.9,2833,1572,1261,124.7
서울특별시,금천구,43세,2019,3234,1709,1525,112.1,2790,1433,1357,105.6
서울특별시,금천구,44세,2019,3424,1837,1587,115.8,3007,1581,1426,110.9
서울특별시,금천구,45~49세,2019,20828,10904,9924,109.9,17697,9044,8653,104.5
서울특별시,금천구,45세,2019,3757,2035,1722,118.2,3309,1746,1563,111.7
서울특별시,금천구,46세,2019,4001,2118,1883,112.5,3385,1739,1646,105.7
서울특별시,금천구,47세,2019,4129,2157,1972,109.4,3528,1802,1726,104.4
서울특별시,금천구,48세,2019,4445,2293,2152,106.6,3712,1880,1832,102.6
서울특별시,금천구,49세,2019,4496,2301,2195,104.8,3763,1877,1886,99.5
서울특별시,금천구,50~54세,2019,22722,11445,11277,101.5,19014,9350,9664,96.8
서울특별시,금천구,50세,2019,4530,2289,2241,102.1,3777,1879,1898,99
서울특별시,금천구,51세,2019,4691,2361,2330,101.3,3936,1920,2016,95.2
서울특별시,금천구,52세,2019,4219,2047,2172,94.2,3596,1706,1890,90.3
서울특별시,금천구,53세,2019,4531,2353,2178,108,3782,1925,1857,103.7
서울특별시,금천구,54세,2019,4751,2395,2356,101.7,3923,1920,2003,95.9
서울특별시,금천구,55~59세,2019,24554,12443,12111,102.7,20485,10242,10243,100
서울특별시,금천구,55세,2019,4681,2392,2289,104.5,3805,1896,1909,99.3
서울특별시,금천구,56세,2019,5029,2569,2460,104.4,3966,2015,1951,103.3
서울특별시,금천구,57세,2019,4819,2460,2359,104.3,3988,2004,1984,101
서울특별시,금천구,58세,2019,4861,2399,2462,97.4,4393,2138,2255,94.8
서울특별시,금천구,59세,2019,5164,2623,2541,103.2,4333,2189,2144,102.1
서울특별시,금천구,60~64세,2019,20803,10315,10488,98.4,17753,8732,9021,96.8
서울특별시,금천구,60세,2019,4621,2292,2329,98.4,4006,1955,2051,95.3
서울특별시,금천구,61세,2019,4347,2184,2163,101,3654,1853,1801,102.9
서울특별시,금천구,62세,2019,4123,2045,2078,98.4,3423,1691,1732,97.6
서울특별시,금천구,63세,2019,3827,1934,1893,102.2,3307,1654,1653,100.1
서울특별시,금천구,64세,2019,3885,1860,2025,91.9,3363,1579,1784,88.5
서울특별시,금천구,65~69세,2019,13904,6736,7168,94,12362,5958,6404,93
서울특별시,금천구,65세,2019,3365,1628,1737,93.7,2916,1376,1540,89.4
서울특별시,금천구,66세,2019,2791,1336,1455,91.8,2455,1173,1282,91.5
서울특별시,금천구,67세,2019,2998,1452,1546,93.9,2691,1301,1390,93.6
서울특별시,금천구,68세,2019,2256,1132,1124,100.7,2012,1004,1008,99.6
서울특별시,금천구,69세,2019,2494,1188,1306,91,2288,1104,1184,93.2
서울특별시,금천구,70~74세,2019,10052,4696,5356,87.7,9576,4503,5073,88.8
서울특별시,금천구,70세,2019,2362,1107,1255,88.2,2201,1027,1174,87.5
서울특별시,금천구,71세,2019,2155,1019,1136,89.7,2049,975,1074,90.8
서울특별시,금천구,72세,2019,2246,1051,1195,87.9,2157,1017,1140,89.2
서울특별시,금천구,73세,2019,1643,743,900,82.6,1572,722,850,84.9
서울특별시,금천구,74세,2019,1646,776,870,89.2,1597,762,835,91.3
서울특별시,금천구,75~79세,2019,7363,3343,4020,83.2,7177,3289,3888,84.6
서울특별시,금천구,75세,2019,1549,693,856,81,1509,674,835,80.7
서울특별시,금천구,76세,2019,1526,728,798,91.2,1490,717,773,92.8
서울특별시,금천구,77세,2019,1719,786,933,84.2,1684,776,908,85.5
서울특별시,금천구,78세,2019,1395,619,776,79.8,1355,610,745,81.9
서울특별시,금천구,79세,2019,1174,517,657,78.7,1139,512,627,81.7
서울특별시,금천구,80~84세,2019,4057,1621,2436,66.5,3930,1590,2340,67.9
서울특별시,금천구,80세,2019,1109,468,641,73,1072,462,610,75.7
서울특별시,금천구,81세,2019,907,377,530,71.1,879,370,509,72.7
서울특별시,금천구,82세,2019,744,300,444,67.6,717,294,423,69.5
서울특별시,금천구,83세,2019,663,250,413,60.5,653,247,406,60.8
서울특별시,금천구,84세,2019,634,226,408,55.4,609,217,392,55.4
서울특별시,금천구,85세이상,2019,2439,702,1737,40.4,2383,691,1692,40.8
서울특별시,금천구,85~89세,2019,1740,566,1174,48.2,1697,557,1140,48.9
서울특별시,금천구,85세,2019,499,172,327,52.6,482,168,314,53.5
서울특별시,금천구,86세,2019,398,124,274,45.3,387,121,266,45.5
서울특별시,금천구,87세,2019,347,114,233,48.9,342,114,228,50
서울특별시,금천구,88세,2019,272,95,177,53.7,268,93,175,53.1
서울특별시,금천구,89세,2019,224,61,163,37.4,218,61,157,38.9
서울특별시,금천구,90~94세,2019,532,92,440,20.9,524,91,433,21
서울특별시,금천구,90세,2019,145,33,112,29.5,142,32,110,29.1
서울특별시,금천구,91세,2019,146,22,124,17.7,143,22,121,18.2
서울특별시,금천구,92세,2019,122,19,103,18.4,122,19,103,18.4
서울특별시,금천구,93세,2019,54,9,45,20,53,9,44,20.5
서울특별시,금천구,94세,2019,65,9,56,16.1,64,9,55,16.4
서울특별시,금천구,95~99세,2019,145,39,106,36.8,141,38,103,36.9
서울특별시,금천구,95세,2019,45,10,35,28.6,43,9,34,26.5
서울특별시,금천구,96세,2019,42,13,29,44.8,40,13,27,48.1
서울특별시,금천구,97세,2019,26,7,19,36.8,26,7,19,36.8
서울특별시,금천구,98세,2019,16,X,12,33.3,16,X,12,33.3
서울특별시,금천구,99세,2019,16,5,11,45.5,16,5,11,45.5
서울특별시,금천구,100세이상,2019,22,5,17,29.4,21,5,16,31.3
서울특별시,금천구,15세미만,2019,21545,10999,10546,104.3,20066,10229,9837,104
서울특별시,금천구,15~64세,2019,190387,99145,91242,108.7,166699,86026,80673,106.6
서울특별시,금천구,65세이상,2019,37815,17098,20717,82.5,35428,16031,19397,82.6
서울특별시,금천구,평균연령,2019,44.1,43.3,44.9,,43.9,43,44.7,
서울특별시,금천구,중위연령,2019,45.5,44.2,46.8,,44.8,43.2,46.3,
서울특별시,영등포구,합계,2019,394083,196903,197180,99.9,345903,171068,174835,97.8
서울특별시,영등포구,0~4세,2019,13962,7144,6818,104.8,12797,6545,6252,104.7
서울특별시,영등포구,0세,2019,2722,1379,1343,102.7,2514,1273,1241,102.6
서울특별시,영등포구,1세,2019,2664,1342,1322,101.5,2439,1225,1214,100.9
서울특별시,영등포구,2세,2019,2646,1373,1273,107.9,2410,1264,1146,110.3
서울특별시,영등포구,3세,2019,3010,1523,1487,102.4,2717,1369,1348,101.6
서울특별시,영등포구,4세,2019,2920,1527,1393,109.6,2717,1414,1303,108.5
서울특별시,영등포구,5~9세,2019,12514,6326,6188,102.2,11732,5944,5788,102.7
서울특별시,영등포구,5세,2019,2684,1384,1300,106.5,2501,1298,1203,107.9
서울특별시,영등포구,6세,2019,2508,1305,1203,108.5,2339,1219,1120,108.8
서울특별시,영등포구,7세,2019,2647,1302,1345,96.8,2481,1229,1252,98.2
서울특별시,영등포구,8세,2019,2411,1185,1226,96.7,2276,1113,1163,95.7
서울특별시,영등포구,9세,2019,2264,1150,1114,103.2,2135,1085,1050,103.3
서울특별시,영등포구,10~14세,2019,10914,5745,5169,111.1,10402,5486,4916,111.6
서울특별시,영등포구,10세,2019,2164,1127,1037,108.7,2055,1074,981,109.5
서울특별시,영등포구,11세,2019,2329,1208,1121,107.8,2199,1142,1057,108
서울특별시,영등포구,12세,2019,2227,1161,1066,108.9,2125,1108,1017,108.9
서울특별시,영등포구,13세,2019,2106,1136,970,117.1,2020,1087,933,116.5
서울특별시,영등포구,14세,2019,2088,1113,975,114.2,2003,1075,928,115.8
서울특별시,영등포구,15~19세,2019,12867,6773,6094,111.1,12454,6540,5914,110.6
서울특별시,영등포구,15세,2019,2295,1235,1060,116.5,2204,1179,1025,115
서울특별시,영등포구,16세,2019,2250,1250,1000,125,2193,1215,978,124.2
서울특별시,영등포구,17세,2019,2385,1274,1111,114.7,2321,1242,1079,115.1
서울특별시,영등포구,18세,2019,2770,1424,1346,105.8,2698,1392,1306,106.6
서울특별시,영등포구,19세,2019,3167,1590,1577,100.8,3038,1512,1526,99.1
서울특별시,영등포구,20~24세,2019,21097,9832,11265,87.3,19734,9209,10525,87.5
서울특별시,영등포구,20세,2019,3296,1671,1625,102.8,3143,1593,1550,102.8
서울특별시,영등포구,21세,2019,3776,1861,1915,97.2,3541,1753,1788,98
서울특별시,영등포구,22세,2019,4092,1949,2143,90.9,3835,1830,2005,91.3
서울특별시,영등포구,23세,2019,4549,2026,2523,80.3,4227,1885,2342,80.5
서울특별시,영등포구,24세,2019,5384,2325,3059,76,4988,2148,2840,75.6
서울특별시,영등포구,25~29세,2019,35950,17237,18713,92.1,32893,15673,17220,91
서울특별시,영등포구,25세,2019,6124,2784,3340,83.4,5711,2593,3118,83.2
서울특별시,영등포구,26세,2019,6983,3271,3712,88.1,6443,3011,3432,87.7
서울특별시,영등포구,27세,2019,7738,3732,4006,93.2,7147,3407,3740,91.1
서울특별시,영등포구,28세,2019,7702,3746,3956,94.7,7046,3414,3632,94
서울특별시,영등포구,29세,2019,7403,3704,3699,100.1,6546,3248,3298,98.5
서울특별시,영등포구,30~34세,2019,36743,19003,17740,107.1,32060,16382,15678,104.5
서울특별시,영등포구,30세,2019,7505,3895,3610,107.9,6623,3411,3212,106.2
서울특별시,영등포구,31세,2019,7529,3879,3650,106.3,6608,3375,3233,104.4
서울특별시,영등포구,32세,2019,7551,3817,3734,102.2,6421,3174,3247,97.8
서울특별시,영등포구,33세,2019,7168,3725,3443,108.2,6247,3206,3041,105.4
서울특별시,영등포구,34세,2019,6990,3687,3303,111.6,6161,3216,2945,109.2
서울특별시,영등포구,35~39세,2019,34697,18459,16238,113.7,30886,16154,14732,109.7
서울특별시,영등포구,35세,2019,6895,3669,3226,113.7,6096,3193,2903,110
서울특별시,영등포구,36세,2019,7019,3721,3298,112.8,6213,3234,2979,108.6
서울특별시,영등포구,37세,2019,7275,3835,3440,111.5,6442,3340,3102,107.7
서울특별시,영등포구,38세,2019,6871,3703,3168,116.9,6183,3295,2888,114.1
서울특별시,영등포구,39세,2019,6637,3531,3106,113.7,5952,3092,2860,108.1
서울특별시,영등포구,40~44세,2019,28438,15114,13324,113.4,24894,12881,12013,107.2
서울특별시,영등포구,40세,2019,6276,3374,2902,116.3,5492,2882,2610,110.4
서울특별시,영등포구,41세,2019,5491,2918,2573,113.4,4756,2444,2312,105.7
서울특별시,영등포구,42세,2019,5651,2985,2666,112,4997,2571,2426,106
서울특별시,영등포구,43세,2019,5536,2907,2629,110.6,4837,2473,2364,104.6
서울특별시,영등포구,44세,2019,5484,2930,2554,114.7,4812,2511,2301,109.1
서울특별시,영등포구,45~49세,2019,32080,16843,15237,110.5,26815,13766,13049,105.5
서울특별시,영등포구,45세,2019,5970,3203,2767,115.8,5161,2708,2453,110.4
서울특별시,영등포구,46세,2019,6202,3268,2934,111.4,5256,2680,2576,104
서울특별시,영등포구,47세,2019,6320,3325,2995,111,5289,2730,2559,106.7
서울특별시,영등포구,48세,2019,6874,3542,3332,106.3,5684,2865,2819,101.6
서울특별시,영등포구,49세,2019,6714,3505,3209,109.2,5425,2783,2642,105.3
서울특별시,영등포구,50~54세,2019,32356,16394,15962,102.7,25920,12972,12948,100.2
서울특별시,영등포구,50세,2019,6763,3365,3398,99,5538,2727,2811,97
서울특별시,영등포구,51세,2019,6596,3419,3177,107.6,5266,2680,2586,103.6
서울특별시,영등포구,52세,2019,6096,3026,3070,98.6,5033,2451,2582,94.9
서울특별시,영등포구,53세,2019,6326,3246,3080,105.4,4975,2535,2440,103.9
서울특별시,영등포구,54세,2019,6575,3338,3237,103.1,5108,2579,2529,102
서울특별시,영등포구,55~59세,2019,34310,17084,17226,99.2,26980,13360,13620,98.1
서울특별시,영등포구,55세,2019,6659,3348,3311,101.1,5072,2548,2524,101
서울특별시,영등포구,56세,2019,7063,3644,3419,106.6,5118,2619,2499,104.8
서울특별시,영등포구,57세,2019,6777,3436,3341,102.8,5313,2686,2627,102.2
서울특별시,영등포구,58세,2019,6631,3217,3414,94.2,5712,2760,2952,93.5
서울특별시,영등포구,59세,2019,7180,3439,3741,91.9,5765,2747,3018,91
서울특별시,영등포구,60~64세,2019,30549,15136,15413,98.2,24767,12097,12670,95.5
서울특별시,영등포구,60세,2019,6501,3215,3286,97.8,5277,2582,2695,95.8
서울특별시,영등포구,61세,2019,6299,3151,3148,100.1,5038,2479,2559,96.9
서울특별시,영등포구,62세,2019,6330,3134,3196,98.1,5064,2465,2599,94.8
서울특별시,영등포구,63세,2019,5604,2811,2793,100.6,4539,2263,2276,99.4
서울특별시,영등포구,64세,2019,5815,2825,2990,94.5,4849,2308,2541,90.8
서울특별시,영등포구,65~69세,2019,19951,9538,10413,91.6,17394,8266,9128,90.6
서울특별시,영등포구,65세,2019,4695,2284,2411,94.7,3933,1903,2030,93.7
서울특별시,영등포구,66세,2019,4095,1982,2113,93.8,3516,1687,1829,92.2
서울특별시,영등포구,67세,2019,4349,2101,2248,93.5,3846,1847,1999,92.4
서울특별시,영등포구,68세,2019,3260,1551,1709,90.8,2846,1346,1500,89.7
서울특별시,영등포구,69세,2019,3552,1620,1932,83.9,3253,1483,1770,83.8
서울특별시,영등포구,70~74세,2019,14932,7058,7874,89.6,14163,6747,7416,91
서울특별시,영등포구,70세,2019,3515,1689,1826,92.5,3243,1566,1677,93.4
서울특별시,영등포구,71세,2019,3254,1545,1709,90.4,3096,1480,1616,91.6
서울특별시,영등포구,72세,2019,3211,1494,1717,87,3078,1442,1636,88.1
서울특별시,영등포구,73세,2019,2569,1200,1369,87.7,2446,1153,1293,89.2
서울특별시,영등포구,74세,2019,2383,1130,1253,90.2,2300,1106,1194,92.6
서울특별시,영등포구,75~79세,2019,11287,4948,6339,78.1,10953,4858,6095,79.7
서울특별시,영등포구,75세,2019,2330,1035,1295,79.9,2267,1017,1250,81.4
서울특별시,영등포구,76세,2019,2317,1030,1287,80,2258,1011,1247,81.1
서울특별시,영등포구,77세,2019,2734,1203,1531,78.6,2663,1185,1478,80.2
서울특별시,영등포구,78세,2019,2045,892,1153,77.4,1976,876,1100,79.6
서울특별시,영등포구,79세,2019,1861,788,1073,73.4,1789,769,1020,75.4
서울특별시,영등포구,80~84세,2019,7119,2962,4157,71.3,6869,2907,3962,73.4
서울특별시,영등포구,80세,2019,1806,789,1017,77.6,1727,776,951,81.6
서울특별시,영등포구,81세,2019,1538,636,902,70.5,1490,625,865,72.3
서울특별시,영등포구,82세,2019,1405,572,833,68.7,1358,554,804,68.9
서울특별시,영등포구,83세,2019,1226,494,732,67.5,1185,486,699,69.5
서울특별시,영등포구,84세,2019,1144,471,673,70,1109,466,643,72.5
서울특별시,영등포구,85세이상,2019,4317,1307,3010,43.4,4190,1281,2909,44
서울특별시,영등포구,85~89세,2019,3051,988,2063,47.9,2960,971,1989,48.8
서울특별시,영등포구,85세,2019,914,327,587,55.7,885,320,565,56.6
서울특별시,영등포구,86세,2019,710,223,487,45.8,687,222,465,47.7
서울특별시,영등포구,87세,2019,584,192,392,49,567,187,380,49.2
서울특별시,영등포구,88세,2019,447,134,313,42.8,436,132,304,43.4
서울특별시,영등포구,89세,2019,396,112,284,39.4,385,110,275,40
서울특별시,영등포구,90~94세,2019,995,251,744,33.7,969,247,722,34.2
서울특별시,영등포구,90세,2019,311,82,229,35.8,303,81,222,36.5
서울특별시,영등포구,91세,2019,262,76,186,40.9,255,74,181,40.9
서울특별시,영등포구,92세,2019,193,44,149,29.5,188,44,144,30.6
서울특별시,영등포구,93세,2019,118,25,93,26.9,114,24,90,26.7
서울특별시,영등포구,94세,2019,111,24,87,27.6,109,24,85,28.2
서울특별시,영등포구,95~99세,2019,247,64,183,35,237,59,178,33.1
서울특별시,영등포구,95세,2019,78,22,56,39.3,76,21,55,38.2
서울특별시,영등포구,96세,2019,84,21,63,33.3,80,17,63,27
서울특별시,영등포구,97세,2019,45,9,36,25,42,9,33,27.3
서울특별시,영등포구,98세,2019,21,5,16,31.3,21,5,16,31.3
서울특별시,영등포구,99세,2019,19,7,12,58.3,18,7,11,63.6
서울특별시,영등포구,100세이상,2019,24,X,20,20,24,X,20,20
서울특별시,영등포구,15세미만,2019,37390,19215,18175,105.7,34931,17975,16956,106
서울특별시,영등포구,15~64세,2019,299087,151875,147212,103.2,257403,129034,128369,100.5
서울특별시,영등포구,65세이상,2019,57606,25813,31793,81.2,53569,24059,29510,81.5
서울특별시,영등포구,평균연령,2019,43.2,42.6,43.8,,42.8,42.1,43.4,
서울특별시,영등포구,중위연령,2019,43.2,42.5,43.8,,41.9,41.3,42.6,
서울특별시,동작구,합계,2019,400368,194049,206319,94.1,382396,185757,196639,94.5
서울특별시,동작구,0~4세,2019,12614,6385,6229,102.5,12395,6273,6122,102.5
서울특별시,동작구,0세,2019,2263,1205,1058,113.9,2217,1184,1033,114.6
서울특별시,동작구,1세,2019,2337,1185,1152,102.9,2283,1156,1127,102.6
서울특별시,동작구,2세,2019,2427,1179,1248,94.5,2390,1160,1230,94.3
서울특별시,동작구,3세,2019,2725,1383,1342,103.1,2678,1353,1325,102.1
서울특별시,동작구,4세,2019,2862,1433,1429,100.3,2827,1420,1407,100.9
서울특별시,동작구,5~9세,2019,13427,6891,6536,105.4,13273,6806,6467,105.2
서울특별시,동작구,5세,2019,2666,1403,1263,111.1,2629,1378,1251,110.2
서울특별시,동작구,6세,2019,2653,1342,1311,102.4,2616,1325,1291,102.6
서울특별시,동작구,7세,2019,2779,1409,1370,102.8,2751,1395,1356,102.9
서울특별시,동작구,8세,2019,2717,1359,1358,100.1,2687,1342,1345,99.8
서울특별시,동작구,9세,2019,2612,1378,1234,111.7,2590,1366,1224,111.6
서울특별시,동작구,10~14세,2019,12591,6473,6118,105.8,12501,6434,6067,106
서울특별시,동작구,10세,2019,2531,1268,1263,100.4,2513,1261,1252,100.7
서울특별시,동작구,11세,2019,2576,1342,1234,108.8,2551,1328,1223,108.6
서울특별시,동작구,12세,2019,2587,1390,1197,116.1,2566,1384,1182,117.1
서울특별시,동작구,13세,2019,2450,1239,1211,102.3,2434,1231,1203,102.3
서울특별시,동작구,14세,2019,2447,1234,1213,101.7,2437,1230,1207,101.9
서울특별시,동작구,15~19세,2019,17219,8580,8639,99.3,16583,8368,8215,101.9
서울특별시,동작구,15세,2019,2611,1348,1263,106.7,2596,1343,1253,107.2
서울특별시,동작구,16세,2019,2581,1326,1255,105.7,2567,1320,1247,105.9
서울특별시,동작구,17세,2019,2730,1380,1350,102.2,2700,1367,1333,102.6
서울특별시,동작구,18세,2019,3619,1820,1799,101.2,3457,1764,1693,104.2
서울특별시,동작구,19세,2019,5678,2706,2972,91,5263,2574,2689,95.7
서울특별시,동작구,20~24세,2019,33671,15721,17950,87.6,30325,14513,15812,91.8
서울특별시,동작구,20세,2019,5763,2584,3179,81.3,5192,2406,2786,86.4
서울특별시,동작구,21세,2019,6012,2649,3363,78.8,5319,2392,2927,81.7
서울특별시,동작구,22세,2019,6588,3071,3517,87.3,5870,2814,3056,92.1
서울특별시,동작구,23세,2019,7494,3544,3950,89.7,6801,3289,3512,93.7
서울특별시,동작구,24세,2019,7814,3873,3941,98.3,7143,3612,3531,102.3
서울특별시,동작구,25~29세,2019,39268,19693,19575,100.6,37189,18787,18402,102.1
서울특별시,동작구,25세,2019,8036,3967,4069,97.5,7513,3768,3745,100.6
서울특별시,동작구,26세,2019,8111,4009,4102,97.7,7694,3839,3855,99.6
서울특별시,동작구,27세,2019,8108,4144,3964,104.5,7736,3986,3750,106.3
서울특별시,동작구,28세,2019,7728,3889,3839,101.3,7360,3713,3647,101.8
서울특별시,동작구,29세,2019,7285,3684,3601,102.3,6886,3481,3405,102.2
서울특별시,동작구,30~34세,2019,32172,16227,15945,101.8,30476,15380,15096,101.9
서울특별시,동작구,30세,2019,6788,3449,3339,103.3,6416,3277,3139,104.4
서울특별시,동작구,31세,2019,6662,3329,3333,99.9,6293,3156,3137,100.6
서울특별시,동작구,32세,2019,6367,3247,3120,104.1,6021,3065,2956,103.7
서울특별시,동작구,33세,2019,6211,3116,3095,100.7,5877,2937,2940,99.9
서울특별시,동작구,34세,2019,6144,3086,3058,100.9,5869,2945,2924,100.7
서울특별시,동작구,35~39세,2019,32181,16380,15801,103.7,30917,15670,15247,102.8
서울특별시,동작구,35세,2019,6100,3085,3015,102.3,5795,2913,2882,101.1
서울특별시,동작구,36세,2019,6508,3274,3234,101.2,6238,3127,3111,100.5
서울특별시,동작구,37세,2019,6579,3348,3231,103.6,6321,3209,3112,103.1
서울특별시,동작구,38세,2019,6399,3335,3064,108.8,6188,3213,2975,108
서울특별시,동작구,39세,2019,6595,3338,3257,102.5,6375,3208,3167,101.3
서울특별시,동작구,40~44세,2019,28291,14376,13915,103.3,27235,13761,13474,102.1
서울특별시,동작구,40세,2019,6144,3175,2969,106.9,5901,3017,2884,104.6
서울특별시,동작구,41세,2019,5497,2749,2748,100,5281,2625,2656,98.8
서울특별시,동작구,42세,2019,5510,2747,2763,99.4,5324,2647,2677,98.9
서울특별시,동작구,43세,2019,5501,2822,2679,105.3,5297,2707,2590,104.5
서울특별시,동작구,44세,2019,5639,2883,2756,104.6,5432,2765,2667,103.7
서울특별시,동작구,45~49세,2019,30908,15529,15379,101,29558,14811,14747,100.4
서울특별시,동작구,45세,2019,6088,3201,2887,110.9,5855,3078,2777,110.8
서울특별시,동작구,46세,2019,5920,2899,3021,96,5705,2786,2919,95.4
서울특별시,동작구,47세,2019,6059,3098,2961,104.6,5788,2944,2844,103.5
서울특별시,동작구,48세,2019,6552,3211,3341,96.1,6230,3030,3200,94.7
서울특별시,동작구,49세,2019,6289,3120,3169,98.5,5980,2973,3007,98.9
서울특별시,동작구,50~54세,2019,29450,14004,15446,90.7,27836,13224,14612,90.5
서울특별시,동작구,50세,2019,6412,3107,3305,94,6086,2935,3151,93.1
서울특별시,동작구,51세,2019,6125,2868,3257,88.1,5786,2709,3077,88
서울특별시,동작구,52세,2019,5627,2651,2976,89.1,5357,2519,2838,88.8
서울특별시,동작구,53세,2019,5547,2674,2873,93.1,5209,2516,2693,93.4
서울특별시,동작구,54세,2019,5739,2704,3035,89.1,5398,2545,2853,89.2
서울특별시,동작구,55~59세,2019,30760,14613,16147,90.5,28876,13714,15162,90.4
서울특별시,동작구,55세,2019,5773,2769,3004,92.2,5391,2576,2815,91.5
서울특별시,동작구,56세,2019,6029,2896,3133,92.4,5551,2670,2881,92.7
서울특별시,동작구,57세,2019,5951,2859,3092,92.5,5565,2676,2889,92.6
서울특별시,동작구,58세,2019,6287,2912,3375,86.3,6081,2821,3260,86.5
서울특별시,동작구,59세,2019,6720,3177,3543,89.7,6288,2971,3317,89.6
서울특별시,동작구,60~64세,2019,28024,12957,15067,86,26520,12245,14275,85.8
서울특별시,동작구,60세,2019,5924,2738,3186,85.9,5624,2609,3015,86.5
서울특별시,동작구,61세,2019,5674,2598,3076,84.5,5334,2436,2898,84.1
서울특별시,동작구,62세,2019,5755,2705,3050,88.7,5404,2527,2877,87.8
서울특별시,동작구,63세,2019,5190,2394,2796,85.6,4906,2253,2653,84.9
서울특별시,동작구,64세,2019,5481,2522,2959,85.2,5252,2420,2832,85.5
서울특별시,동작구,65~69세,2019,19812,9068,10744,84.4,19121,8752,10369,84.4
서울특별시,동작구,65세,2019,4544,2096,2448,85.6,4332,1993,2339,85.2
서울특별시,동작구,66세,2019,4079,1882,2197,85.7,3912,1805,2107,85.7
서울특별시,동작구,67세,2019,4317,1983,2334,85,4180,1924,2256,85.3
서울특별시,동작구,68세,2019,3301,1457,1844,79,3210,1417,1793,79
서울특별시,동작구,69세,2019,3571,1650,1921,85.9,3487,1613,1874,86.1
서울특별시,동작구,70~74세,2019,16027,7048,8979,78.5,15837,6971,8866,78.6
서울특별시,동작구,70세,2019,3571,1550,2021,76.7,3502,1520,1982,76.7
서울특별시,동작구,71세,2019,3537,1586,1951,81.3,3489,1569,1920,81.7
서울특별시,동작구,72세,2019,3520,1547,1973,78.4,3490,1537,1953,78.7
서울특별시,동작구,73세,2019,2820,1220,1600,76.3,2795,1209,1586,76.2
서울특별시,동작구,74세,2019,2579,1145,1434,79.8,2561,1136,1425,79.7
서울특별시,동작구,75~79세,2019,12267,5712,6555,87.1,12168,5687,6481,87.7
서울특별시,동작구,75세,2019,2568,1182,1386,85.3,2541,1173,1368,85.7
서울특별시,동작구,76세,2019,2514,1211,1303,92.9,2492,1201,1291,93
서울특별시,동작구,77세,2019,2906,1384,1522,90.9,2888,1382,1506,91.8
서울특별시,동작구,78세,2019,2253,1030,1223,84.2,2234,1026,1208,84.9
서울특별시,동작구,79세,2019,2026,905,1121,80.7,2013,905,1108,81.7
서울특별시,동작구,80~84세,2019,7266,2990,4276,69.9,7198,2967,4231,70.1
서울특별시,동작구,80세,2019,1890,839,1051,79.8,1879,834,1045,79.8
서울특별시,동작구,81세,2019,1589,678,911,74.4,1572,672,900,74.7
서울특별시,동작구,82세,2019,1451,573,878,65.3,1435,567,868,65.3
서울특별시,동작구,83세,2019,1260,493,767,64.3,1242,488,754,64.7
서울특별시,동작구,84세,2019,1076,407,669,60.8,1070,406,664,61.1
서울특별시,동작구,85세이상,2019,4420,1402,3018,46.5,4388,1394,2994,46.6
서울특별시,동작구,85~89세,2019,3083,1038,2045,50.8,3064,1033,2031,50.9
서울특별시,동작구,85세,2019,913,340,573,59.3,910,339,571,59.4
서울특별시,동작구,86세,2019,716,250,466,53.6,709,248,461,53.8
서울특별시,동작구,87세,2019,600,186,414,44.9,596,186,410,45.4
서울특별시,동작구,88세,2019,450,150,300,50,450,150,300,50
서울특별시,동작구,89세,2019,404,112,292,38.4,399,110,289,38.1
서울특별시,동작구,90~94세,2019,1057,288,769,37.5,1051,287,764,37.6
서울특별시,동작구,90세,2019,359,111,248,44.8,357,111,246,45.1
서울특별시,동작구,91세,2019,253,68,185,36.8,250,67,183,36.6
서울특별시,동작구,92세,2019,208,49,159,30.8,208,49,159,30.8
서울특별시,동작구,93세,2019,140,38,102,37.3,140,38,102,37.3
서울특별시,동작구,94세,2019,97,22,75,29.3,96,22,74,29.7
서울특별시,동작구,95~99세,2019,243,64,179,35.8,240,64,176,36.4
서울특별시,동작구,95세,2019,86,24,62,38.7,85,24,61,39.3
서울특별시,동작구,96세,2019,70,21,49,42.9,69,21,48,43.8
서울특별시,동작구,97세,2019,37,7,30,23.3,36,7,29,24.1
서울특별시,동작구,98세,2019,25,6,19,31.6,25,6,19,31.6
서울특별시,동작구,99세,2019,25,6,19,31.6,25,6,19,31.6
서울특별시,동작구,100세이상,2019,37,12,25,48,33,10,23,43.5
서울특별시,동작구,15세미만,2019,38632,19749,18883,104.6,38169,19513,18656,104.6
서울특별시,동작구,15~64세,2019,301944,148080,153864,96.2,285515,140473,145042,96.8
서울특별시,동작구,65세이상,2019,59792,26220,33572,78.1,58712,25771,32941,78.2
서울특별시,동작구,평균연령,2019,42.1,41.3,42.9,,42.2,41.3,43.1,
서울특별시,동작구,중위연령,2019,41.2,40.2,42.2,,41.3,40.2,42.5,
서울특별시,관악구,합계,2019,507828,254082,253746,100.1,482476,242205,240271,100.8
서울특별시,관악구,0~4세,2019,12334,6388,5946,107.4,11773,6114,5659,108
서울특별시,관악구,0세,2019,2263,1151,1112,103.5,2158,1099,1059,103.8
서울특별시,관악구,1세,2019,2239,1183,1056,112,2127,1134,993,114.2
서울특별시,관악구,2세,2019,2476,1281,1195,107.2,2356,1214,1142,106.3
서울특별시,관악구,3세,2019,2629,1358,1271,106.8,2508,1295,1213,106.8
서울특별시,관악구,4세,2019,2727,1415,1312,107.9,2624,1372,1252,109.6
서울특별시,관악구,5~9세,2019,13029,6677,6352,105.1,12689,6501,6188,105.1
서울특별시,관악구,5세,2019,2636,1357,1279,106.1,2554,1319,1235,106.8
서울특별시,관악구,6세,2019,2562,1311,1251,104.8,2482,1276,1206,105.8
서울특별시,관악구,7세,2019,2625,1348,1277,105.6,2553,1306,1247,104.7
서울특별시,관악구,8세,2019,2668,1369,1299,105.4,2620,1344,1276,105.3
서울특별시,관악구,9세,2019,2538,1292,1246,103.7,2480,1256,1224,102.6
서울특별시,관악구,10~14세,2019,12663,6509,6154,105.8,12448,6407,6041,106.1
서울특별시,관악구,10세,2019,2427,1272,1155,110.1,2368,1244,1124,110.7
서울특별시,관악구,11세,2019,2589,1333,1256,106.1,2540,1305,1235,105.7
서울특별시,관악구,12세,2019,2649,1347,1302,103.5,2610,1330,1280,103.9
서울특별시,관악구,13세,2019,2484,1290,1194,108,2452,1277,1175,108.7
서울특별시,관악구,14세,2019,2514,1267,1247,101.6,2478,1251,1227,102
서울특별시,관악구,15~19세,2019,17942,9158,8784,104.3,17560,9011,8549,105.4
서울특별시,관악구,15세,2019,2708,1412,1296,109,2674,1398,1276,109.6
서울특별시,관악구,16세,2019,2753,1377,1376,100.1,2725,1368,1357,100.8
서울특별시,관악구,17세,2019,3061,1534,1527,100.5,3024,1521,1503,101.2
서울특별시,관악구,18세,2019,3890,1962,1928,101.8,3801,1926,1875,102.7
서울특별시,관악구,19세,2019,5530,2873,2657,108.1,5336,2798,2538,110.2
서울특별시,관악구,20~24세,2019,42140,18879,23261,81.2,40252,18193,22059,82.5
서울특별시,관악구,20세,2019,5989,2864,3125,91.6,5704,2749,2955,93
서울특별시,관악구,21세,2019,6794,3120,3674,84.9,6531,3013,3518,85.6
서울특별시,관악구,22세,2019,7860,3380,4480,75.4,7509,3259,4250,76.7
서울특별시,관악구,23세,2019,10050,4390,5660,77.6,9582,4220,5362,78.7
서울특별시,관악구,24세,2019,11447,5125,6322,81.1,10926,4952,5974,82.9
서울특별시,관악구,25~29세,2019,69742,35815,33927,105.6,66429,34463,31966,107.8
서울특별시,관악구,25세,2019,13724,6519,7205,90.5,13074,6293,6781,92.8
서울특별시,관악구,26세,2019,14346,7217,7129,101.2,13726,6976,6750,103.3
서울특별시,관악구,27세,2019,15093,7862,7231,108.7,14422,7587,6835,111
서울특별시,관악구,28세,2019,13804,7300,6504,112.2,13146,7022,6124,114.7
서울특별시,관악구,29세,2019,12775,6917,5858,118.1,12061,6585,5476,120.3
서울특별시,관악구,30~34세,2019,49614,27235,22379,121.7,46676,25803,20873,123.6
서울특별시,관악구,30세,2019,11761,6442,5319,121.1,11099,6145,4954,124
서울특별시,관악구,31세,2019,10611,5805,4806,120.8,10005,5509,4496,122.5
서울특별시,관악구,32세,2019,9722,5335,4387,121.6,9136,5027,4109,122.3
서울특별시,관악구,33세,2019,9057,4989,4068,122.6,8477,4712,3765,125.2
서울특별시,관악구,34세,2019,8463,4664,3799,122.8,7959,4410,3549,124.3
서울특별시,관악구,35~39세,2019,41154,22439,18715,119.9,39174,21382,17792,120.2
서울특별시,관악구,35세,2019,8185,4463,3722,119.9,7725,4234,3491,121.3
서울특별시,관악구,36세,2019,8214,4493,3721,120.7,7776,4244,3532,120.2
서울특별시,관악구,37세,2019,8684,4700,3984,118,8231,4466,3765,118.6
서울특별시,관악구,38세,2019,8063,4458,3605,123.7,7746,4280,3466,123.5
서울특별시,관악구,39세,2019,8008,4325,3683,117.4,7696,4158,3538,117.5
서울특별시,관악구,40~44세,2019,33299,17951,15348,117,31643,17039,14604,116.7
서울특별시,관악구,40세,2019,7277,3952,3325,118.9,6867,3724,3143,118.5
서울특별시,관악구,41세,2019,6506,3446,3060,112.6,6195,3281,2914,112.6
서울특별시,관악구,42세,2019,6508,3459,3049,113.4,6203,3292,2911,113.1
서울특별시,관악구,43세,2019,6408,3541,2867,123.5,6097,3376,2721,124.1
서울특별시,관악구,44세,2019,6600,3553,3047,116.6,6281,3366,2915,115.5
서울특별시,관악구,45~49세,2019,36876,19499,17377,112.2,34646,18356,16290,112.7
서울특별시,관악구,45세,2019,7122,3796,3326,114.1,6756,3598,3158,113.9
서울특별시,관악구,46세,2019,7175,3880,3295,117.8,6782,3676,3106,118.4
서울특별시,관악구,47세,2019,7412,3947,3465,113.9,6927,3696,3231,114.4
서울특별시,관악구,48세,2019,7801,4056,3745,108.3,7335,3829,3506,109.2
서울특별시,관악구,49세,2019,7366,3820,3546,107.7,6846,3557,3289,108.1
서울특별시,관악구,50~54세,2019,35312,17416,17896,97.3,32572,16116,16456,97.9
서울특별시,관악구,50세,2019,7334,3675,3659,100.4,6804,3417,3387,100.9
서울특별시,관악구,51세,2019,7232,3538,3694,95.8,6703,3270,3433,95.3
서울특별시,관악구,52세,2019,6769,3230,3539,91.3,6272,3009,3263,92.2
서울특별시,관악구,53세,2019,6731,3429,3302,103.8,6180,3161,3019,104.7
서울특별시,관악구,54세,2019,7246,3544,3702,95.7,6613,3259,3354,97.2
서울특별시,관악구,55~59세,2019,36810,17718,19092,92.8,33759,16250,17509,92.8
서울특별시,관악구,55세,2019,6683,3308,3375,98,6035,3003,3032,99
서울특별시,관악구,56세,2019,7356,3580,3776,94.8,6515,3180,3335,95.4
서울특별시,관악구,57세,2019,7261,3510,3751,93.6,6668,3227,3441,93.8
서울특별시,관악구,58세,2019,7505,3569,3936,90.7,7115,3370,3745,90
서울특별시,관악구,59세,2019,8005,3751,4254,88.2,7426,3470,3956,87.7
서울특별시,관악구,60~64세,2019,33762,15726,18036,87.2,31509,14635,16874,86.7
서울특별시,관악구,60세,2019,7242,3391,3851,88.1,6754,3140,3614,86.9
서울특별시,관악구,61세,2019,6804,3279,3525,93,6301,3019,3282,92
서울특별시,관악구,62세,2019,6721,3098,3623,85.5,6199,2848,3351,85
서울특별시,관악구,63세,2019,6371,2922,3449,84.7,5989,2768,3221,85.9
서울특별시,관악구,64세,2019,6624,3036,3588,84.6,6266,2860,3406,84
서울특별시,관악구,65~69세,2019,24987,11512,13475,85.4,23888,11018,12870,85.6
서울특별시,관악구,65세,2019,5677,2609,3068,85,5332,2461,2871,85.7
서울특별시,관악구,66세,2019,4987,2217,2770,80,4757,2114,2643,80
서울특별시,관악구,67세,2019,5550,2587,2963,87.3,5349,2494,2855,87.4
서울특별시,관악구,68세,2019,4205,1922,2283,84.2,4006,1825,2181,83.7
서울특별시,관악구,69세,2019,4568,2177,2391,91,4444,2124,2320,91.6
서울특별시,관악구,70~74세,2019,20224,9209,11015,83.6,19846,9056,10790,83.9
서울특별시,관악구,70세,2019,4676,2145,2531,84.7,4548,2095,2453,85.4
서울특별시,관악구,71세,2019,4380,1979,2401,82.4,4296,1943,2353,82.6
서울특별시,관악구,72세,2019,4454,2034,2420,84,4391,2009,2382,84.3
서울특별시,관악구,73세,2019,3409,1525,1884,80.9,3355,1503,1852,81.2
서울특별시,관악구,74세,2019,3305,1526,1779,85.8,3256,1506,1750,86.1
서울특별시,관악구,75~79세,2019,15311,7051,8260,85.4,15163,7012,8151,86
서울특별시,관악구,75세,2019,3267,1502,1765,85.1,3239,1494,1745,85.6
서울특별시,관악구,76세,2019,3256,1498,1758,85.2,3222,1484,1738,85.4
서울특별시,관악구,77세,2019,3635,1697,1938,87.6,3609,1693,1916,88.4
서울특별시,관악구,78세,2019,2811,1327,1484,89.4,2784,1322,1462,90.4
서울특별시,관악구,79세,2019,2342,1027,1315,78.1,2309,1019,1290,79
서울특별시,관악구,80~84세,2019,8233,3527,4706,74.9,8116,3494,4622,75.6
서울특별시,관악구,80세,2019,2273,1049,1224,85.7,2242,1042,1200,86.8
서울특별시,관악구,81세,2019,1889,838,1051,79.7,1857,830,1027,80.8
서울특별시,관악구,82세,2019,1553,642,911,70.5,1532,635,897,70.8
서울특별시,관악구,83세,2019,1314,537,777,69.1,1295,529,766,69.1
서울특별시,관악구,84세,2019,1204,461,743,62,1190,458,732,62.6
서울특별시,관악구,85세이상,2019,4396,1373,3023,45.4,4333,1355,2978,45.5
서울특별시,관악구,85~89세,2019,3120,1091,2029,53.8,3072,1076,1996,53.9
서울특별시,관악구,85세,2019,872,341,531,64.2,861,339,522,64.9
서울특별시,관악구,86세,2019,738,260,478,54.4,725,257,468,54.9
서울특별시,관악구,87세,2019,615,216,399,54.1,610,212,398,53.3
서울특별시,관악구,88세,2019,480,144,336,42.9,471,142,329,43.2
서울특별시,관악구,89세,2019,415,130,285,45.6,405,126,279,45.2
서울특별시,관악구,90~94세,2019,1002,224,778,28.8,992,222,770,28.8
서울특별시,관악구,90세,2019,333,87,246,35.4,331,87,244,35.7
서울특별시,관악구,91세,2019,254,58,196,29.6,250,56,194,28.9
서울특별시,관악구,92세,2019,192,52,140,37.1,190,52,138,37.7
서울특별시,관악구,93세,2019,146,19,127,15,145,19,126,15.1
서울특별시,관악구,94세,2019,77,8,69,11.6,76,8,68,11.8
서울특별시,관악구,95~99세,2019,238,53,185,28.6,233,52,181,28.7
서울특별시,관악구,95세,2019,71,14,57,24.6,67,13,54,24.1
서울특별시,관악구,96세,2019,79,17,62,27.4,78,17,61,27.9
서울특별시,관악구,97세,2019,44,13,31,41.9,44,13,31,41.9
서울특별시,관악구,98세,2019,28,6,22,27.3,28,6,22,27.3
서울특별시,관악구,99세,2019,16,X,13,23.1,16,X,13,23.1
서울특별시,관악구,100세이상,2019,36,5,31,16.1,36,5,31,16.1
서울특별시,관악구,15세미만,2019,38026,19574,18452,106.1,36910,19022,17888,106.3
서울특별시,관악구,15~64세,2019,396651,201836,194815,103.6,374220,191248,182972,104.5
서울특별시,관악구,65세이상,2019,73151,32672,40479,80.7,71346,31935,39411,81
서울특별시,관악구,평균연령,2019,41.9,41.1,42.7,,41.9,41,42.7,
서울특별시,관악구,중위연령,2019,39.4,38.6,40.4,,39.3,38.4,40.3,
서울특별시,서초구,합계,2019,404960,194195,210765,92.1,397025,189922,207103,91.7
서울특별시,서초구,0~4세,2019,14509,7452,7057,105.6,14027,7183,6844,105
서울특별시,서초구,0세,2019,2450,1276,1174,108.7,2414,1255,1159,108.3
서울특별시,서초구,1세,2019,2633,1419,1214,116.9,2559,1378,1181,116.7
서울특별시,서초구,2세,2019,2807,1399,1408,99.4,2684,1337,1347,99.3
서울특별시,서초구,3세,2019,3205,1607,1598,100.6,3080,1538,1542,99.7
서울특별시,서초구,4세,2019,3414,1751,1663,105.3,3290,1675,1615,103.7
서울특별시,서초구,5~9세,2019,19678,10237,9441,108.4,19338,10044,9294,108.1
서울특별시,서초구,5세,2019,3547,1871,1676,111.6,3443,1813,1630,111.2
서울특별시,서초구,6세,2019,3770,1974,1796,109.9,3705,1944,1761,110.4
서울특별시,서초구,7세,2019,4110,2135,1975,108.1,4040,2091,1949,107.3
서울특별시,서초구,8세,2019,4228,2220,2008,110.6,4170,2179,1991,109.4
서울특별시,서초구,9세,2019,4023,2037,1986,102.6,3980,2017,1963,102.8
서울특별시,서초구,10~14세,2019,20323,10374,9949,104.3,20128,10261,9867,104
서울특별시,서초구,10세,2019,3977,2043,1934,105.6,3924,2010,1914,105
서울특별시,서초구,11세,2019,4203,2149,2054,104.6,4161,2126,2035,104.5
서울특별시,서초구,12세,2019,4356,2142,2214,96.7,4307,2117,2190,96.7
서울특별시,서초구,13세,2019,3970,2052,1918,107,3941,2035,1906,106.8
서울특별시,서초구,14세,2019,3817,1988,1829,108.7,3795,1973,1822,108.3
서울특별시,서초구,15~19세,2019,21377,10694,10683,100.1,21202,10590,10612,99.8
서울특별시,서초구,15세,2019,4422,2240,2182,102.7,4398,2223,2175,102.2
서울특별시,서초구,16세,2019,3887,1981,1906,103.9,3865,1971,1894,104.1
서울특별시,서초구,17세,2019,3947,1990,1957,101.7,3921,1976,1945,101.6
서울특별시,서초구,18세,2019,4250,2126,2124,100.1,4229,2120,2109,100.5
서울특별시,서초구,19세,2019,4871,2357,2514,93.8,4789,2300,2489,92.4
서울특별시,서초구,20~24세,2019,23385,11325,12060,93.9,22741,10922,11819,92.4
서울특별시,서초구,20세,2019,4542,2231,2311,96.5,4458,2173,2285,95.1
서울특별시,서초구,21세,2019,4612,2328,2284,101.9,4516,2269,2247,101
서울특별시,서초구,22세,2019,4612,2298,2314,99.3,4463,2211,2252,98.2
서울특별시,서초구,23세,2019,4733,2254,2479,90.9,4592,2164,2428,89.1
서울특별시,서초구,24세,2019,4886,2214,2672,82.9,4712,2105,2607,80.7
서울특별시,서초구,25~29세,2019,28936,13716,15220,90.1,27963,13159,14804,88.9
서울특별시,서초구,25세,2019,5333,2563,2770,92.5,5120,2440,2680,91
서울특별시,서초구,26세,2019,5687,2676,3011,88.9,5483,2563,2920,87.8
서울특별시,서초구,27세,2019,6064,2846,3218,88.4,5876,2736,3140,87.1
서울특별시,서초구,28세,2019,6044,2820,3224,87.5,5863,2721,3142,86.6
서울특별시,서초구,29세,2019,5808,2811,2997,93.8,5621,2699,2922,92.4
서울특별시,서초구,30~34세,2019,29252,13623,15629,87.2,28188,13030,15158,86
서울특별시,서초구,30세,2019,6003,2794,3209,87.1,5774,2681,3093,86.7
서울특별시,서초구,31세,2019,5850,2731,3119,87.6,5633,2617,3016,86.8
서울특별시,서초구,32세,2019,5876,2716,3160,85.9,5664,2591,3073,84.3
서울특별시,서초구,33세,2019,5761,2687,3074,87.4,5567,2575,2992,86.1
서울특별시,서초구,34세,2019,5762,2695,3067,87.9,5550,2566,2984,86
서울특별시,서초구,35~39세,2019,34016,15878,18138,87.5,33066,15322,17744,86.4
서울특별시,서초구,35세,2019,6059,2866,3193,89.8,5857,2743,3114,88.1
서울특별시,서초구,36세,2019,6483,3013,3470,86.8,6294,2904,3390,85.7
서울특별시,서초구,37세,2019,7113,3352,3761,89.1,6907,3236,3671,88.2
서울특별시,서초구,38세,2019,7077,3254,3823,85.1,6884,3140,3744,83.9
서울특별시,서초구,39세,2019,7284,3393,3891,87.2,7124,3299,3825,86.2
서울특별시,서초구,40~44세,2019,34318,16000,18318,87.3,33589,15605,17984,86.8
서울특별시,서초구,40세,2019,7082,3319,3763,88.2,6911,3219,3692,87.2
서울특별시,서초구,41세,2019,6439,3004,3435,87.5,6299,2935,3364,87.2
서울특별시,서초구,42세,2019,6995,3228,3767,85.7,6847,3141,3706,84.8
서울특별시,서초구,43세,2019,6842,3098,3744,82.7,6708,3029,3679,82.3
서울특별시,서초구,44세,2019,6960,3351,3609,92.9,6824,3281,3543,92.6
서울특별시,서초구,45~49세,2019,39364,19084,20280,94.1,38689,18702,19987,93.6
서울특별시,서초구,45세,2019,7737,3682,4055,90.8,7598,3599,3999,90
서울특별시,서초구,46세,2019,7828,3740,4088,91.5,7694,3665,4029,91
서울특별시,서초구,47세,2019,7879,3844,4035,95.3,7753,3766,3987,94.5
서울특별시,서초구,48세,2019,8130,3986,4144,96.2,7996,3911,4085,95.7
서울특별시,서초구,49세,2019,7790,3832,3958,96.8,7648,3761,3887,96.8
서울특별시,서초구,50~54세,2019,31931,15833,16098,98.4,31423,15612,15811,98.7
서울특별시,서초구,50세,2019,7416,3753,3663,102.5,7319,3711,3608,102.9
서울특별시,서초구,51세,2019,6930,3405,3525,96.6,6830,3363,3467,97
서울특별시,서초구,52세,2019,6204,3036,3168,95.8,6096,2985,3111,95.9
서울특별시,서초구,53세,2019,5455,2732,2723,100.3,5358,2690,2668,100.8
서울특별시,서초구,54세,2019,5926,2907,3019,96.3,5820,2863,2957,96.8
서울특별시,서초구,55~59세,2019,28272,13538,14734,91.9,27822,13339,14483,92.1
서울특별시,서초구,55세,2019,5645,2738,2907,94.2,5566,2703,2863,94.4
서울특별시,서초구,56세,2019,5711,2767,2944,94,5604,2721,2883,94.4
서울특별시,서초구,57세,2019,5434,2624,2810,93.4,5341,2577,2764,93.2
서울특별시,서초구,58세,2019,5726,2683,3043,88.2,5642,2649,2993,88.5
서울특별시,서초구,59세,2019,5756,2726,3030,90,5669,2689,2980,90.2
서울특별시,서초구,60~64세,2019,26104,12045,14059,85.7,25726,11903,13823,86.1
서울특별시,서초구,60세,2019,5497,2517,2980,84.5,5416,2484,2932,84.7
서울특별시,서초구,61세,2019,5324,2535,2789,90.9,5248,2502,2746,91.1
서울특별시,서초구,62세,2019,5308,2414,2894,83.4,5228,2391,2837,84.3
서울특별시,서초구,63세,2019,4812,2259,2553,88.5,4739,2230,2509,88.9
서울특별시,서초구,64세,2019,5163,2320,2843,81.6,5095,2296,2799,82
서울특별시,서초구,65~69세,2019,18587,8560,10027,85.4,18410,8487,9923,85.5
서울특별시,서초구,65세,2019,4257,1981,2276,87,4206,1960,2246,87.3
서울특별시,서초구,66세,2019,4051,1823,2228,81.8,4017,1811,2206,82.1
서울특별시,서초구,67세,2019,4080,1865,2215,84.2,4045,1853,2192,84.5
서울특별시,서초구,68세,2019,2914,1379,1535,89.8,2886,1364,1522,89.6
서울특별시,서초구,69세,2019,3285,1512,1773,85.3,3256,1499,1757,85.3
서울특별시,서초구,70~74세,2019,15018,6984,8034,86.9,14934,6952,7982,87.1
서울특별시,서초구,70세,2019,3378,1528,1850,82.6,3364,1521,1843,82.5
서울특별시,서초구,71세,2019,3349,1584,1765,89.7,3323,1576,1747,90.2
서울특별시,서초구,72세,2019,3218,1491,1727,86.3,3207,1486,1721,86.3
서울특별시,서초구,73세,2019,2690,1239,1451,85.4,2671,1232,1439,85.6
서울특별시,서초구,74세,2019,2383,1142,1241,92,2369,1137,1232,92.3
서울특별시,서초구,75~79세,2019,10094,4962,5132,96.7,10043,4942,5101,96.9
서울특별시,서초구,75세,2019,2267,1104,1163,94.9,2254,1098,1156,95
서울특별시,서초구,76세,2019,2181,1070,1111,96.3,2170,1066,1104,96.6
서울특별시,서초구,77세,2019,2231,1135,1096,103.6,2224,1133,1091,103.8
서울특별시,서초구,78세,2019,1830,894,936,95.5,1820,892,928,96.1
서울특별시,서초구,79세,2019,1585,759,826,91.9,1575,753,822,91.6
서울특별시,서초구,80~84세,2019,5726,2593,3133,82.8,5697,2581,3116,82.8
서울특별시,서초구,80세,2019,1391,676,715,94.5,1386,674,712,94.7
서울특별시,서초구,81세,2019,1258,597,661,90.3,1252,596,656,90.9
서울특별시,서초구,82세,2019,1171,491,680,72.2,1162,486,676,71.9
서울특별시,서초구,83세,2019,965,440,525,83.8,963,439,524,83.8
서울특별시,서초구,84세,2019,941,389,552,70.5,934,386,548,70.4
서울특별시,서초구,85세이상,2019,4070,1297,2773,46.8,4039,1288,2751,46.8
서울특별시,서초구,85~89세,2019,2636,927,1709,54.2,2622,925,1697,54.5
서울특별시,서초구,85세,2019,720,273,447,61.1,717,272,445,61.1
서울특별시,서초구,86세,2019,590,211,379,55.7,589,211,378,55.8
서울특별시,서초구,87세,2019,574,216,358,60.3,570,215,355,60.6
서울특별시,서초구,88세,2019,392,128,264,48.5,388,128,260,49.2
서울특별시,서초구,89세,2019,360,99,261,37.9,358,99,259,38.2
서울특별시,서초구,90~94세,2019,1128,306,822,37.2,1118,301,817,36.8
서울특별시,서초구,90세,2019,341,103,238,43.3,339,103,236,43.6
서울특별시,서초구,91세,2019,306,67,239,28,302,66,236,28
서울특별시,서초구,92세,2019,218,58,160,36.3,215,55,160,34.4
서울특별시,서초구,93세,2019,144,47,97,48.5,144,47,97,48.5
서울특별시,서초구,94세,2019,119,31,88,35.2,118,30,88,34.1
서울특별시,서초구,95~99세,2019,271,59,212,27.8,266,58,208,27.9
서울특별시,서초구,95세,2019,89,18,71,25.4,88,18,70,25.7
서울특별시,서초구,96세,2019,85,27,58,46.6,84,27,57,47.4
서울특별시,서초구,97세,2019,50,7,43,16.3,49,7,42,16.7
서울특별시,서초구,98세,2019,26,X,24,8.3,26,X,24,8.3
서울특별시,서초구,99세,2019,21,5,16,31.3,19,X,15,26.7
서울특별시,서초구,100세이상,2019,35,5,30,16.7,33,X,29,13.8
서울특별시,서초구,15세미만,2019,54510,28063,26447,106.1,53493,27488,26005,105.7
서울특별시,서초구,15~64세,2019,296955,141736,155219,91.3,290409,138184,152225,90.8
서울특별시,서초구,65세이상,2019,53495,24396,29099,83.8,53123,24250,28873,84
서울특별시,서초구,평균연령,2019,40.9,40.3,41.5,,41,40.4,41.6,
서울특별시,서초구,중위연령,2019,41.6,41.2,42,,41.8,41.4,42.1,
서울특별시,강남구,합계,2019,509199,244403,264796,92.3,499474,239049,260425,91.8
서울특별시,강남구,0~4세,2019,14823,7611,7212,105.5,14512,7422,7090,104.7
서울특별시,강남구,0세,2019,2630,1386,1244,111.4,2598,1366,1232,110.9
서울특별시,강남구,1세,2019,2664,1443,1221,118.2,2611,1412,1199,117.8
서울특별시,강남구,2세,2019,2825,1427,1398,102.1,2744,1376,1368,100.6
서울특별시,강남구,3세,2019,3240,1586,1654,95.9,3157,1540,1617,95.2
서울특별시,강남구,4세,2019,3464,1769,1695,104.4,3402,1728,1674,103.2
서울특별시,강남구,5~9세,2019,21071,11016,10055,109.6,20875,10888,9987,109
서울특별시,강남구,5세,2019,3719,1955,1764,110.8,3670,1926,1744,110.4
서울특별시,강남구,6세,2019,4037,2091,1946,107.5,3988,2058,1930,106.6
서울특별시,강남구,7세,2019,4373,2287,2086,109.6,4331,2260,2071,109.1
서울특별시,강남구,8세,2019,4531,2390,2141,111.6,4495,2365,2130,111
서울특별시,강남구,9세,2019,4411,2293,2118,108.3,4391,2279,2112,107.9
서울특별시,강남구,10~14세,2019,25580,13377,12203,109.6,25481,13327,12154,109.7
서울특별시,강남구,10세,2019,4480,2329,2151,108.3,4459,2318,2141,108.3
서울특별시,강남구,11세,2019,5156,2689,2467,109,5137,2680,2457,109.1
서울특별시,강남구,12세,2019,5632,2948,2684,109.8,5611,2938,2673,109.9
서울특별시,강남구,13세,2019,5137,2699,2438,110.7,5119,2691,2428,110.8
서울특별시,강남구,14세,2019,5175,2712,2463,110.1,5155,2700,2455,110
서울특별시,강남구,15~19세,2019,28841,14972,13869,108,28595,14831,13764,107.8
서울특별시,강남구,15세,2019,5652,3004,2648,113.4,5623,2982,2641,112.9
서울특별시,강남구,16세,2019,5430,2804,2626,106.8,5403,2786,2617,106.5
서울특별시,강남구,17세,2019,5360,2788,2572,108.4,5324,2770,2554,108.5
서울특별시,강남구,18세,2019,6047,3121,2926,106.7,6010,3104,2906,106.8
서울특별시,강남구,19세,2019,6352,3255,3097,105.1,6235,3189,3046,104.7
서울특별시,강남구,20~24세,2019,29822,14654,15168,96.6,28752,14020,14732,95.2
서울특별시,강남구,20세,2019,5633,2849,2784,102.3,5456,2725,2731,99.8
서울특별시,강남구,21세,2019,5803,3061,2742,111.6,5615,2951,2664,110.8
서울특별시,강남구,22세,2019,5767,2843,2924,97.2,5578,2721,2857,95.2
서울특별시,강남구,23세,2019,6207,2954,3253,90.8,5962,2824,3138,90
서울특별시,강남구,24세,2019,6412,2947,3465,85.1,6141,2799,3342,83.8
서울특별시,강남구,25~29세,2019,38842,18231,20611,88.5,37255,17385,19870,87.5
서울특별시,강남구,25세,2019,7056,3254,3802,85.6,6775,3117,3658,85.2
서울특별시,강남구,26세,2019,7557,3568,3989,89.4,7237,3395,3842,88.4
서울특별시,강남구,27세,2019,8230,3805,4425,86,7897,3633,4264,85.2
서울특별시,강남구,28세,2019,7930,3804,4126,92.2,7612,3623,3989,90.8
서울특별시,강남구,29세,2019,8069,3800,4269,89,7734,3617,4117,87.9
서울특별시,강남구,30~34세,2019,38140,17805,20335,87.6,36652,16959,19693,86.1
서울특별시,강남구,30세,2019,8009,3780,4229,89.4,7692,3622,4070,89
서울특별시,강남구,31세,2019,7503,3472,4031,86.1,7202,3297,3905,84.4
서울특별시,강남구,32세,2019,7577,3478,4099,84.8,7283,3321,3962,83.8
서울특별시,강남구,33세,2019,7563,3569,3994,89.4,7276,3392,3884,87.3
서울특별시,강남구,34세,2019,7488,3506,3982,88,7199,3327,3872,85.9
서울특별시,강남구,35~39세,2019,42611,19670,22941,85.7,41438,18977,22461,84.5
서울특별시,강남구,35세,2019,7767,3616,4151,87.1,7505,3454,4051,85.3
서울특별시,강남구,36세,2019,8211,3837,4374,87.7,7977,3703,4274,86.6
서울특별시,강남구,37세,2019,8753,3944,4809,82,8498,3797,4701,80.8
서울특별시,강남구,38세,2019,8962,4128,4834,85.4,8768,4016,4752,84.5
서울특별시,강남구,39세,2019,8918,4145,4773,86.8,8690,4007,4683,85.6
서울특별시,강남구,40~44세,2019,42820,19648,23172,84.8,41978,19148,22830,83.9
서울특별시,강남구,40세,2019,8866,3992,4874,81.9,8661,3872,4789,80.9
서울특별시,강남구,41세,2019,8082,3757,4325,86.9,7902,3637,4265,85.3
서울특별시,강남구,42세,2019,8489,3887,4602,84.5,8328,3803,4525,84
서울특별시,강남구,43세,2019,8460,3879,4581,84.7,8319,3799,4520,84
서울특별시,강남구,44세,2019,8923,4133,4790,86.3,8768,4037,4731,85.3
서울특별시,강남구,45~49세,2019,50261,24068,26193,91.9,49541,23649,25892,91.3
서울특별시,강남구,45세,2019,9610,4476,5134,87.2,9459,4380,5079,86.2
서울특별시,강남구,46세,2019,9663,4491,5172,86.8,9521,4408,5113,86.2
서울특별시,강남구,47세,2019,10156,4860,5296,91.8,10010,4782,5228,91.5
서울특별시,강남구,48세,2019,10625,5262,5363,98.1,10488,5185,5303,97.8
서울특별시,강남구,49세,2019,10207,4979,5228,95.2,10063,4894,5169,94.7
서울특별시,강남구,50~54세,2019,41943,20990,20953,100.2,41350,20692,20658,100.2
서울특별시,강남구,50세,2019,9807,4896,4911,99.7,9676,4827,4849,99.5
서울특별시,강남구,51세,2019,8956,4477,4479,100,8854,4420,4434,99.7
서울특별시,강남구,52세,2019,8221,4011,4210,95.3,8095,3948,4147,95.2
서울특별시,강남구,53세,2019,7277,3773,3504,107.7,7161,3717,3444,107.9
서울특별시,강남구,54세,2019,7682,3833,3849,99.6,7564,3780,3784,99.9
서울특별시,강남구,55~59세,2019,35466,17276,18190,95,34943,17040,17903,95.2
서울특별시,강남구,55세,2019,7152,3516,3636,96.7,7048,3470,3578,97
서울특별시,강남구,56세,2019,7305,3612,3693,97.8,7178,3554,3624,98.1
서울특별시,강남구,57세,2019,6773,3394,3379,100.4,6665,3337,3328,100.3
서울특별시,강남구,58세,2019,7127,3410,3717,91.7,7051,3379,3672,92
서울특별시,강남구,59세,2019,7109,3344,3765,88.8,7001,3300,3701,89.2
서울특별시,강남구,60~64세,2019,32189,14747,17442,84.5,31758,14567,17191,84.7
서울특별시,강남구,60세,2019,6593,3097,3496,88.6,6500,3061,3439,89
서울특별시,강남구,61세,2019,6478,2969,3509,84.6,6394,2938,3456,85
서울특별시,강남구,62세,2019,6572,3044,3528,86.3,6478,3003,3475,86.4
서울특별시,강남구,63세,2019,6092,2812,3280,85.7,6003,2771,3232,85.7
서울특별시,강남구,64세,2019,6454,2825,3629,77.8,6383,2794,3589,77.8
서울특별시,강남구,65~69세,2019,23510,10706,12804,83.6,23303,10629,12674,83.9
서울특별시,강남구,65세,2019,5415,2469,2946,83.8,5349,2444,2905,84.1
서울특별시,강남구,66세,2019,5027,2246,2781,80.8,4982,2230,2752,81
서울특별시,강남구,67세,2019,5292,2398,2894,82.9,5243,2379,2864,83.1
서울특별시,강남구,68세,2019,3579,1687,1892,89.2,3552,1677,1875,89.4
서울특별시,강남구,69세,2019,4197,1906,2291,83.2,4177,1899,2278,83.4
서울특별시,강남구,70~74세,2019,18895,8934,9961,89.7,18798,8885,9913,89.6
서울특별시,강남구,70세,2019,4294,1996,2298,86.9,4268,1985,2283,86.9
서울특별시,강남구,71세,2019,4220,2031,2189,92.8,4200,2019,2181,92.6
서울특별시,강남구,72세,2019,4096,1882,2214,85,4072,1869,2203,84.8
서울특별시,강남구,73세,2019,3335,1594,1741,91.6,3323,1590,1733,91.7
서울특별시,강남구,74세,2019,2950,1431,1519,94.2,2935,1422,1513,94
서울특별시,강남구,75~79세,2019,12433,6093,6340,96.1,12378,6065,6313,96.1
서울특별시,강남구,75세,2019,2796,1393,1403,99.3,2786,1386,1400,99
서울특별시,강남구,76세,2019,2639,1293,1346,96.1,2630,1289,1341,96.1
서울특별시,강남구,77세,2019,2761,1400,1361,102.9,2741,1391,1350,103
서울특별시,강남구,78세,2019,2287,1080,1207,89.5,2276,1076,1200,89.7
서울특별시,강남구,79세,2019,1950,927,1023,90.6,1945,923,1022,90.3
서울특별시,강남구,80~84세,2019,6919,3086,3833,80.5,6877,3064,3813,80.4
서울특별시,강남구,80세,2019,1686,819,867,94.5,1675,812,863,94.1
서울특별시,강남구,81세,2019,1577,713,864,82.5,1569,709,860,82.4
서울특별시,강남구,82세,2019,1411,624,787,79.3,1401,621,780,79.6
서울특별시,강남구,83세,2019,1144,503,641,78.5,1138,500,638,78.4
서울특별시,강남구,84세,2019,1101,427,674,63.4,1094,422,672,62.8
서울특별시,강남구,85세이상,2019,5033,1519,3514,43.2,4988,1501,3487,43
서울특별시,강남구,85~89세,2019,3298,1087,2211,49.2,3272,1077,2195,49.1
서울특별시,강남구,85세,2019,892,321,571,56.2,883,318,565,56.3
서울특별시,강남구,86세,2019,716,243,473,51.4,711,242,469,51.6
서울특별시,강남구,87세,2019,706,245,461,53.1,703,244,459,53.2
서울특별시,강남구,88세,2019,506,146,360,40.6,503,145,358,40.5
서울특별시,강남구,89세,2019,478,132,346,38.2,472,128,344,37.2
서울특별시,강남구,90~94세,2019,1354,344,1010,34.1,1340,338,1002,33.7
서울특별시,강남구,90세,2019,428,118,310,38.1,424,117,307,38.1
서울특별시,강남구,91세,2019,330,80,250,32,326,77,249,30.9
서울특별시,강남구,92세,2019,269,65,204,31.9,267,64,203,31.5
서울특별시,강남구,93세,2019,171,37,134,27.6,169,36,133,27.1
서울특별시,강남구,94세,2019,156,44,112,39.3,154,44,110,40
서울특별시,강남구,95~99세,2019,334,81,253,32,332,79,253,31.2
서울특별시,강남구,95세,2019,114,29,85,34.1,113,28,85,32.9
서울특별시,강남구,96세,2019,88,20,68,29.4,88,20,68,29.4
서울특별시,강남구,97세,2019,56,12,44,27.3,55,11,44,25
서울특별시,강남구,98세,2019,44,13,31,41.9,44,13,31,41.9
서울특별시,강남구,99세,2019,32,7,25,28,32,7,25,28
서울특별시,강남구,100세이상,2019,47,7,40,17.5,44,7,37,18.9
서울특별시,강남구,15세미만,2019,61474,32004,29470,108.6,60868,31637,29231,108.2
서울특별시,강남구,15~64세,2019,380935,182061,198874,91.5,372262,177268,194994,90.9
서울특별시,강남구,65세이상,2019,66790,30338,36452,83.2,66344,30144,36200,83.3
서울특별시,강남구,평균연령,2019,41.2,40.5,41.9,,41.3,40.6,41.9,
서울특별시,강남구,중위연령,2019,41.7,41.2,42.2,,42,41.5,42.3,
서울특별시,송파구,합계,2019,648600,313725,334875,93.7,637683,308300,329383,93.6
서울특별시,송파구,0~4세,2019,24494,12813,11681,109.7,24147,12627,11520,109.6
서울특별시,송파구,0세,2019,4389,2282,2107,108.3,4351,2260,2091,108.1
서울특별시,송파구,1세,2019,4421,2345,2076,113,4354,2308,2046,112.8
서울특별시,송파구,2세,2019,4814,2499,2315,107.9,4744,2462,2282,107.9
서울특별시,송파구,3세,2019,5433,2856,2577,110.8,5338,2800,2538,110.3
서울특별시,송파구,4세,2019,5437,2831,2606,108.6,5360,2797,2563,109.1
서울특별시,송파구,5~9세,2019,27386,14026,13360,105,27144,13910,13234,105.1
서울특별시,송파구,5세,2019,5200,2673,2527,105.8,5142,2646,2496,106
서울특별시,송파구,6세,2019,5273,2688,2585,104,5217,2657,2560,103.8
서울특별시,송파구,7세,2019,5849,2974,2875,103.4,5802,2955,2847,103.8
서울특별시,송파구,8세,2019,5536,2887,2649,109,5488,2866,2622,109.3
서울특별시,송파구,9세,2019,5528,2804,2724,102.9,5495,2786,2709,102.8
서울특별시,송파구,10~14세,2019,27014,13803,13211,104.5,26888,13748,13140,104.6
서울특별시,송파구,10세,2019,5236,2641,2595,101.8,5196,2624,2572,102
서울특별시,송파구,11세,2019,5459,2810,2649,106.1,5434,2801,2633,106.4
서울특별시,송파구,12세,2019,5662,2899,2763,104.9,5642,2892,2750,105.2
서울특별시,송파구,13세,2019,5392,2731,2661,102.6,5373,2719,2654,102.4
서울특별시,송파구,14세,2019,5265,2722,2543,107,5243,2712,2531,107.2
서울특별시,송파구,15~19세,2019,30762,15730,15032,104.6,30604,15645,14959,104.6
서울특별시,송파구,15세,2019,5665,2897,2768,104.7,5645,2886,2759,104.6
서울특별시,송파구,16세,2019,5624,2894,2730,106,5606,2885,2721,106
서울특별시,송파구,17세,2019,5727,2955,2772,106.6,5705,2948,2757,106.9
서울특별시,송파구,18세,2019,6549,3335,3214,103.8,6533,3323,3210,103.5
서울특별시,송파구,19세,2019,7197,3649,3548,102.8,7115,3603,3512,102.6
서울특별시,송파구,20~24세,2019,38305,18820,19485,96.6,37635,18475,19160,96.4
서울특별시,송파구,20세,2019,7006,3637,3369,108,6895,3565,3330,107.1
서울특별시,송파구,21세,2019,7053,3666,3387,108.2,6946,3604,3342,107.8
서울특별시,송파구,22세,2019,7513,3779,3734,101.2,7396,3727,3669,101.6
서울특별시,송파구,23세,2019,8020,3749,4271,87.8,7862,3673,4189,87.7
서울특별시,송파구,24세,2019,8713,3989,4724,84.4,8536,3906,4630,84.4
서울특별시,송파구,25~29세,2019,51785,24296,27489,88.4,50599,23719,26880,88.2
서울특별시,송파구,25세,2019,9680,4482,5198,86.2,9438,4365,5073,86
서울특별시,송파구,26세,2019,10318,4829,5489,88,10080,4726,5354,88.3
서울특별시,송파구,27세,2019,10726,4977,5749,86.6,10503,4871,5632,86.5
서울특별시,송파구,28세,2019,10478,4976,5502,90.4,10262,4855,5407,89.8
서울특별시,송파구,29세,2019,10583,5032,5551,90.7,10316,4902,5414,90.5
서울특별시,송파구,30~34세,2019,52640,25190,27450,91.8,51185,24477,26708,91.6
서울특별시,송파구,30세,2019,10646,5049,5597,90.2,10350,4923,5427,90.7
서울특별시,송파구,31세,2019,10341,4980,5361,92.9,10067,4855,5212,93.2
서울특별시,송파구,32세,2019,10585,5080,5505,92.3,10256,4906,5350,91.7
서울특별시,송파구,33세,2019,10571,5052,5519,91.5,10294,4909,5385,91.2
서울특별시,송파구,34세,2019,10497,5029,5468,92,10218,4884,5334,91.6
서울특별시,송파구,35~39세,2019,57621,27933,29688,94.1,56477,27311,29166,93.6
서울특별시,송파구,35세,2019,10651,5197,5454,95.3,10387,5056,5331,94.8
서울특별시,송파구,36세,2019,11533,5547,5986,92.7,11268,5398,5870,92
서울특별시,송파구,37세,2019,12004,5849,6155,95,11774,5727,6047,94.7
서울특별시,송파구,38세,2019,11727,5747,5980,96.1,11509,5623,5886,95.5
서울특별시,송파구,39세,2019,11706,5593,6113,91.5,11539,5507,6032,91.3
서울특별시,송파구,40~44세,2019,50333,24434,25899,94.3,49491,23980,25511,94
서울특별시,송파구,40세,2019,10984,5191,5793,89.6,10781,5083,5698,89.2
서울특별시,송파구,41세,2019,9646,4709,4937,95.4,9467,4604,4863,94.7
서울특별시,송파구,42세,2019,9904,4751,5153,92.2,9763,4673,5090,91.8
서울특별시,송파구,43세,2019,9698,4830,4868,99.2,9539,4744,4795,98.9
서울특별시,송파구,44세,2019,10101,4953,5148,96.2,9941,4876,5065,96.3
서울특별시,송파구,45~49세,2019,55111,26683,28428,93.9,54130,26143,27987,93.4
서울특별시,송파구,45세,2019,10654,5218,5436,96,10478,5127,5351,95.8
서울특별시,송파구,46세,2019,10707,5071,5636,90,10546,4976,5570,89.3
서울특별시,송파구,47세,2019,11051,5402,5649,95.6,10837,5279,5558,95
서울특별시,송파구,48세,2019,11777,5608,6169,90.9,11568,5490,6078,90.3
서울특별시,송파구,49세,2019,10922,5384,5538,97.2,10701,5271,5430,97.1
서울특별시,송파구,50~54세,2019,51701,24982,26719,93.5,50590,24455,26135,93.6
서울특별시,송파구,50세,2019,11208,5469,5739,95.3,10982,5353,5629,95.1
서울특별시,송파구,51세,2019,10936,5172,5764,89.7,10671,5049,5622,89.8
서울특별시,송파구,52세,2019,9934,4776,5158,92.6,9757,4688,5069,92.5
서울특별시,송파구,53세,2019,9553,4712,4841,97.3,9342,4625,4717,98
서울특별시,송파구,54세,2019,10070,4853,5217,93,9838,4740,5098,93
서울특별시,송파구,55~59세,2019,51092,24185,26907,89.9,50034,23696,26338,90
서울특별시,송파구,55세,2019,9534,4565,4969,91.9,9289,4448,4841,91.9
서울특별시,송파구,56세,2019,10175,4926,5249,93.8,9927,4810,5117,94
서울특별시,송파구,57세,2019,9840,4734,5106,92.7,9637,4635,5002,92.7
서울특별시,송파구,58세,2019,10684,4960,5724,86.7,10533,4896,5637,86.9
서울특별시,송파구,59세,2019,10859,5000,5859,85.3,10648,4907,5741,85.5
서울특별시,송파구,60~64세,2019,46846,22099,24747,89.3,45973,21694,24279,89.4
서울특별시,송파구,60세,2019,10028,4756,5272,90.2,9841,4676,5165,90.5
서울특별시,송파구,61세,2019,9469,4477,4992,89.7,9285,4390,4895,89.7
서울특별시,송파구,62세,2019,9556,4468,5088,87.8,9366,4373,4993,87.6
서울특별시,송파구,63세,2019,8511,4022,4489,89.6,8359,3957,4402,89.9
서울특별시,송파구,64세,2019,9282,4376,4906,89.2,9122,4298,4824,89.1
서울특별시,송파구,65~69세,2019,31885,15465,16420,94.2,31495,15278,16217,94.2
서울특별시,송파구,65세,2019,7544,3563,3981,89.5,7439,3516,3923,89.6
서울특별시,송파구,66세,2019,6870,3289,3581,91.8,6773,3242,3531,91.8
서울특별시,송파구,67세,2019,7205,3558,3647,97.6,7136,3519,3617,97.3
서울특별시,송파구,68세,2019,4890,2398,2492,96.2,4823,2369,2454,96.5
서울특별시,송파구,69세,2019,5376,2657,2719,97.7,5324,2632,2692,97.8
서울특별시,송파구,70~74세,2019,22540,11080,11460,96.7,22350,11005,11345,97
서울특별시,송파구,70세,2019,5310,2619,2691,97.3,5254,2597,2657,97.7
서울특별시,송파구,71세,2019,4921,2428,2493,97.4,4882,2415,2467,97.9
서울특별시,송파구,72세,2019,5110,2508,2602,96.4,5077,2494,2583,96.6
서울특별시,송파구,73세,2019,3779,1854,1925,96.3,3744,1840,1904,96.6
서울특별시,송파구,74세,2019,3420,1671,1749,95.5,3393,1659,1734,95.7
서울특별시,송파구,75~79세,2019,14626,7005,7621,91.9,14555,6979,7576,92.1
서울특별시,송파구,75세,2019,3279,1619,1660,97.5,3266,1613,1653,97.6
서울특별시,송파구,76세,2019,3100,1509,1591,94.8,3087,1504,1583,95
서울특별시,송파구,77세,2019,3351,1595,1756,90.8,3337,1590,1747,91
서울특별시,송파구,78세,2019,2609,1218,1391,87.6,2596,1215,1381,88
서울특별시,송파구,79세,2019,2287,1064,1223,87,2269,1057,1212,87.2
서울특별시,송파구,80~84세,2019,8355,3427,4928,69.5,8316,3417,4899,69.7
서울특별시,송파구,80세,2019,2087,927,1160,79.9,2081,925,1156,80
서울특별시,송파구,81세,2019,1811,788,1023,77,1796,784,1012,77.5
서울특별시,송파구,82세,2019,1666,690,976,70.7,1658,689,969,71.1
서울특별시,송파구,83세,2019,1455,538,917,58.7,1448,536,912,58.8
서울특별시,송파구,84세,2019,1336,484,852,56.8,1333,483,850,56.8
서울특별시,송파구,85세이상,2019,6104,1754,4350,40.3,6070,1741,4329,40.2
서울특별시,송파구,85~89세,2019,4151,1291,2860,45.1,4129,1284,2845,45.1
서울특별시,송파구,85세,2019,1104,397,707,56.2,1098,397,701,56.6
서울특별시,송파구,86세,2019,986,291,695,41.9,981,289,692,41.8
서울특별시,송파구,87세,2019,861,268,593,45.2,856,266,590,45.1
서울특별시,송파구,88세,2019,652,192,460,41.7,647,189,458,41.3
서울특별시,송파구,89세,2019,548,143,405,35.3,547,143,404,35.4
서울특별시,송파구,90~94세,2019,1580,381,1199,31.8,1571,377,1194,31.6
서울특별시,송파구,90세,2019,486,122,364,33.5,483,120,363,33.1
서울특별시,송파구,91세,2019,399,106,293,36.2,399,106,293,36.2
서울특별시,송파구,92세,2019,319,76,243,31.3,317,75,242,31
서울특별시,송파구,93세,2019,222,47,175,26.9,219,46,173,26.6
서울특별시,송파구,94세,2019,154,30,124,24.2,153,30,123,24.4
서울특별시,송파구,95~99세,2019,332,73,259,28.2,329,71,258,27.5
서울특별시,송파구,95세,2019,105,30,75,40,105,30,75,40
서울특별시,송파구,96세,2019,96,18,78,23.1,95,17,78,21.8
서울특별시,송파구,97세,2019,58,8,50,16,57,7,50,14
서울특별시,송파구,98세,2019,46,10,36,27.8,45,10,35,28.6
서울특별시,송파구,99세,2019,27,7,20,35,27,7,20,35
서울특별시,송파구,100세이상,2019,41,9,32,28.1,41,9,32,28.1
서울특별시,송파구,15세미만,2019,78894,40642,38252,106.2,78179,40285,37894,106.3
서울특별시,송파구,15~64세,2019,486196,234352,251844,93.1,476718,229595,247123,92.9
서울특별시,송파구,65세이상,2019,83510,38731,44779,86.5,82786,38420,44366,86.6
서울특별시,송파구,평균연령,2019,41.3,40.7,41.9,,41.3,40.7,41.9,
서울특별시,송파구,중위연령,2019,41.3,40.8,41.9,,41.4,40.8,41.9,
서울특별시,강동구,합계,2019,415287,204807,210480,97.3,408618,201609,207009,97.4
서울특별시,강동구,0~4세,2019,14087,7278,6809,106.9,13946,7201,6745,106.8
서울특별시,강동구,0세,2019,2524,1278,1246,102.6,2500,1265,1235,102.4
서울특별시,강동구,1세,2019,2539,1327,1212,109.5,2517,1316,1201,109.6
서울특별시,강동구,2세,2019,2751,1410,1341,105.1,2721,1396,1325,105.4
서울특별시,강동구,3세,2019,3081,1621,1460,111,3048,1600,1448,110.5
서울특별시,강동구,4세,2019,3192,1642,1550,105.9,3160,1624,1536,105.7
서울특별시,강동구,5~9세,2019,16482,8592,7890,108.9,16383,8545,7838,109
서울특별시,강동구,5세,2019,3274,1662,1612,103.1,3248,1649,1599,103.1
서울특별시,강동구,6세,2019,3061,1599,1462,109.4,3040,1588,1452,109.4
서울특별시,강동구,7세,2019,3434,1796,1638,109.6,3413,1785,1628,109.6
서울특별시,강동구,8세,2019,3332,1752,1580,110.9,3319,1749,1570,111.4
서울특별시,강동구,9세,2019,3381,1783,1598,111.6,3363,1774,1589,111.6
서울특별시,강동구,10~14세,2019,16633,8843,7790,113.5,16580,8817,7763,113.6
서울특별시,강동구,10세,2019,3184,1619,1565,103.5,3170,1609,1561,103.1
서울특별시,강동구,11세,2019,3511,1903,1608,118.3,3499,1898,1601,118.6
서울특별시,강동구,12세,2019,3549,1928,1621,118.9,3541,1925,1616,119.1
서울특별시,강동구,13세,2019,3262,1733,1529,113.3,3256,1729,1527,113.2
서울특별시,강동구,14세,2019,3127,1660,1467,113.2,3114,1656,1458,113.6
서울특별시,강동구,15~19세,2019,19293,10189,9104,111.9,19206,10153,9053,112.2
서울특별시,강동구,15세,2019,3639,1889,1750,107.9,3624,1883,1741,108.2
서울특별시,강동구,16세,2019,3630,1916,1714,111.8,3622,1913,1709,111.9
서울특별시,강동구,17세,2019,3779,2061,1718,120,3767,2058,1709,120.4
서울특별시,강동구,18세,2019,4071,2169,1902,114,4054,2164,1890,114.5
서울특별시,강동구,19세,2019,4174,2154,2020,106.6,4139,2135,2004,106.5
서울특별시,강동구,20~24세,2019,24040,12321,11719,105.1,23647,12124,11523,105.2
서울특별시,강동구,20세,2019,4103,2209,1894,116.6,4052,2177,1875,116.1
서울특별시,강동구,21세,2019,4455,2330,2125,109.6,4400,2299,2101,109.4
서울특별시,강동구,22세,2019,4676,2438,2238,108.9,4608,2408,2200,109.5
서울특별시,강동구,23세,2019,5222,2578,2644,97.5,5127,2530,2597,97.4
서울특별시,강동구,24세,2019,5584,2766,2818,98.2,5460,2710,2750,98.5
서울특별시,강동구,25~29세,2019,30972,15410,15562,99,30316,15086,15230,99.1
서울특별시,강동구,25세,2019,5767,2764,3003,92,5649,2709,2940,92.1
서울특별시,강동구,26세,2019,6216,3126,3090,101.2,6093,3057,3036,100.7
서울특별시,강동구,27세,2019,6583,3238,3345,96.8,6446,3170,3276,96.8
서울특별시,강동구,28세,2019,6293,3133,3160,99.1,6156,3062,3094,99
서울특별시,강동구,29세,2019,6113,3149,2964,106.2,5972,3088,2884,107.1
서울특별시,강동구,30~34세,2019,29695,14887,14808,100.5,28963,14539,14424,100.8
서울특별시,강동구,30세,2019,5886,2956,2930,100.9,5742,2897,2845,101.8
서울특별시,강동구,31세,2019,5963,2984,2979,100.2,5814,2916,2898,100.6
서울특별시,강동구,32세,2019,5898,2916,2982,97.8,5743,2837,2906,97.6
서울특별시,강동구,33세,2019,5881,2950,2931,100.6,5731,2874,2857,100.6
서울특별시,강동구,34세,2019,6067,3081,2986,103.2,5933,3015,2918,103.3
서울특별시,강동구,35~39세,2019,34656,17418,17238,101,34017,17099,16918,101.1
서울특별시,강동구,35세,2019,6374,3200,3174,100.8,6223,3130,3093,101.2
서울특별시,강동구,36세,2019,6652,3339,3313,100.8,6534,3283,3251,101
서울특별시,강동구,37세,2019,7197,3565,3632,98.2,7066,3500,3566,98.1
서울특별시,강동구,38세,2019,7275,3663,3612,101.4,7157,3605,3552,101.5
서울특별시,강동구,39세,2019,7158,3651,3507,104.1,7037,3581,3456,103.6
서울특별시,강동구,40~44세,2019,31421,15728,15693,100.2,30903,15463,15440,100.1
서울특별시,강동구,40세,2019,6874,3428,3446,99.5,6770,3374,3396,99.4
서울특별시,강동구,41세,2019,6196,3104,3092,100.4,6087,3038,3049,99.6
서울특별시,강동구,42세,2019,6247,3101,3146,98.6,6137,3043,3094,98.4
서울특별시,강동구,43세,2019,5969,3060,2909,105.2,5859,3009,2850,105.6
서울특별시,강동구,44세,2019,6135,3035,3100,97.9,6050,2999,3051,98.3
서울특별시,강동구,45~49세,2019,34859,17341,17518,99,34170,17008,17162,99.1
서울특별시,강동구,45세,2019,6692,3375,3317,101.7,6598,3326,3272,101.7
서울특별시,강동구,46세,2019,6872,3347,3525,95,6741,3283,3458,94.9
서울특별시,강동구,47세,2019,6986,3496,3490,100.2,6848,3426,3422,100.1
서울특별시,강동구,48세,2019,7263,3687,3576,103.1,7099,3615,3484,103.8
서울특별시,강동구,49세,2019,7046,3436,3610,95.2,6884,3358,3526,95.2
서울특별시,강동구,50~54세,2019,33448,16215,17233,94.1,32724,15881,16843,94.3
서울특별시,강동구,50세,2019,7110,3448,3662,94.2,6961,3368,3593,93.7
서울특별시,강동구,51세,2019,7174,3486,3688,94.5,7027,3413,3614,94.4
서울특별시,강동구,52세,2019,6385,3026,3359,90.1,6260,2978,3282,90.7
서울특별시,강동구,53세,2019,6282,3144,3138,100.2,6127,3082,3045,101.2
서울특별시,강동구,54세,2019,6497,3111,3386,91.9,6349,3040,3309,91.9
서울특별시,강동구,55~59세,2019,35659,17040,18619,91.5,34887,16675,18212,91.6
서울특별시,강동구,55세,2019,6436,3066,3370,91,6280,2991,3289,90.9
서울특별시,강동구,56세,2019,6779,3283,3496,93.9,6588,3197,3391,94.3
서울특별시,강동구,57세,2019,7062,3454,3608,95.7,6910,3386,3524,96.1
서울특별시,강동구,58세,2019,7601,3577,4024,88.9,7489,3529,3960,89.1
서울특별시,강동구,59세,2019,7781,3660,4121,88.8,7620,3572,4048,88.2
서울특별시,강동구,60~64세,2019,33305,15701,17604,89.2,32661,15401,17260,89.2
서울특별시,강동구,60세,2019,7141,3344,3797,88.1,7014,3289,3725,88.3
서울특별시,강동구,61세,2019,6696,3214,3482,92.3,6543,3141,3402,92.3
서울특별시,강동구,62세,2019,6758,3236,3522,91.9,6631,3171,3460,91.6
서울특별시,강동구,63세,2019,6231,2874,3357,85.6,6110,2822,3288,85.8
서울특별시,강동구,64세,2019,6479,3033,3446,88,6363,2978,3385,88
서울특별시,강동구,65~69세,2019,22644,10936,11708,93.4,22320,10776,11544,93.3
서울특별시,강동구,65세,2019,5392,2574,2818,91.3,5303,2533,2770,91.4
서울특별시,강동구,66세,2019,4758,2275,2483,91.6,4681,2236,2445,91.5
서울특별시,강동구,67세,2019,5155,2482,2673,92.9,5090,2450,2640,92.8
서울특별시,강동구,68세,2019,3510,1731,1779,97.3,3460,1703,1757,96.9
서울특별시,강동구,69세,2019,3829,1874,1955,95.9,3786,1854,1932,96
서울특별시,강동구,70~74세,2019,16545,8105,8440,96,16441,8069,8372,96.4
서울특별시,강동구,70세,2019,3927,1899,2028,93.6,3895,1890,2005,94.3
서울특별시,강동구,71세,2019,3797,1907,1890,100.9,3774,1899,1875,101.3
서울특별시,강동구,72세,2019,3587,1695,1892,89.6,3565,1686,1879,89.7
서울특별시,강동구,73세,2019,2704,1340,1364,98.2,2684,1333,1351,98.7
서울특별시,강동구,74세,2019,2530,1264,1266,99.8,2523,1261,1262,99.9
서울특별시,강동구,75~79세,2019,10881,5187,5694,91.1,10832,5168,5664,91.2
서울특별시,강동구,75세,2019,2445,1190,1255,94.8,2430,1182,1248,94.7
서울특별시,강동구,76세,2019,2309,1122,1187,94.5,2298,1119,1179,94.9
서울특별시,강동구,77세,2019,2522,1194,1328,89.9,2514,1192,1322,90.2
서울특별시,강동구,78세,2019,1976,931,1045,89.1,1969,928,1041,89.1
서울특별시,강동구,79세,2019,1629,750,879,85.3,1621,747,874,85.5
서울특별시,강동구,80~84세,2019,6186,2425,3761,64.5,6161,2419,3742,64.6
서울특별시,강동구,80세,2019,1583,669,914,73.2,1575,667,908,73.5
서울특별시,강동구,81세,2019,1376,578,798,72.4,1368,577,791,72.9
서울특별시,강동구,82세,2019,1209,467,742,62.9,1205,465,740,62.8
서울특별시,강동구,83세,2019,1036,388,648,59.9,1033,387,646,59.9
서울특별시,강동구,84세,2019,982,323,659,49,980,323,657,49.2
서울특별시,강동구,85세이상,2019,4481,1191,3290,36.2,4461,1185,3276,36.2
서울특별시,강동구,85~89세,2019,2943,854,2089,40.9,2930,850,2080,40.9
서울특별시,강동구,85세,2019,789,251,538,46.7,786,251,535,46.9
서울특별시,강동구,86세,2019,668,216,452,47.8,662,214,448,47.8
서울특별시,강동구,87세,2019,593,159,434,36.6,591,159,432,36.8
서울특별시,강동구,88세,2019,451,120,331,36.3,450,119,331,36
서울특별시,강동구,89세,2019,442,108,334,32.3,441,107,334,32
서울특별시,강동구,90~94세,2019,1223,269,954,28.2,1219,268,951,28.2
서울특별시,강동구,90세,2019,393,100,293,34.1,392,100,292,34.2
서울특별시,강동구,91세,2019,295,68,227,30,295,68,227,30
서울특별시,강동구,92세,2019,242,48,194,24.7,241,47,194,24.2
서울특별시,강동구,93세,2019,170,35,135,25.9,169,35,134,26.1
서울특별시,강동구,94세,2019,123,18,105,17.1,122,18,104,17.3
서울특별시,강동구,95~99세,2019,272,62,210,29.5,270,61,209,29.2
서울특별시,강동구,95세,2019,80,20,60,33.3,80,20,60,33.3
서울특별시,강동구,96세,2019,80,17,63,27,79,16,63,25.4
서울특별시,강동구,97세,2019,45,9,36,25,45,9,36,25
서울특별시,강동구,98세,2019,36,9,27,33.3,35,9,26,34.6
서울특별시,강동구,99세,2019,31,7,24,29.2,31,7,24,29.2
서울특별시,강동구,100세이상,2019,43,6,37,16.2,42,6,36,16.7
서울특별시,강동구,15세미만,2019,47202,24713,22489,109.9,46909,24563,22346,109.9
서울특별시,강동구,15~64세,2019,307348,152250,155098,98.2,301494,149429,152065,98.3
서울특별시,강동구,65세이상,2019,60737,27844,32893,84.7,60215,27617,32598,84.7
서울특별시,강동구,평균연령,2019,42.7,41.7,43.6,,42.6,41.7,43.6,
서울특별시,강동구,중위연령,2019,43.4,42.3,44.6,,43.4,42.3,44.5,
경기도,수원시장안구,합계,2019,282288,143174,139114,102.9,271875,137699,134176,102.6
경기도,수원시장안구,0~4세,2019,8656,4434,4222,105,8348,4281,4067,105.3
경기도,수원시장안구,0세,2019,1387,676,711,95.1,1315,638,677,94.2
경기도,수원시장안구,1세,2019,1481,771,710,108.6,1417,741,676,109.6
경기도,수원시장안구,2세,2019,1688,880,808,108.9,1625,855,770,111
경기도,수원시장안구,3세,2019,1960,1002,958,104.6,1895,964,931,103.5
경기도,수원시장안구,4세,2019,2140,1105,1035,106.8,2096,1083,1013,106.9
경기도,수원시장안구,5~9세,2019,11791,6125,5666,108.1,11620,6039,5581,108.2
경기도,수원시장안구,5세,2019,2133,1112,1021,108.9,2089,1090,999,109.1
경기도,수원시장안구,6세,2019,2256,1184,1072,110.4,2208,1161,1047,110.9
경기도,수원시장안구,7세,2019,2418,1230,1188,103.5,2390,1219,1171,104.1
경기도,수원시장안구,8세,2019,2528,1338,1190,112.4,2503,1325,1178,112.5
경기도,수원시장안구,9세,2019,2456,1261,1195,105.5,2430,1244,1186,104.9
경기도,수원시장안구,10~14세,2019,13402,6870,6532,105.2,13329,6839,6490,105.4
경기도,수원시장안구,10세,2019,2517,1286,1231,104.5,2493,1273,1220,104.3
경기도,수원시장안구,11세,2019,2779,1432,1347,106.3,2763,1426,1337,106.7
경기도,수원시장안구,12세,2019,2838,1459,1379,105.8,2828,1455,1373,106
경기도,수원시장안구,13세,2019,2633,1353,1280,105.7,2620,1348,1272,106
경기도,수원시장안구,14세,2019,2635,1340,1295,103.5,2625,1337,1288,103.8
경기도,수원시장안구,15~19세,2019,17342,9440,7902,119.5,17007,9330,7677,121.5
경기도,수원시장안구,15세,2019,2912,1563,1349,115.9,2904,1561,1343,116.2
경기도,수원시장안구,16세,2019,3108,1662,1446,114.9,3098,1656,1442,114.8
경기도,수원시장안구,17세,2019,3133,1706,1427,119.6,3122,1701,1421,119.7
경기도,수원시장안구,18세,2019,3798,2118,1680,126.1,3727,2095,1632,128.4
경기도,수원시장안구,19세,2019,4391,2391,2000,119.6,4156,2317,1839,126
경기도,수원시장안구,20~24세,2019,23784,13341,10443,127.8,22491,12646,9845,128.5
경기도,수원시장안구,20세,2019,4310,2449,1861,131.6,4059,2337,1722,135.7
경기도,수원시장안구,21세,2019,4642,2512,2130,117.9,4400,2386,2014,118.5
경기도,수원시장안구,22세,2019,4894,2760,2134,129.3,4599,2605,1994,130.6
경기도,수원시장안구,23세,2019,4993,2782,2211,125.8,4738,2628,2110,124.5
경기도,수원시장안구,24세,2019,4945,2838,2107,134.7,4695,2690,2005,134.2
경기도,수원시장안구,25~29세,2019,22181,12303,9878,124.5,20833,11555,9278,124.5
경기도,수원시장안구,25세,2019,4891,2778,2113,131.5,4643,2635,2008,131.2
경기도,수원시장안구,26세,2019,4807,2678,2129,125.8,4533,2524,2009,125.6
경기도,수원시장안구,27세,2019,4508,2499,2009,124.4,4231,2336,1895,123.3
경기도,수원시장안구,28세,2019,4187,2283,1904,119.9,3929,2152,1777,121.1
경기도,수원시장안구,29세,2019,3788,2065,1723,119.8,3497,1908,1589,120.1
경기도,수원시장안구,30~34세,2019,16162,8661,7501,115.5,14943,8010,6933,115.5
경기도,수원시장안구,30세,2019,3532,1959,1573,124.5,3275,1825,1450,125.9
경기도,수원시장안구,31세,2019,3197,1712,1485,115.3,2956,1588,1368,116.1
경기도,수원시장안구,32세,2019,3102,1663,1439,115.6,2842,1516,1326,114.3
경기도,수원시장안구,33세,2019,3135,1649,1486,111,2894,1516,1378,110
경기도,수원시장안구,34세,2019,3196,1678,1518,110.5,2976,1565,1411,110.9
경기도,수원시장안구,35~39세,2019,19259,9738,9521,102.3,18357,9205,9152,100.6
경기도,수원시장안구,35세,2019,3235,1641,1594,102.9,3022,1516,1506,100.7
경기도,수원시장안구,36세,2019,3616,1884,1732,108.8,3426,1777,1649,107.8
경기도,수원시장안구,37세,2019,4037,2013,2024,99.5,3852,1901,1951,97.4
경기도,수원시장안구,38세,2019,4136,2053,2083,98.6,3973,1956,2017,97
경기도,수원시장안구,39세,2019,4235,2147,2088,102.8,4084,2055,2029,101.3
경기도,수원시장안구,40~44세,2019,21203,10527,10676,98.6,20487,10132,10355,97.8
경기도,수원시장안구,40세,2019,4325,2125,2200,96.6,4149,2021,2128,95
경기도,수원시장안구,41세,2019,3988,2040,1948,104.7,3829,1955,1874,104.3
경기도,수원시장안구,42세,2019,4213,2053,2160,95,4082,1986,2096,94.8
경기도,수원시장안구,43세,2019,4241,2127,2114,100.6,4102,2047,2055,99.6
경기도,수원시장안구,44세,2019,4436,2182,2254,96.8,4325,2123,2202,96.4
경기도,수원시장안구,45~49세,2019,26419,13153,13266,99.1,25532,12659,12873,98.3
경기도,수원시장안구,45세,2019,5058,2517,2541,99.1,4913,2437,2476,98.4
경기도,수원시장안구,46세,2019,5164,2496,2668,93.6,4982,2407,2575,93.5
경기도,수원시장안구,47세,2019,5158,2617,2541,103,4983,2503,2480,100.9
경기도,수원시장안구,48세,2019,5542,2727,2815,96.9,5362,2636,2726,96.7
경기도,수원시장안구,49세,2019,5497,2796,2701,103.5,5292,2676,2616,102.3
경기도,수원시장안구,50~54세,2019,26370,12979,13391,96.9,25417,12490,12927,96.6
경기도,수원시장안구,50세,2019,5690,2747,2943,93.3,5499,2655,2844,93.4
경기도,수원시장안구,51세,2019,5647,2703,2944,91.8,5437,2599,2838,91.6
경기도,수원시장안구,52세,2019,5114,2480,2634,94.2,4943,2381,2562,92.9
경기도,수원시장안구,53세,2019,4968,2519,2449,102.9,4788,2429,2359,103
경기도,수원시장안구,54세,2019,4951,2530,2421,104.5,4750,2426,2324,104.4
경기도,수원시장안구,55~59세,2019,23719,12025,11694,102.8,22793,11562,11231,102.9
경기도,수원시장안구,55세,2019,4516,2289,2227,102.8,4303,2180,2123,102.7
경기도,수원시장안구,56세,2019,4897,2531,2366,107,4658,2411,2247,107.3
경기도,수원시장안구,57세,2019,4633,2348,2285,102.8,4450,2259,2191,103.1
경기도,수원시장안구,58세,2019,4942,2465,2477,99.5,4838,2416,2422,99.8
경기도,수원시장안구,59세,2019,4731,2392,2339,102.3,4544,2296,2248,102.1
경기도,수원시장안구,60~64세,2019,17664,8835,8829,100.1,16982,8471,8511,99.5
경기도,수원시장안구,60세,2019,4137,2103,2034,103.4,3993,2027,1966,103.1
경기도,수원시장안구,61세,2019,3788,1924,1864,103.2,3636,1837,1799,102.1
경기도,수원시장안구,62세,2019,3417,1724,1693,101.8,3280,1653,1627,101.6
경기도,수원시장안구,63세,2019,3168,1589,1579,100.6,3045,1519,1526,99.5
경기도,수원시장안구,64세,2019,3154,1495,1659,90.1,3028,1435,1593,90.1
경기도,수원시장안구,65~69세,2019,10954,5244,5710,91.8,10604,5078,5526,91.9
경기도,수원시장안구,65세,2019,2621,1298,1323,98.1,2521,1257,1264,99.4
경기도,수원시장안구,66세,2019,2281,1084,1197,90.6,2197,1041,1156,90.1
경기도,수원시장안구,67세,2019,2467,1192,1275,93.5,2401,1158,1243,93.2
경기도,수원시장안구,68세,2019,1665,781,884,88.3,1608,756,852,88.7
경기도,수원시장안구,69세,2019,1920,889,1031,86.2,1877,866,1011,85.7
경기도,수원시장안구,70~74세,2019,8449,3877,4572,84.8,8326,3817,4509,84.7
경기도,수원시장안구,70세,2019,1877,901,976,92.3,1843,887,956,92.8
경기도,수원시장안구,71세,2019,1840,893,947,94.3,1819,878,941,93.3
경기도,수원시장안구,72세,2019,1879,847,1032,82.1,1854,832,1022,81.4
경기도,수원시장안구,73세,2019,1428,650,778,83.5,1408,642,766,83.8
경기도,수원시장안구,74세,2019,1425,586,839,69.8,1402,578,824,70.1
경기도,수원시장안구,75~79세,2019,6865,2911,3954,73.6,6803,2898,3905,74.2
경기도,수원시장안구,75세,2019,1394,596,798,74.7,1379,596,783,76.1
경기도,수원시장안구,76세,2019,1435,618,817,75.6,1422,614,808,76
경기도,수원시장안구,77세,2019,1586,667,919,72.6,1570,661,909,72.7
경기도,수원시장안구,78세,2019,1310,570,740,77,1301,569,732,77.7
경기도,수원시장안구,79세,2019,1140,460,680,67.6,1131,458,673,68.1
경기도,수원시장안구,80~84세,2019,4728,1775,2953,60.1,4685,1758,2927,60.1
경기도,수원시장안구,80세,2019,1117,452,665,68,1103,447,656,68.1
경기도,수원시장안구,81세,2019,1039,427,612,69.8,1034,424,610,69.5
경기도,수원시장안구,82세,2019,936,357,579,61.7,927,354,573,61.8
경기도,수원시장안구,83세,2019,865,287,578,49.7,857,283,574,49.3
경기도,수원시장안구,84세,2019,771,252,519,48.6,764,250,514,48.6
경기도,수원시장안구,85세이상,2019,3340,936,2404,38.9,3318,929,2389,38.9
경기도,수원시장안구,85~89세,2019,2266,680,1586,42.9,2250,675,1575,42.9
경기도,수원시장안구,85세,2019,601,208,393,52.9,596,206,390,52.8
경기도,수원시장안구,86세,2019,513,148,365,40.5,509,147,362,40.6
경기도,수원시장안구,87세,2019,473,142,331,42.9,468,140,328,42.7
경기도,수원시장안구,88세,2019,338,98,240,40.8,336,98,238,41.2
경기도,수원시장안구,89세,2019,341,84,257,32.7,341,84,257,32.7
경기도,수원시장안구,90~94세,2019,865,213,652,32.7,861,212,649,32.7
경기도,수원시장안구,90세,2019,277,73,204,35.8,277,73,204,35.8
경기도,수원시장안구,91세,2019,208,55,153,35.9,205,54,151,35.8
경기도,수원시장안구,92세,2019,176,37,139,26.6,175,37,138,26.8
경기도,수원시장안구,93세,2019,110,26,84,31,110,26,84,31
경기도,수원시장안구,94세,2019,94,22,72,30.6,94,22,72,30.6
경기도,수원시장안구,95~99세,2019,187,39,148,26.4,185,38,147,25.9
경기도,수원시장안구,95세,2019,59,14,45,31.1,59,14,45,31.1
경기도,수원시장안구,96세,2019,46,14,32,43.8,44,13,31,41.9
경기도,수원시장안구,97세,2019,48,X,44,9.1,48,X,44,9.1
경기도,수원시장안구,98세,2019,24,7,17,41.2,24,7,17,41.2
경기도,수원시장안구,99세,2019,10,X,10,0,10,X,10,0
경기도,수원시장안구,100세이상,2019,22,X,18,22.2,22,X,18,22.2
경기도,수원시장안구,15세미만,2019,33849,17429,16420,106.1,33297,17159,16138,106.3
경기도,수원시장안구,15~64세,2019,214103,111002,103101,107.7,204842,106060,98782,107.4
경기도,수원시장안구,65세이상,2019,34336,14743,19593,75.2,33736,14480,19256,75.2
경기도,수원시장안구,평균연령,2019,40.9,39.7,42.2,,41,39.7,42.3,
경기도,수원시장안구,중위연령,2019,42.1,40.3,43.7,,42.3,40.5,44,
경기도,수원시권선구,합계,2019,374770,189282,185488,102,359431,181368,178063,101.9
경기도,수원시권선구,0~4세,2019,16941,8776,8165,107.5,16401,8502,7899,107.6
경기도,수원시권선구,0세,2019,2802,1465,1337,109.6,2689,1401,1288,108.8
경기도,수원시권선구,1세,2019,3065,1563,1502,104.1,2945,1502,1443,104.1
경기도,수원시권선구,2세,2019,3395,1749,1646,106.3,3276,1693,1583,106.9
경기도,수원시권선구,3세,2019,3817,2005,1812,110.7,3707,1951,1756,111.1
경기도,수원시권선구,4세,2019,3862,1994,1868,106.7,3784,1955,1829,106.9
경기도,수원시권선구,5~9세,2019,18314,9308,9006,103.4,18044,9183,8861,103.6
경기도,수원시권선구,5세,2019,3790,1909,1881,101.5,3707,1874,1833,102.2
경기도,수원시권선구,6세,2019,3636,1839,1797,102.3,3576,1817,1759,103.3
경기도,수원시권선구,7세,2019,3893,2008,1885,106.5,3848,1986,1862,106.7
경기도,수원시권선구,8세,2019,3682,1891,1791,105.6,3636,1865,1771,105.3
경기도,수원시권선구,9세,2019,3313,1661,1652,100.5,3277,1641,1636,100.3
경기도,수원시권선구,10~14세,2019,15911,8207,7704,106.5,15779,8155,7624,107
경기도,수원시권선구,10세,2019,3231,1671,1560,107.1,3198,1657,1541,107.5
경기도,수원시권선구,11세,2019,3344,1746,1598,109.3,3317,1735,1582,109.7
경기도,수원시권선구,12세,2019,3395,1746,1649,105.9,3367,1735,1632,106.3
경기도,수원시권선구,13세,2019,3035,1570,1465,107.2,3016,1561,1455,107.3
경기도,수원시권선구,14세,2019,2906,1474,1432,102.9,2881,1467,1414,103.7
경기도,수원시권선구,15~19세,2019,17440,9115,8325,109.5,17303,9063,8240,110
경기도,수원시권선구,15세,2019,3283,1740,1543,112.8,3258,1729,1529,113.1
경기도,수원시권선구,16세,2019,3239,1701,1538,110.6,3218,1692,1526,110.9
경기도,수원시권선구,17세,2019,3274,1712,1562,109.6,3250,1706,1544,110.5
경기도,수원시권선구,18세,2019,3780,1984,1796,110.5,3754,1973,1781,110.8
경기도,수원시권선구,19세,2019,3864,1978,1886,104.9,3823,1963,1860,105.5
경기도,수원시권선구,20~24세,2019,23795,12275,11520,106.6,23292,12021,11271,106.7
경기도,수원시권선구,20세,2019,3947,2104,1843,114.2,3899,2083,1816,114.7
경기도,수원시권선구,21세,2019,4433,2415,2018,119.7,4363,2383,1980,120.4
경기도,수원시권선구,22세,2019,4772,2386,2386,100,4678,2340,2338,100.1
경기도,수원시권선구,23세,2019,5107,2579,2528,102,4976,2520,2456,102.6
경기도,수원시권선구,24세,2019,5536,2791,2745,101.7,5376,2695,2681,100.5
경기도,수원시권선구,25~29세,2019,29601,15528,14073,110.3,28340,14901,13439,110.9
경기도,수원시권선구,25세,2019,5731,2964,2767,107.1,5556,2868,2688,106.7
경기도,수원시권선구,26세,2019,6022,3178,2844,111.7,5791,3059,2732,112
경기도,수원시권선구,27세,2019,6221,3278,2943,111.4,5986,3164,2822,112.1
경기도,수원시권선구,28세,2019,6051,3185,2866,111.1,5769,3050,2719,112.2
경기도,수원시권선구,29세,2019,5576,2923,2653,110.2,5238,2760,2478,111.4
경기도,수원시권선구,30~34세,2019,28720,14953,13767,108.6,26611,13847,12764,108.5
경기도,수원시권선구,30세,2019,5677,2967,2710,109.5,5298,2779,2519,110.3
경기도,수원시권선구,31세,2019,5549,2914,2635,110.6,5133,2704,2429,111.3
경기도,수원시권선구,32세,2019,5744,3028,2716,111.5,5296,2773,2523,109.9
경기도,수원시권선구,33세,2019,5747,2959,2788,106.1,5298,2723,2575,105.7
경기도,수원시권선구,34세,2019,6003,3085,2918,105.7,5586,2868,2718,105.5
경기도,수원시권선구,35~39세,2019,34518,18103,16415,110.3,32882,17173,15709,109.3
경기도,수원시권선구,35세,2019,6214,3317,2897,114.5,5826,3094,2732,113.3
경기도,수원시권선구,36세,2019,6658,3471,3187,108.9,6330,3294,3036,108.5
경기도,수원시권선구,37세,2019,7234,3754,3480,107.9,6883,3549,3334,106.4
경기도,수원시권선구,38세,2019,7286,3760,3526,106.6,6993,3607,3386,106.5
경기도,수원시권선구,39세,2019,7126,3801,3325,114.3,6850,3629,3221,112.7
경기도,수원시권선구,40~44세,2019,30214,15874,14340,110.7,28881,15105,13776,109.6
경기도,수원시권선구,40세,2019,6688,3494,3194,109.4,6388,3326,3062,108.6
경기도,수원시권선구,41세,2019,5898,3119,2779,112.2,5645,2971,2674,111.1
경기도,수원시권선구,42세,2019,5945,3138,2807,111.8,5680,2989,2691,111.1
경기도,수원시권선구,43세,2019,5785,3074,2711,113.4,5524,2917,2607,111.9
경기도,수원시권선구,44세,2019,5898,3049,2849,107,5644,2902,2742,105.8
경기도,수원시권선구,45~49세,2019,32260,16407,15853,103.5,30766,15590,15176,102.7
경기도,수원시권선구,45세,2019,6278,3237,3041,106.4,6034,3087,2947,104.8
경기도,수원시권선구,46세,2019,6367,3250,3117,104.3,6120,3122,2998,104.1
경기도,수원시권선구,47세,2019,6321,3237,3084,105,5996,3059,2937,104.2
경기도,수원시권선구,48세,2019,6858,3503,3355,104.4,6518,3317,3201,103.6
경기도,수원시권선구,49세,2019,6436,3180,3256,97.7,6098,3005,3093,97.2
경기도,수원시권선구,50~54세,2019,33144,15999,17145,93.3,31449,15132,16317,92.7
경기도,수원시권선구,50세,2019,6905,3269,3636,89.9,6551,3089,3462,89.2
경기도,수원시권선구,51세,2019,6883,3225,3658,88.2,6535,3050,3485,87.5
경기도,수원시권선구,52세,2019,6458,3131,3327,94.1,6180,2977,3203,92.9
경기도,수원시권선구,53세,2019,6220,3107,3113,99.8,5909,2947,2962,99.5
경기도,수원시권선구,54세,2019,6678,3267,3411,95.8,6274,3069,3205,95.8
경기도,수원시권선구,55~59세,2019,31800,15957,15843,100.7,29969,15066,14903,101.1
경기도,수원시권선구,55세,2019,6071,3047,3024,100.8,5680,2853,2827,100.9
경기도,수원시권선구,56세,2019,6379,3242,3137,103.3,5872,3007,2865,105
경기도,수원시권선구,57세,2019,6171,3106,3065,101.3,5823,2947,2876,102.5
경기도,수원시권선구,58세,2019,6723,3316,3407,97.3,6488,3190,3298,96.7
경기도,수원시권선구,59세,2019,6456,3246,3210,101.1,6106,3069,3037,101.1
경기도,수원시권선구,60~64세,2019,23604,11767,11837,99.4,22253,11103,11150,99.6
경기도,수원시권선구,60세,2019,5622,2792,2830,98.7,5374,2668,2706,98.6
경기도,수원시권선구,61세,2019,4986,2498,2488,100.4,4681,2349,2332,100.7
경기도,수원시권선구,62세,2019,4621,2320,2301,100.8,4297,2160,2137,101.1
경기도,수원시권선구,63세,2019,4217,2101,2116,99.3,3965,1976,1989,99.3
경기도,수원시권선구,64세,2019,4158,2056,2102,97.8,3936,1950,1986,98.2
경기도,수원시권선구,65~69세,2019,13908,6812,7096,96,13241,6460,6781,95.3
경기도,수원시권선구,65세,2019,3352,1628,1724,94.4,3154,1520,1634,93
경기도,수원시권선구,66세,2019,3008,1461,1547,94.4,2850,1379,1471,93.7
경기도,수원시권선구,67세,2019,3205,1623,1582,102.6,3070,1555,1515,102.6
경기도,수원시권선구,68세,2019,2116,1010,1106,91.3,2022,957,1065,89.9
경기도,수원시권선구,69세,2019,2227,1090,1137,95.9,2145,1049,1096,95.7
경기도,수원시권선구,70~74세,2019,9779,4653,5126,90.8,9584,4574,5010,91.3
경기도,수원시권선구,70세,2019,2249,1108,1141,97.1,2193,1077,1116,96.5
경기도,수원시권선구,71세,2019,2157,1026,1131,90.7,2116,1013,1103,91.8
경기도,수원시권선구,72세,2019,2227,1055,1172,90,2182,1040,1142,91.1
경기도,수원시권선구,73세,2019,1611,737,874,84.3,1583,729,854,85.4
경기도,수원시권선구,74세,2019,1535,727,808,90,1510,715,795,89.9
경기도,수원시권선구,75~79세,2019,7063,3002,4061,73.9,6960,2970,3990,74.4
경기도,수원시권선구,75세,2019,1552,705,847,83.2,1531,696,835,83.4
경기도,수원시권선구,76세,2019,1417,602,815,73.9,1399,598,801,74.7
경기도,수원시권선구,77세,2019,1617,720,897,80.3,1596,711,885,80.3
경기도,수원시권선구,78세,2019,1342,538,804,66.9,1312,534,778,68.6
경기도,수원시권선구,79세,2019,1135,437,698,62.6,1122,431,691,62.4
경기도,수원시권선구,80~84세,2019,4642,1688,2954,57.1,4582,1671,2911,57.4
경기도,수원시권선구,80세,2019,1192,453,739,61.3,1177,451,726,62.1
경기도,수원시권선구,81세,2019,1021,397,624,63.6,1005,391,614,63.7
경기도,수원시권선구,82세,2019,927,330,597,55.3,910,325,585,55.6
경기도,수원시권선구,83세,2019,787,274,513,53.4,780,271,509,53.2
경기도,수원시권선구,84세,2019,715,234,481,48.6,710,233,477,48.8
경기도,수원시권선구,85세이상,2019,3116,858,2258,38,3094,852,2242,38
경기도,수원시권선구,85~89세,2019,2188,650,1538,42.3,2171,645,1526,42.3
경기도,수원시권선구,85세,2019,618,204,414,49.3,613,203,410,49.5
경기도,수원시권선구,86세,2019,522,156,366,42.6,517,154,363,42.4
경기도,수원시권선구,87세,2019,432,130,302,43,431,130,301,43.2
경기도,수원시권선구,88세,2019,304,87,217,40.1,300,86,214,40.2
경기도,수원시권선구,89세,2019,312,73,239,30.5,310,72,238,30.3
경기도,수원시권선구,90~94세,2019,756,172,584,29.5,752,171,581,29.4
경기도,수원시권선구,90세,2019,249,62,187,33.2,248,62,186,33.3
경기도,수원시권선구,91세,2019,187,44,143,30.8,186,44,142,31
경기도,수원시권선구,92세,2019,147,39,108,36.1,147,39,108,36.1
경기도,수원시권선구,93세,2019,92,18,74,24.3,90,17,73,23.3
경기도,수원시권선구,94세,2019,81,9,72,12.5,81,9,72,12.5
경기도,수원시권선구,95~99세,2019,149,31,118,26.3,148,31,117,26.5
경기도,수원시권선구,95세,2019,46,11,35,31.4,45,11,34,32.4
경기도,수원시권선구,96세,2019,40,9,31,29,40,9,31,29
경기도,수원시권선구,97세,2019,33,7,26,26.9,33,7,26,26.9
경기도,수원시권선구,98세,2019,23,X,20,15,23,X,20,15
경기도,수원시권선구,99세,2019,7,X,6,16.7,7,X,6,16.7
경기도,수원시권선구,100세이상,2019,23,5,18,27.8,23,5,18,27.8
경기도,수원시권선구,15세미만,2019,51166,26291,24875,105.7,50224,25840,24384,106
경기도,수원시권선구,15~64세,2019,285096,145978,139118,104.9,271746,139001,132745,104.7
경기도,수원시권선구,65세이상,2019,38508,17013,21495,79.1,37461,16527,20934,78.9
경기도,수원시권선구,평균연령,2019,40,39.2,40.8,,39.8,39,40.7,
경기도,수원시권선구,중위연령,2019,40.3,39.6,41.2,,40.2,39.4,41.1,
경기도,수원시팔달구,합계,2019,189052,95973,93079,103.1,168601,84799,83802,101.2
경기도,수원시팔달구,0~4세,2019,5262,2648,2614,101.3,4672,2338,2334,100.2
경기도,수원시팔달구,0세,2019,899,457,442,103.4,787,397,390,101.8
경기도,수원시팔달구,1세,2019,995,500,495,101,869,437,432,101.2
경기도,수원시팔달구,2세,2019,1032,514,518,99.2,926,460,466,98.7
경기도,수원시팔달구,3세,2019,1175,582,593,98.1,1040,509,531,95.9
경기도,수원시팔달구,4세,2019,1161,595,566,105.1,1050,535,515,103.9
경기도,수원시팔달구,5~9세,2019,5983,3060,2923,104.7,5633,2897,2736,105.9
경기도,수원시팔달구,5세,2019,1174,604,570,106,1080,565,515,109.7
경기도,수원시팔달구,6세,2019,1139,573,566,101.2,1069,544,525,103.6
경기도,수원시팔달구,7세,2019,1244,637,607,104.9,1164,591,573,103.1
경기도,수원시팔달구,8세,2019,1199,617,582,106,1138,589,549,107.3
경기도,수원시팔달구,9세,2019,1227,629,598,105.2,1182,608,574,105.9
경기도,수원시팔달구,10~14세,2019,6271,3211,3060,104.9,6080,3121,2959,105.5
경기도,수원시팔달구,10세,2019,1161,627,534,117.4,1111,601,510,117.8
경기도,수원시팔달구,11세,2019,1304,681,623,109.3,1264,659,605,108.9
경기도,수원시팔달구,12세,2019,1332,671,661,101.5,1297,654,643,101.7
경기도,수원시팔달구,13세,2019,1225,617,608,101.5,1187,602,585,102.9
경기도,수원시팔달구,14세,2019,1249,615,634,97,1221,605,616,98.2
경기도,수원시팔달구,15~19세,2019,8216,4258,3958,107.6,8001,4166,3835,108.6
경기도,수원시팔달구,15세,2019,1450,732,718,101.9,1427,719,708,101.6
경기도,수원시팔달구,16세,2019,1471,778,693,112.3,1444,763,681,112
경기도,수원시팔달구,17세,2019,1584,816,768,106.3,1553,804,749,107.3
경기도,수원시팔달구,18세,2019,1818,945,873,108.2,1757,926,831,111.4
경기도,수원시팔달구,19세,2019,1893,987,906,108.9,1820,954,866,110.2
경기도,수원시팔달구,20~24세,2019,12178,6191,5987,103.4,11596,5889,5707,103.2
경기도,수원시팔달구,20세,2019,1976,1049,927,113.2,1904,1007,897,112.3
경기도,수원시팔달구,21세,2019,2133,1101,1032,106.7,2046,1061,985,107.7
경기도,수원시팔달구,22세,2019,2350,1197,1153,103.8,2238,1129,1109,101.8
경기도,수원시팔달구,23세,2019,2743,1387,1356,102.3,2592,1312,1280,102.5
경기도,수원시팔달구,24세,2019,2976,1457,1519,95.9,2816,1380,1436,96.1
경기도,수원시팔달구,25~29세,2019,16187,8729,7458,117,14746,7933,6813,116.4
경기도,수원시팔달구,25세,2019,3133,1666,1467,113.6,2953,1553,1400,110.9
경기도,수원시팔달구,26세,2019,3242,1753,1489,117.7,3025,1634,1391,117.5
경기도,수원시팔달구,27세,2019,3447,1856,1591,116.7,3136,1694,1442,117.5
경기도,수원시팔달구,28세,2019,3252,1759,1493,117.8,2941,1585,1356,116.9
경기도,수원시팔달구,29세,2019,3113,1695,1418,119.5,2691,1467,1224,119.9
경기도,수원시팔달구,30~34세,2019,14226,7814,6412,121.9,11870,6443,5427,118.7
경기도,수원시팔달구,30세,2019,3101,1731,1370,126.4,2631,1464,1167,125.4
경기도,수원시팔달구,31세,2019,2894,1571,1323,118.7,2424,1303,1121,116.2
경기도,수원시팔달구,32세,2019,2842,1537,1305,117.8,2356,1239,1117,110.9
경기도,수원시팔달구,33세,2019,2795,1575,1220,129.1,2283,1273,1010,126
경기도,수원시팔달구,34세,2019,2594,1400,1194,117.3,2176,1164,1012,115
경기도,수원시팔달구,35~39세,2019,14441,7817,6624,118,12522,6635,5887,112.7
경기도,수원시팔달구,35세,2019,2671,1468,1203,122,2264,1220,1044,116.9
경기도,수원시팔달구,36세,2019,2842,1543,1299,118.8,2433,1303,1130,115.3
경기도,수원시팔달구,37세,2019,3003,1605,1398,114.8,2570,1337,1233,108.4
경기도,수원시팔달구,38세,2019,2952,1584,1368,115.8,2616,1365,1251,109.1
경기도,수원시팔달구,39세,2019,2973,1617,1356,119.2,2639,1410,1229,114.7
경기도,수원시팔달구,40~44세,2019,13922,7253,6669,108.8,12250,6270,5980,104.8
경기도,수원시팔달구,40세,2019,2865,1511,1354,111.6,2483,1277,1206,105.9
경기도,수원시팔달구,41세,2019,2639,1387,1252,110.8,2297,1196,1101,108.6
경기도,수원시팔달구,42세,2019,2780,1425,1355,105.2,2451,1237,1214,101.9
경기도,수원시팔달구,43세,2019,2709,1405,1304,107.7,2409,1226,1183,103.6
경기도,수원시팔달구,44세,2019,2929,1525,1404,108.6,2610,1334,1276,104.5
경기도,수원시팔달구,45~49세,2019,17009,8883,8126,109.3,14709,7561,7148,105.8
경기도,수원시팔달구,45세,2019,3179,1648,1531,107.6,2831,1447,1384,104.6
경기도,수원시팔달구,46세,2019,3287,1696,1591,106.6,2896,1469,1427,102.9
경기도,수원시팔달구,47세,2019,3307,1756,1551,113.2,2806,1464,1342,109.1
경기도,수원시팔달구,48세,2019,3651,1891,1760,107.4,3122,1589,1533,103.7
경기도,수원시팔달구,49세,2019,3585,1892,1693,111.8,3054,1592,1462,108.9
경기도,수원시팔달구,50~54세,2019,17316,8787,8529,103,14716,7395,7321,101
경기도,수원시팔달구,50세,2019,3608,1835,1773,103.5,3120,1560,1560,100
경기도,수원시팔달구,51세,2019,3673,1808,1865,96.9,3195,1544,1651,93.5
경기도,수원시팔달구,52세,2019,3254,1658,1596,103.9,2823,1435,1388,103.4
경기도,수원시팔달구,53세,2019,3339,1713,1626,105.4,2765,1415,1350,104.8
경기도,수원시팔달구,54세,2019,3442,1773,1669,106.2,2813,1441,1372,105
경기도,수원시팔달구,55~59세,2019,17764,9051,8713,103.9,15022,7569,7453,101.6
경기도,수원시팔달구,55세,2019,3409,1776,1633,108.8,2810,1442,1368,105.4
경기도,수원시팔달구,56세,2019,3767,1906,1861,102.4,2989,1474,1515,97.3
경기도,수원시팔달구,57세,2019,3445,1751,1694,103.4,2877,1457,1420,102.6
경기도,수원시팔달구,58세,2019,3616,1831,1785,102.6,3295,1670,1625,102.8
경기도,수원시팔달구,59세,2019,3527,1787,1740,102.7,3051,1526,1525,100.1
경기도,수원시팔달구,60~64세,2019,14208,7024,7184,97.8,12253,6003,6250,96
경기도,수원시팔달구,60세,2019,3154,1596,1558,102.4,2734,1361,1373,99.1
경기도,수원시팔달구,61세,2019,2987,1512,1475,102.5,2559,1286,1273,101
경기도,수원시팔달구,62세,2019,2875,1430,1445,99,2426,1210,1216,99.5
경기도,수원시팔달구,63세,2019,2541,1223,1318,92.8,2209,1061,1148,92.4
경기도,수원시팔달구,64세,2019,2651,1263,1388,91,2325,1085,1240,87.5
경기도,수원시팔달구,65~69세,2019,9095,4320,4775,90.5,8159,3875,4284,90.5
경기도,수원시팔달구,65세,2019,2225,1068,1157,92.3,1945,936,1009,92.8
경기도,수원시팔달구,66세,2019,1815,841,974,86.3,1623,752,871,86.3
경기도,수원시팔달구,67세,2019,2085,995,1090,91.3,1905,907,998,90.9
경기도,수원시팔달구,68세,2019,1410,672,738,91.1,1252,597,655,91.1
경기도,수원시팔달구,69세,2019,1560,744,816,91.2,1434,683,751,90.9
경기도,수원시팔달구,70~74세,2019,6638,3057,3581,85.4,6305,2898,3407,85.1
경기도,수원시팔달구,70세,2019,1484,708,776,91.2,1369,654,715,91.5
경기도,수원시팔달구,71세,2019,1506,697,809,86.2,1429,655,774,84.6
경기도,수원시팔달구,72세,2019,1468,633,835,75.8,1399,601,798,75.3
경기도,수원시팔달구,73세,2019,1110,517,593,87.2,1069,501,568,88.2
경기도,수원시팔달구,74세,2019,1070,502,568,88.4,1039,487,552,88.2
경기도,수원시팔달구,75~79세,2019,5155,2147,3008,71.4,5003,2111,2892,73
경기도,수원시팔달구,75세,2019,1100,463,637,72.7,1058,454,604,75.2
경기도,수원시팔달구,76세,2019,1063,455,608,74.8,1039,448,591,75.8
경기도,수원시팔달구,77세,2019,1208,524,684,76.6,1182,521,661,78.8
경기도,수원시팔달구,78세,2019,959,380,579,65.6,929,374,555,67.4
경기도,수원시팔달구,79세,2019,825,325,500,65,795,314,481,65.3
경기도,수원시팔달구,80~84세,2019,3191,1190,2001,59.5,3108,1168,1940,60.2
경기도,수원시팔달구,80세,2019,809,329,480,68.5,784,322,462,69.7
경기도,수원시팔달구,81세,2019,695,278,417,66.7,675,269,406,66.3
경기도,수원시팔달구,82세,2019,615,220,395,55.7,601,218,383,56.9
경기도,수원시팔달구,83세,2019,582,184,398,46.2,566,180,386,46.6
경기도,수원시팔달구,84세,2019,490,179,311,57.6,482,179,303,59.1
경기도,수원시팔달구,85세이상,2019,1990,533,1457,36.6,1956,527,1429,36.9
경기도,수원시팔달구,85~89세,2019,1361,398,963,41.3,1334,394,940,41.9
경기도,수원시팔달구,85세,2019,381,129,252,51.2,373,127,246,51.6
경기도,수원시팔달구,86세,2019,325,99,226,43.8,319,99,220,45
경기도,수원시팔달구,87세,2019,282,77,205,37.6,278,76,202,37.6
경기도,수원시팔달구,88세,2019,204,49,155,31.6,200,48,152,31.6
경기도,수원시팔달구,89세,2019,169,44,125,35.2,164,44,120,36.7
경기도,수원시팔달구,90~94세,2019,495,99,396,25,491,98,393,24.9
경기도,수원시팔달구,90세,2019,158,33,125,26.4,157,33,124,26.6
경기도,수원시팔달구,91세,2019,122,25,97,25.8,121,25,96,26
경기도,수원시팔달구,92세,2019,99,24,75,32,98,23,75,30.7
경기도,수원시팔달구,93세,2019,66,13,53,24.5,65,13,52,25
경기도,수원시팔달구,94세,2019,50,X,46,8.7,50,X,46,8.7
경기도,수원시팔달구,95~99세,2019,125,35,90,38.9,122,34,88,38.6
경기도,수원시팔달구,95세,2019,35,10,25,40,35,10,25,40
경기도,수원시팔달구,96세,2019,41,14,27,51.9,41,14,27,51.9
경기도,수원시팔달구,97세,2019,27,9,18,50,26,8,18,44.4
경기도,수원시팔달구,98세,2019,13,X,12,8.3,12,X,11,9.1
경기도,수원시팔달구,99세,2019,9,X,8,12.5,8,X,7,14.3
경기도,수원시팔달구,100세이상,2019,9,X,8,12.5,9,X,8,12.5
경기도,수원시팔달구,15세미만,2019,17516,8919,8597,103.7,16385,8356,8029,104.1
경기도,수원시팔달구,15~64세,2019,145467,75807,69660,108.8,127685,65864,61821,106.5
경기도,수원시팔달구,65세이상,2019,26069,11247,14822,75.9,24531,10579,13952,75.8
경기도,수원시팔달구,평균연령,2019,43.1,42.2,44.2,,42.9,41.9,44,
경기도,수원시팔달구,중위연령,2019,44.3,43,45.5,,43.8,42.4,45.2,
경기도,수원시영통구,합계,2019,368876,186064,182812,101.8,358893,180796,178097,101.5
경기도,수원시영통구,0~4세,2019,18073,9371,8702,107.7,17619,9131,8488,107.6
경기도,수원시영통구,0세,2019,3073,1600,1473,108.6,3012,1567,1445,108.4
경기도,수원시영통구,1세,2019,3348,1737,1611,107.8,3250,1680,1570,107
경기도,수원시영통구,2세,2019,3412,1805,1607,112.3,3325,1759,1566,112.3
경기도,수원시영통구,3세,2019,3880,2008,1872,107.3,3772,1954,1818,107.5
경기도,수원시영통구,4세,2019,4360,2221,2139,103.8,4260,2171,2089,103.9
경기도,수원시영통구,5~9세,2019,21040,10909,10131,107.7,20717,10732,9985,107.5
경기도,수원시영통구,5세,2019,4020,2043,1977,103.3,3945,1997,1948,102.5
경기도,수원시영통구,6세,2019,4095,2126,1969,108,4010,2080,1930,107.8
경기도,수원시영통구,7세,2019,4512,2336,2176,107.4,4446,2307,2139,107.9
경기도,수원시영통구,8세,2019,4269,2212,2057,107.5,4209,2176,2033,107
경기도,수원시영통구,9세,2019,4144,2192,1952,112.3,4107,2172,1935,112.2
경기도,수원시영통구,10~14세,2019,20266,10397,9869,105.4,20120,10319,9801,105.3
경기도,수원시영통구,10세,2019,3954,2033,1921,105.8,3912,2008,1904,105.5
경기도,수원시영통구,11세,2019,4290,2172,2118,102.5,4258,2150,2108,102
경기도,수원시영통구,12세,2019,4380,2294,2086,110,4352,2278,2074,109.8
경기도,수원시영통구,13세,2019,3875,2003,1872,107,3852,1998,1854,107.8
경기도,수원시영통구,14세,2019,3767,1895,1872,101.2,3746,1885,1861,101.3
경기도,수원시영통구,15~19세,2019,23047,11774,11273,104.4,22647,11624,11023,105.5
경기도,수원시영통구,15세,2019,4144,2109,2035,103.6,4129,2101,2028,103.6
경기도,수원시영통구,16세,2019,4219,2129,2090,101.9,4204,2122,2082,101.9
경기도,수원시영통구,17세,2019,4217,2122,2095,101.3,4187,2113,2074,101.9
경기도,수원시영통구,18세,2019,4975,2574,2401,107.2,4838,2534,2304,110
경기도,수원시영통구,19세,2019,5492,2840,2652,107.1,5289,2754,2535,108.6
경기도,수원시영통구,20~24세,2019,27795,14268,13527,105.5,26387,13607,12780,106.5
경기도,수원시영통구,20세,2019,5133,2532,2601,97.3,4863,2413,2450,98.5
경기도,수원시영통구,21세,2019,5329,2714,2615,103.8,5002,2561,2441,104.9
경기도,수원시영통구,22세,2019,5383,2843,2540,111.9,5110,2704,2406,112.4
경기도,수원시영통구,23세,2019,5795,3025,2770,109.2,5535,2893,2642,109.5
경기도,수원시영통구,24세,2019,6155,3154,3001,105.1,5877,3036,2841,106.9
경기도,수원시영통구,25~29세,2019,32650,17427,15223,114.5,31206,16603,14603,113.7
경기도,수원시영통구,25세,2019,6412,3317,3095,107.2,6140,3162,2978,106.2
경기도,수원시영통구,26세,2019,6756,3588,3168,113.3,6438,3410,3028,112.6
경기도,수원시영통구,27세,2019,6831,3724,3107,119.9,6545,3564,2981,119.6
경기도,수원시영통구,28세,2019,6414,3502,2912,120.3,6130,3335,2795,119.3
경기도,수원시영통구,29세,2019,6237,3296,2941,112.1,5953,3132,2821,111
경기도,수원시영통구,30~34세,2019,30449,15808,14641,108,29001,15017,13984,107.4
경기도,수원시영통구,30세,2019,6237,3279,2958,110.9,5948,3136,2812,111.5
경기도,수원시영통구,31세,2019,6197,3260,2937,111,5896,3097,2799,110.6
경기도,수원시영통구,32세,2019,5972,3128,2844,110,5691,2969,2722,109.1
경기도,수원시영통구,33세,2019,5920,3068,2852,107.6,5636,2895,2741,105.6
경기도,수원시영통구,34세,2019,6123,3073,3050,100.8,5830,2920,2910,100.3
경기도,수원시영통구,35~39세,2019,34606,17288,17318,99.8,33517,16663,16854,98.9
경기도,수원시영통구,35세,2019,6048,3065,2983,102.7,5786,2919,2867,101.8
경기도,수원시영통구,36세,2019,6660,3398,3262,104.2,6430,3276,3154,103.9
경기도,수원시영통구,37세,2019,7336,3671,3665,100.2,7103,3529,3574,98.7
경기도,수원시영통구,38세,2019,7345,3626,3719,97.5,7162,3518,3644,96.5
경기도,수원시영통구,39세,2019,7217,3528,3689,95.6,7036,3421,3615,94.6
경기도,수원시영통구,40~44세,2019,33162,16529,16633,99.4,32417,16072,16345,98.3
경기도,수원시영통구,40세,2019,6975,3459,3516,98.4,6803,3350,3453,97
경기도,수원시영통구,41세,2019,6426,3267,3159,103.4,6280,3179,3101,102.5
경기도,수원시영통구,42세,2019,6736,3300,3436,96,6585,3202,3383,94.6
경기도,수원시영통구,43세,2019,6536,3268,3268,100,6385,3176,3209,99
경기도,수원시영통구,44세,2019,6489,3235,3254,99.4,6364,3165,3199,98.9
경기도,수원시영통구,45~49세,2019,34386,17028,17358,98.1,33697,16631,17066,97.5
경기도,수원시영통구,45세,2019,6820,3278,3542,92.5,6678,3190,3488,91.5
경기도,수원시영통구,46세,2019,6943,3367,3576,94.2,6809,3293,3516,93.7
경기도,수원시영통구,47세,2019,6816,3413,3403,100.3,6656,3323,3333,99.7
경기도,수원시영통구,48세,2019,7128,3579,3549,100.8,6996,3505,3491,100.4
경기도,수원시영통구,49세,2019,6679,3391,3288,103.1,6558,3320,3238,102.5
경기도,수원시영통구,50~54세,2019,29068,14368,14700,97.7,28487,14073,14414,97.6
경기도,수원시영통구,50세,2019,6689,3307,3382,97.8,6560,3240,3320,97.6
경기도,수원시영통구,51세,2019,6287,3069,3218,95.4,6172,3010,3162,95.2
경기도,수원시영통구,52세,2019,5551,2728,2823,96.6,5446,2672,2774,96.3
경기도,수원시영통구,53세,2019,5208,2588,2620,98.8,5101,2534,2567,98.7
경기도,수원시영통구,54세,2019,5333,2676,2657,100.7,5208,2617,2591,101
경기도,수원시영통구,55~59세,2019,23952,12341,11611,106.3,23386,12072,11314,106.7
경기도,수원시영통구,55세,2019,4851,2429,2422,100.3,4738,2374,2364,100.4
경기도,수원시영통구,56세,2019,5014,2597,2417,107.4,4860,2521,2339,107.8
경기도,수원시영통구,57세,2019,4758,2480,2278,108.9,4629,2423,2206,109.8
경기도,수원시영통구,58세,2019,4821,2466,2355,104.7,4743,2430,2313,105.1
경기도,수원시영통구,59세,2019,4508,2369,2139,110.8,4416,2324,2092,111.1
경기도,수원시영통구,60~64세,2019,15638,8015,7623,105.1,15243,7826,7417,105.5
경기도,수원시영통구,60세,2019,3785,2018,1767,114.2,3712,1980,1732,114.3
경기도,수원시영통구,61세,2019,3473,1781,1692,105.3,3376,1731,1645,105.2
경기도,수원시영통구,62세,2019,3020,1551,1469,105.6,2937,1512,1425,106.1
경기도,수원시영통구,63세,2019,2701,1385,1316,105.2,2629,1347,1282,105.1
경기도,수원시영통구,64세,2019,2659,1280,1379,92.8,2589,1256,1333,94.2
경기도,수원시영통구,65~69세,2019,8621,4147,4474,92.7,8455,4077,4378,93.1
경기도,수원시영통구,65세,2019,2055,987,1068,92.4,2016,969,1047,92.6
경기도,수원시영통구,66세,2019,1820,860,960,89.6,1784,847,937,90.4
경기도,수원시영통구,67세,2019,1969,957,1012,94.6,1939,941,998,94.3
경기도,수원시영통구,68세,2019,1296,637,659,96.7,1259,626,633,98.9
경기도,수원시영통구,69세,2019,1481,706,775,91.1,1457,694,763,91
경기도,수원시영통구,70~74세,2019,6167,2844,3323,85.6,6097,2818,3279,85.9
경기도,수원시영통구,70세,2019,1431,669,762,87.8,1412,662,750,88.3
경기도,수원시영통구,71세,2019,1373,629,744,84.5,1356,623,733,85
경기도,수원시영통구,72세,2019,1312,612,700,87.4,1298,605,693,87.3
경기도,수원시영통구,73세,2019,1040,496,544,91.2,1027,492,535,92
경기도,수원시영통구,74세,2019,1011,438,573,76.4,1004,436,568,76.8
경기도,수원시영통구,75~79세,2019,4696,1895,2801,67.7,4666,1887,2779,67.9
경기도,수원시영통구,75세,2019,955,384,571,67.3,947,380,567,67
경기도,수원시영통구,76세,2019,981,397,584,68,974,396,578,68.5
경기도,수원시영통구,77세,2019,1071,443,628,70.5,1067,442,625,70.7
경기도,수원시영통구,78세,2019,905,348,557,62.5,899,348,551,63.2
경기도,수원시영통구,79세,2019,784,323,461,70.1,779,321,458,70.1
경기도,수원시영통구,80~84세,2019,3064,1055,2009,52.5,3050,1049,2001,52.4
경기도,수원시영통구,80세,2019,733,271,462,58.7,731,270,461,58.6
경기도,수원시영통구,81세,2019,683,254,429,59.2,680,252,428,58.9
경기도,수원시영통구,82세,2019,609,214,395,54.2,604,212,392,54.1
경기도,수원시영통구,83세,2019,532,162,370,43.8,530,161,369,43.6
경기도,수원시영통구,84세,2019,507,154,353,43.6,505,154,351,43.9
경기도,수원시영통구,85세이상,2019,2196,600,1596,37.6,2181,595,1586,37.5
경기도,수원시영통구,85~89세,2019,1522,440,1082,40.7,1508,436,1072,40.7
경기도,수원시영통구,85세,2019,436,140,296,47.3,430,139,291,47.8
경기도,수원시영통구,86세,2019,345,110,235,46.8,343,110,233,47.2
경기도,수원시영통구,87세,2019,298,82,216,38,295,81,214,37.9
경기도,수원시영통구,88세,2019,216,53,163,32.5,215,52,163,31.9
경기도,수원시영통구,89세,2019,227,55,172,32,225,54,171,31.6
경기도,수원시영통구,90~94세,2019,533,127,406,31.3,533,127,406,31.3
경기도,수원시영통구,90세,2019,173,48,125,38.4,173,48,125,38.4
경기도,수원시영통구,91세,2019,141,28,113,24.8,141,28,113,24.8
경기도,수원시영통구,92세,2019,97,28,69,40.6,97,28,69,40.6
경기도,수원시영통구,93세,2019,72,11,61,18,72,11,61,18
경기도,수원시영통구,94세,2019,50,12,38,31.6,50,12,38,31.6
경기도,수원시영통구,95~99세,2019,125,29,96,30.2,124,28,96,29.2
경기도,수원시영통구,95세,2019,37,5,32,15.6,37,5,32,15.6
경기도,수원시영통구,96세,2019,35,13,22,59.1,34,12,22,54.5
경기도,수원시영통구,97세,2019,29,6,23,26.1,29,6,23,26.1
경기도,수원시영통구,98세,2019,13,X,10,30,13,X,10,30
경기도,수원시영통구,99세,2019,11,X,9,22.2,11,X,9,22.2
경기도,수원시영통구,100세이상,2019,16,X,12,33.3,16,X,12,33.3
경기도,수원시영통구,15세미만,2019,59379,30677,28702,106.9,58456,30182,28274,106.7
경기도,수원시영통구,15~64세,2019,284753,144846,139907,103.5,275988,140188,135800,103.2
경기도,수원시영통구,65세이상,2019,24744,10541,14203,74.2,24449,10426,14023,74.3
경기도,수원시영통구,평균연령,2019,36.4,35.8,37.1,,36.5,35.8,37.2,
경기도,수원시영통구,중위연령,2019,36.8,36,37.5,,36.9,36.1,37.7,
경상남도,진주시,합계,2019,354166,176860,177306,99.7,347014,172576,174438,98.9
경상남도,진주시,0~4세,2019,12820,6566,6254,105,12748,6528,6220,105
경상남도,진주시,0세,2019,2048,1008,1040,96.9,2037,1003,1034,97
경상남도,진주시,1세,2019,2277,1197,1080,110.8,2257,1188,1069,111.1
경상남도,진주시,2세,2019,2532,1296,1236,104.9,2515,1284,1231,104.3
경상남도,진주시,3세,2019,2862,1492,1370,108.9,2847,1484,1363,108.9
경상남도,진주시,4세,2019,3101,1573,1528,102.9,3092,1569,1523,103
경상남도,진주시,5~9세,2019,16702,8800,7902,111.4,16658,8773,7885,111.3
경상남도,진주시,5세,2019,3250,1688,1562,108.1,3232,1674,1558,107.4
경상남도,진주시,6세,2019,3122,1686,1436,117.4,3118,1685,1433,117.6
경상남도,진주시,7세,2019,3491,1790,1701,105.2,3479,1785,1694,105.4
경상남도,진주시,8세,2019,3495,1862,1633,114,3488,1857,1631,113.9
경상남도,진주시,9세,2019,3344,1774,1570,113,3341,1772,1569,112.9
경상남도,진주시,10~14세,2019,16592,8638,7954,108.6,16573,8626,7947,108.5
경상남도,진주시,10세,2019,3215,1687,1528,110.4,3210,1685,1525,110.5
경상남도,진주시,11세,2019,3493,1821,1672,108.9,3487,1817,1670,108.8
경상남도,진주시,12세,2019,3525,1780,1745,102,3522,1778,1744,101.9
경상남도,진주시,13세,2019,3230,1705,1525,111.8,3228,1703,1525,111.7
경상남도,진주시,14세,2019,3129,1645,1484,110.8,3126,1643,1483,110.8
경상남도,진주시,15~19세,2019,20596,11054,9542,115.8,20307,10905,9402,116
경상남도,진주시,15세,2019,3548,1912,1636,116.9,3543,1909,1634,116.8
경상남도,진주시,16세,2019,3573,1910,1663,114.9,3566,1907,1659,114.9
경상남도,진주시,17세,2019,3812,2118,1694,125,3796,2112,1684,125.4
경상남도,진주시,18세,2019,4347,2330,2017,115.5,4281,2302,1979,116.3
경상남도,진주시,19세,2019,5316,2784,2532,110,5121,2675,2446,109.4
경상남도,진주시,20~24세,2019,28020,15421,12599,122.4,26847,14777,12070,122.4
경상남도,진주시,20세,2019,5219,2569,2650,96.9,5048,2481,2567,96.6
경상남도,진주시,21세,2019,5782,2944,2838,103.7,5539,2817,2722,103.5
경상남도,진주시,22세,2019,5920,3258,2662,122.4,5663,3123,2540,123
경상남도,진주시,23세,2019,5780,3491,2289,152.5,5535,3344,2191,152.6
경상남도,진주시,24세,2019,5319,3159,2160,146.3,5062,3012,2050,146.9
경상남도,진주시,25~29세,2019,22302,12517,9785,127.9,20809,11596,9213,125.9
경상남도,진주시,25세,2019,5068,2947,2121,138.9,4747,2762,1985,139.1
경상남도,진주시,26세,2019,4684,2664,2020,131.9,4393,2490,1903,130.8
경상남도,진주시,27세,2019,4442,2463,1979,124.5,4181,2298,1883,122
경상남도,진주시,28세,2019,4063,2222,1841,120.7,3762,2029,1733,117.1
경상남도,진주시,29세,2019,4045,2221,1824,121.8,3726,2017,1709,118
경상남도,진주시,30~34세,2019,19777,10538,9239,114.1,18463,9670,8793,110
경상남도,진주시,30세,2019,4036,2231,1805,123.6,3759,2056,1703,120.7
경상남도,진주시,31세,2019,3789,2058,1731,118.9,3533,1895,1638,115.7
경상남도,진주시,32세,2019,3998,2041,1957,104.3,3725,1862,1863,99.9
경상남도,진주시,33세,2019,4029,2133,1896,112.5,3768,1946,1822,106.8
경상남도,진주시,34세,2019,3925,2075,1850,112.2,3678,1911,1767,108.1
경상남도,진주시,35~39세,2019,24681,12354,12327,100.2,23753,11754,11999,98
경상남도,진주시,35세,2019,4262,2141,2121,100.9,4034,1988,2046,97.2
경상남도,진주시,36세,2019,4717,2337,2380,98.2,4515,2197,2318,94.8
경상남도,진주시,37세,2019,5130,2573,2557,100.6,4953,2454,2499,98.2
경상남도,진주시,38세,2019,5186,2586,2600,99.5,5009,2482,2527,98.2
경상남도,진주시,39세,2019,5386,2717,2669,101.8,5242,2633,2609,100.9
경상남도,진주시,40~44세,2019,25193,12613,12580,100.3,24664,12279,12385,99.1
경상남도,진주시,40세,2019,5238,2662,2576,103.3,5103,2584,2519,102.6
경상남도,진주시,41세,2019,4883,2458,2425,101.4,4770,2382,2388,99.7
경상남도,진주시,42세,2019,4878,2402,2476,97,4777,2334,2443,95.5
경상남도,진주시,43세,2019,5003,2489,2514,99,4903,2424,2479,97.8
경상남도,진주시,44세,2019,5191,2602,2589,100.5,5111,2555,2556,100
경상남도,진주시,45~49세,2019,29923,14974,14949,100.2,29511,14744,14767,99.8
경상남도,진주시,45세,2019,5773,2855,2918,97.8,5687,2808,2879,97.5
경상남도,진주시,46세,2019,6018,3030,2988,101.4,5946,2993,2953,101.4
경상남도,진주시,47세,2019,5691,2899,2792,103.8,5594,2844,2750,103.4
경상남도,진주시,48세,2019,6132,3082,3050,101,6043,3030,3013,100.6
경상남도,진주시,49세,2019,6309,3108,3201,97.1,6241,3069,3172,96.8
경상남도,진주시,50~54세,2019,29130,14570,14560,100.1,28768,14371,14397,99.8
경상남도,진주시,50세,2019,6321,3161,3160,100,6228,3109,3119,99.7
경상남도,진주시,51세,2019,6188,3113,3075,101.2,6116,3071,3045,100.9
경상남도,진주시,52세,2019,5687,2774,2913,95.2,5613,2741,2872,95.4
경상남도,진주시,53세,2019,5488,2844,2644,107.6,5420,2804,2616,107.2
경상남도,진주시,54세,2019,5446,2678,2768,96.7,5391,2646,2745,96.4
경상남도,진주시,55~59세,2019,28701,14117,14584,96.8,28441,13983,14458,96.7
경상남도,진주시,55세,2019,4695,2298,2397,95.9,4618,2263,2355,96.1
경상남도,진주시,56세,2019,5396,2725,2671,102,5337,2696,2641,102.1
경상남도,진주시,57세,2019,5758,2891,2867,100.8,5713,2868,2845,100.8
경상남도,진주시,58세,2019,6684,3268,3416,95.7,6644,3246,3398,95.5
경상남도,진주시,59세,2019,6168,2935,3233,90.8,6129,2910,3219,90.4
경상남도,진주시,60~64세,2019,24817,12099,12718,95.1,24677,12029,12648,95.1
경상남도,진주시,60세,2019,5229,2578,2651,97.2,5194,2560,2634,97.2
경상남도,진주시,61세,2019,5172,2507,2665,94.1,5134,2490,2644,94.2
경상남도,진주시,62세,2019,5017,2502,2515,99.5,4990,2487,2503,99.4
경상남도,진주시,63세,2019,4609,2297,2312,99.4,4582,2285,2297,99.5
경상남도,진주시,64세,2019,4790,2215,2575,86,4777,2207,2570,85.9
경상남도,진주시,65~69세,2019,17331,8239,9092,90.6,17260,8208,9052,90.7
경상남도,진주시,65세,2019,4090,2034,2056,98.9,4074,2030,2044,99.3
경상남도,진주시,66세,2019,3419,1609,1810,88.9,3404,1603,1801,89
경상남도,진주시,67세,2019,3705,1730,1975,87.6,3691,1723,1968,87.6
경상남도,진주시,68세,2019,2925,1373,1552,88.5,2912,1363,1549,88
경상남도,진주시,69세,2019,3192,1493,1699,87.9,3179,1489,1690,88.1
경상남도,진주시,70~74세,2019,13454,6145,7309,84.1,13432,6130,7302,83.9
경상남도,진주시,70세,2019,3100,1394,1706,81.7,3092,1387,1705,81.3
경상남도,진주시,71세,2019,3057,1416,1641,86.3,3053,1415,1638,86.4
경상남도,진주시,72세,2019,2882,1336,1546,86.4,2879,1333,1546,86.2
경상남도,진주시,73세,2019,2187,997,1190,83.8,2185,995,1190,83.6
경상남도,진주시,74세,2019,2228,1002,1226,81.7,2223,1000,1223,81.8
경상남도,진주시,75~79세,2019,11293,4571,6722,68,11280,4563,6717,67.9
경상남도,진주시,75세,2019,2287,976,1311,74.4,2283,973,1310,74.3
경상남도,진주시,76세,2019,2284,955,1329,71.9,2284,955,1329,71.9
경상남도,진주시,77세,2019,2497,1001,1496,66.9,2493,999,1494,66.9
경상남도,진주시,78세,2019,2184,880,1304,67.5,2180,878,1302,67.4
경상남도,진주시,79세,2019,2041,759,1282,59.2,2040,758,1282,59.1
경상남도,진주시,80~84세,2019,7589,2471,5118,48.3,7582,2468,5114,48.3
경상남도,진주시,80세,2019,1871,655,1216,53.9,1869,655,1214,54
경상남도,진주시,81세,2019,1604,529,1075,49.2,1603,529,1074,49.3
경상남도,진주시,82세,2019,1486,516,970,53.2,1486,516,970,53.2
경상남도,진주시,83세,2019,1400,426,974,43.7,1397,424,973,43.6
경상남도,진주시,84세,2019,1228,345,883,39.1,1227,344,883,39
경상남도,진주시,85세이상,2019,5245,1173,4072,28.8,5241,1172,4069,28.8
경상남도,진주시,85~89세,2019,3719,885,2834,31.2,3716,884,2832,31.2
경상남도,진주시,85세,2019,1066,297,769,38.6,1065,296,769,38.5
경상남도,진주시,86세,2019,823,190,633,30,822,190,632,30.1
경상남도,진주시,87세,2019,762,187,575,32.5,761,187,574,32.6
경상남도,진주시,88세,2019,578,129,449,28.7,578,129,449,28.7
경상남도,진주시,89세,2019,490,82,408,20.1,490,82,408,20.1
경상남도,진주시,90~94세,2019,1248,243,1005,24.2,1247,243,1004,24.2
경상남도,진주시,90세,2019,391,86,305,28.2,391,86,305,28.2
경상남도,진주시,91세,2019,305,62,243,25.5,305,62,243,25.5
경상남도,진주시,92세,2019,235,39,196,19.9,235,39,196,19.9
경상남도,진주시,93세,2019,157,29,128,22.7,156,29,127,22.8
경상남도,진주시,94세,2019,160,27,133,20.3,160,27,133,20.3
경상남도,진주시,95~99세,2019,252,40,212,18.9,252,40,212,18.9
경상남도,진주시,95세,2019,85,18,67,26.9,85,18,67,26.9
경상남도,진주시,96세,2019,65,11,54,20.4,65,11,54,20.4
경상남도,진주시,97세,2019,47,6,41,14.6,47,6,41,14.6
경상남도,진주시,98세,2019,33,X,29,13.8,33,X,29,13.8
경상남도,진주시,99세,2019,22,X,21,4.8,22,X,21,4.8
경상남도,진주시,100세이상,2019,26,5,21,23.8,26,5,21,23.8
경상남도,진주시,15세미만,2019,46114,24004,22110,108.6,45979,23927,22052,108.5
경상남도,진주시,15~64세,2019,253140,130257,122883,106,246240,126108,120132,105
경상남도,진주시,65세이상,2019,54912,22599,32313,69.9,54795,22541,32254,69.9
경상남도,진주시,평균연령,2019,42,40.3,43.7,,42.2,40.4,43.9,
경상남도,진주시,중위연령,2019,43.1,41,45.2,,43.6,41.5,45.5,
경상남도,창원시의창구,합계,2019,256001,130662,125339,104.2,250901,127671,123230,103.6
경상남도,창원시의창구,0~4세,2019,9828,5071,4757,106.6,9762,5037,4725,106.6
경상남도,창원시의창구,0세,2019,1649,859,790,108.7,1630,849,781,108.7
경상남도,창원시의창구,1세,2019,1739,880,859,102.4,1722,871,851,102.4
경상남도,창원시의창구,2세,2019,1985,1040,945,110.1,1971,1035,936,110.6
경상남도,창원시의창구,3세,2019,2146,1088,1058,102.8,2137,1082,1055,102.6
경상남도,창원시의창구,4세,2019,2309,1204,1105,109,2302,1200,1102,108.9
경상남도,창원시의창구,5~9세,2019,11519,5952,5567,106.9,11468,5922,5546,106.8
경상남도,창원시의창구,5세,2019,2274,1204,1070,112.5,2262,1196,1066,112.2
경상남도,창원시의창구,6세,2019,2222,1118,1104,101.3,2209,1111,1098,101.2
경상남도,창원시의창구,7세,2019,2429,1255,1174,106.9,2420,1251,1169,107
경상남도,창원시의창구,8세,2019,2345,1231,1114,110.5,2337,1226,1111,110.4
경상남도,창원시의창구,9세,2019,2249,1144,1105,103.5,2240,1138,1102,103.3
경상남도,창원시의창구,10~14세,2019,10554,5502,5052,108.9,10535,5492,5043,108.9
경상남도,창원시의창구,10세,2019,2164,1101,1063,103.6,2161,1099,1062,103.5
경상남도,창원시의창구,11세,2019,2187,1143,1044,109.5,2183,1139,1044,109.1
경상남도,창원시의창구,12세,2019,2206,1155,1051,109.9,2202,1152,1050,109.7
경상남도,창원시의창구,13세,2019,2008,1033,975,105.9,2004,1033,971,106.4
경상남도,창원시의창구,14세,2019,1989,1070,919,116.4,1985,1069,916,116.7
경상남도,창원시의창구,15~19세,2019,12888,6961,5927,117.4,12823,6935,5888,117.8
경상남도,창원시의창구,15세,2019,2238,1173,1065,110.1,2228,1169,1059,110.4
경상남도,창원시의창구,16세,2019,2220,1172,1048,111.8,2214,1170,1044,112.1
경상남도,창원시의창구,17세,2019,2378,1316,1062,123.9,2367,1312,1055,124.4
경상남도,창원시의창구,18세,2019,2788,1469,1319,111.4,2773,1462,1311,111.5
경상남도,창원시의창구,19세,2019,3264,1831,1433,127.8,3241,1822,1419,128.4
경상남도,창원시의창구,20~24세,2019,17713,10020,7693,130.2,17241,9763,7478,130.6
경상남도,창원시의창구,20세,2019,3201,1778,1423,124.9,3140,1754,1386,126.6
경상남도,창원시의창구,21세,2019,3406,1924,1482,129.8,3334,1885,1449,130.1
경상남도,창원시의창구,22세,2019,3638,2039,1599,127.5,3540,1989,1551,128.2
경상남도,창원시의창구,23세,2019,3721,2121,1600,132.6,3603,2053,1550,132.5
경상남도,창원시의창구,24세,2019,3747,2158,1589,135.8,3624,2082,1542,135
경상남도,창원시의창구,25~29세,2019,18155,10094,8061,125.2,17324,9573,7751,123.5
경상남도,창원시의창구,25세,2019,3804,2136,1668,128.1,3659,2054,1605,128
경상남도,창원시의창구,26세,2019,3665,2015,1650,122.1,3496,1918,1578,121.5
경상남도,창원시의창구,27세,2019,3709,2077,1632,127.3,3551,1973,1578,125
경상남도,창원시의창구,28세,2019,3604,1985,1619,122.6,3456,1885,1571,120
경상남도,창원시의창구,29세,2019,3373,1881,1492,126.1,3162,1743,1419,122.8
경상남도,창원시의창구,30~34세,2019,16146,8856,7290,121.5,15153,8234,6919,119
경상남도,창원시의창구,30세,2019,3217,1762,1455,121.1,3009,1635,1374,119
경상남도,창원시의창구,31세,2019,3159,1709,1450,117.9,2961,1586,1375,115.3
경상남도,창원시의창구,32세,2019,3156,1751,1405,124.6,2933,1608,1325,121.4
경상남도,창원시의창구,33세,2019,3140,1776,1364,130.2,2952,1653,1299,127.3
경상남도,창원시의창구,34세,2019,3474,1858,1616,115,3298,1752,1546,113.3
경상남도,창원시의창구,35~39세,2019,20047,10470,9577,109.3,19354,10019,9335,107.3
경상남도,창원시의창구,35세,2019,3476,1856,1620,114.6,3326,1742,1584,110
경상남도,창원시의창구,36세,2019,3834,1999,1835,108.9,3686,1907,1779,107.2
경상남도,창원시의창구,37세,2019,4210,2201,2009,109.6,4061,2110,1951,108.1
경상남도,창원시의창구,38세,2019,4195,2161,2034,106.2,4070,2081,1989,104.6
경상남도,창원시의창구,39세,2019,4332,2253,2079,108.4,4211,2179,2032,107.2
경상남도,창원시의창구,40~44세,2019,18035,9431,8604,109.6,17557,9144,8413,108.7
경상남도,창원시의창구,40세,2019,3770,1984,1786,111.1,3662,1922,1740,110.5
경상남도,창원시의창구,41세,2019,3597,1908,1689,113,3493,1847,1646,112.2
경상남도,창원시의창구,42세,2019,3504,1833,1671,109.7,3417,1784,1633,109.2
경상남도,창원시의창구,43세,2019,3532,1836,1696,108.3,3436,1775,1661,106.9
경상남도,창원시의창구,44세,2019,3632,1870,1762,106.1,3549,1816,1733,104.8
경상남도,창원시의창구,45~49세,2019,22360,10873,11487,94.7,21913,10617,11296,94
경상남도,창원시의창구,45세,2019,4065,2037,2028,100.4,3983,1993,1990,100.2
경상남도,창원시의창구,46세,2019,4388,2122,2266,93.6,4302,2079,2223,93.5
경상남도,창원시의창구,47세,2019,4307,2164,2143,101,4211,2109,2102,100.3
경상남도,창원시의창구,48세,2019,4710,2216,2494,88.9,4624,2162,2462,87.8
경상남도,창원시의창구,49세,2019,4890,2334,2556,91.3,4793,2274,2519,90.3
경상남도,창원시의창구,50~54세,2019,25175,12047,13128,91.8,24742,11816,12926,91.4
경상남도,창원시의창구,50세,2019,5083,2439,2644,92.2,4989,2388,2601,91.8
경상남도,창원시의창구,51세,2019,5217,2420,2797,86.5,5115,2368,2747,86.2
경상남도,창원시의창구,52세,2019,4849,2252,2597,86.7,4781,2215,2566,86.3
경상남도,창원시의창구,53세,2019,4891,2416,2475,97.6,4811,2372,2439,97.3
경상남도,창원시의창구,54세,2019,5135,2520,2615,96.4,5046,2473,2573,96.1
경상남도,창원시의창구,55~59세,2019,24558,12524,12034,104.1,24258,12372,11886,104.1
경상남도,창원시의창구,55세,2019,4294,2119,2175,97.4,4221,2082,2139,97.3
경상남도,창원시의창구,56세,2019,4813,2488,2325,107,4732,2445,2287,106.9
경상남도,창원시의창구,57세,2019,5008,2575,2433,105.8,4946,2541,2405,105.7
경상남도,창원시의창구,58세,2019,5295,2708,2587,104.7,5253,2692,2561,105.1
경상남도,창원시의창구,59세,2019,5148,2634,2514,104.8,5106,2612,2494,104.7
경상남도,창원시의창구,60~64세,2019,18817,9504,9313,102.1,18685,9432,9253,101.9
경상남도,창원시의창구,60세,2019,4299,2250,2049,109.8,4268,2231,2037,109.5
경상남도,창원시의창구,61세,2019,3943,2042,1901,107.4,3910,2021,1889,107
경상남도,창원시의창구,62세,2019,3772,1858,1914,97.1,3751,1848,1903,97.1
경상남도,창원시의창구,63세,2019,3447,1701,1746,97.4,3424,1691,1733,97.6
경상남도,창원시의창구,64세,2019,3356,1653,1703,97.1,3332,1641,1691,97
경상남도,창원시의창구,65~69세,2019,11417,5803,5614,103.4,11361,5779,5582,103.5
경상남도,창원시의창구,65세,2019,2816,1432,1384,103.5,2801,1425,1376,103.6
경상남도,창원시의창구,66세,2019,2428,1232,1196,103,2412,1225,1187,103.2
경상남도,창원시의창구,67세,2019,2494,1291,1203,107.3,2483,1287,1196,107.6
경상남도,창원시의창구,68세,2019,1894,938,956,98.1,1885,934,951,98.2
경상남도,창원시의창구,69세,2019,1785,910,875,104,1780,908,872,104.1
경상남도,창원시의창구,70~74세,2019,7148,3563,3585,99.4,7116,3552,3564,99.7
경상남도,창원시의창구,70세,2019,1791,917,874,104.9,1780,915,865,105.8
경상남도,창원시의창구,71세,2019,1680,851,829,102.7,1672,845,827,102.2
경상남도,창원시의창구,72세,2019,1547,755,792,95.3,1540,753,787,95.7
경상남도,창원시의창구,73세,2019,1091,546,545,100.2,1087,545,542,100.6
경상남도,창원시의창구,74세,2019,1039,494,545,90.6,1037,494,543,91
경상남도,창원시의창구,75~79세,2019,5392,2242,3150,71.2,5378,2241,3137,71.4
경상남도,창원시의창구,75세,2019,1110,512,598,85.6,1105,512,593,86.3
경상남도,창원시의창구,76세,2019,1159,489,670,73,1156,489,667,73.3
경상남도,창원시의창구,77세,2019,1195,500,695,71.9,1194,500,694,72
경상남도,창원시의창구,78세,2019,979,392,587,66.8,975,391,584,67
경상남도,창원시의창구,79세,2019,949,349,600,58.2,948,349,599,58.3
경상남도,창원시의창구,80~84세,2019,3650,1204,2446,49.2,3636,1200,2436,49.3
경상남도,창원시의창구,80세,2019,851,277,574,48.3,847,276,571,48.3
경상남도,창원시의창구,81세,2019,737,254,483,52.6,733,253,480,52.7
경상남도,창원시의창구,82세,2019,749,239,510,46.9,747,238,509,46.8
경상남도,창원시의창구,83세,2019,666,223,443,50.3,663,222,441,50.3
경상남도,창원시의창구,84세,2019,647,211,436,48.4,646,211,435,48.5
경상남도,창원시의창구,85세이상,2019,2599,545,2054,26.5,2595,543,2052,26.5
경상남도,창원시의창구,85~89세,2019,1888,413,1475,28,1887,413,1474,28
경상남도,창원시의창구,85세,2019,497,108,389,27.8,497,108,389,27.8
경상남도,창원시의창구,86세,2019,439,108,331,32.6,439,108,331,32.6
경상남도,창원시의창구,87세,2019,424,90,334,26.9,424,90,334,26.9
경상남도,창원시의창구,88세,2019,278,64,214,29.9,278,64,214,29.9
경상남도,창원시의창구,89세,2019,250,43,207,20.8,249,43,206,20.9
경상남도,창원시의창구,90~94세,2019,602,118,484,24.4,600,116,484,24
경상남도,창원시의창구,90세,2019,210,41,169,24.3,210,41,169,24.3
경상남도,창원시의창구,91세,2019,153,27,126,21.4,153,27,126,21.4
경상남도,창원시의창구,92세,2019,101,20,81,24.7,100,19,81,23.5
경상남도,창원시의창구,93세,2019,79,15,64,23.4,78,14,64,21.9
경상남도,창원시의창구,94세,2019,59,15,44,34.1,59,15,44,34.1
경상남도,창원시의창구,95~99세,2019,95,13,82,15.9,94,13,81,16
경상남도,창원시의창구,95세,2019,34,X,30,13.3,34,X,30,13.3
경상남도,창원시의창구,96세,2019,27,X,23,17.4,27,X,23,17.4
경상남도,창원시의창구,97세,2019,23,5,18,27.8,22,5,17,29.4
경상남도,창원시의창구,98세,2019,5,X,5,0,5,X,5,0
경상남도,창원시의창구,99세,2019,6,X,6,0,6,X,6,0
경상남도,창원시의창구,100세이상,2019,14,X,13,7.7,14,X,13,7.7
경상남도,창원시의창구,15세미만,2019,31901,16525,15376,107.5,31765,16451,15314,107.4
경상남도,창원시의창구,15~64세,2019,193894,100780,93114,108.2,189050,97905,91145,107.4
경상남도,창원시의창구,65세이상,2019,30206,13357,16849,79.3,30086,13315,16771,79.4
경상남도,창원시의창구,평균연령,2019,41.5,40.3,42.7,,41.6,40.4,42.8,
경상남도,창원시의창구,중위연령,2019,43.1,41.2,45.1,,43.4,41.5,45.3,
경상남도,창원시성산구,합계,2019,219951,114488,105463,108.6,214760,110853,103907,106.7
경상남도,창원시성산구,0~4세,2019,8019,4063,3956,102.7,7945,4026,3919,102.7
경상남도,창원시성산구,0세,2019,1341,663,678,97.8,1331,658,673,97.8
경상남도,창원시성산구,1세,2019,1514,775,739,104.9,1494,763,731,104.4
경상남도,창원시성산구,2세,2019,1536,783,753,104,1520,774,746,103.8
경상남도,창원시성산구,3세,2019,1774,892,882,101.1,1759,887,872,101.7
경상남도,창원시성산구,4세,2019,1854,950,904,105.1,1841,944,897,105.2
경상남도,창원시성산구,5~9세,2019,9975,5134,4841,106.1,9937,5115,4822,106.1
경상남도,창원시성산구,5세,2019,1842,950,892,106.5,1826,943,883,106.8
경상남도,창원시성산구,6세,2019,1911,988,923,107,1904,984,920,107
경상남도,창원시성산구,7세,2019,2156,1092,1064,102.6,2148,1090,1058,103
경상남도,창원시성산구,8세,2019,2066,1070,996,107.4,2065,1069,996,107.3
경상남도,창원시성산구,9세,2019,2000,1034,966,107,1994,1029,965,106.6
경상남도,창원시성산구,10~14세,2019,10866,5747,5119,112.3,10837,5733,5104,112.3
경상남도,창원시성산구,10세,2019,2044,1082,962,112.5,2034,1080,954,113.2
경상남도,창원시성산구,11세,2019,2189,1114,1075,103.6,2185,1111,1074,103.4
경상남도,창원시성산구,12세,2019,2307,1245,1062,117.2,2298,1239,1059,117
경상남도,창원시성산구,13세,2019,2155,1167,988,118.1,2152,1165,987,118
경상남도,창원시성산구,14세,2019,2171,1139,1032,110.4,2168,1138,1030,110.5
경상남도,창원시성산구,15~19세,2019,12340,6874,5466,125.8,12297,6849,5448,125.7
경상남도,창원시성산구,15세,2019,2388,1261,1127,111.9,2382,1259,1123,112.1
경상남도,창원시성산구,16세,2019,2418,1348,1070,126,2414,1346,1068,126
경상남도,창원시성산구,17세,2019,2577,1378,1199,114.9,2572,1376,1196,115.1
경상남도,창원시성산구,18세,2019,2783,1544,1239,124.6,2772,1535,1237,124.1
경상남도,창원시성산구,19세,2019,2174,1343,831,161.6,2157,1333,824,161.8
경상남도,창원시성산구,20~24세,2019,14416,8403,6013,139.7,13977,8086,5891,137.3
경상남도,창원시성산구,20세,2019,2436,1590,846,187.9,2395,1564,831,188.2
경상남도,창원시성산구,21세,2019,2663,1648,1015,162.4,2605,1611,994,162.1
경상남도,창원시성산구,22세,2019,2793,1597,1196,133.5,2723,1546,1177,131.4
경상남도,창원시성산구,23세,2019,3187,1784,1403,127.2,3064,1689,1375,122.8
경상남도,창원시성산구,24세,2019,3337,1784,1553,114.9,3190,1676,1514,110.7
경상남도,창원시성산구,25~29세,2019,17599,10005,7594,131.7,16548,9215,7333,125.7
경상남도,창원시성산구,25세,2019,3389,1922,1467,131,3247,1818,1429,127.2
경상남도,창원시성산구,26세,2019,3477,1955,1522,128.4,3298,1821,1477,123.3
경상남도,창원시성산구,27세,2019,3633,2075,1558,133.2,3384,1885,1499,125.8
경상남도,창원시성산구,28세,2019,3579,2000,1579,126.7,3360,1837,1523,120.6
경상남도,창원시성산구,29세,2019,3521,2053,1468,139.9,3259,1854,1405,132
경상남도,창원시성산구,30~34세,2019,16437,9575,6862,139.5,15302,8697,6605,131.7
경상남도,창원시성산구,30세,2019,3414,1985,1429,138.9,3175,1804,1371,131.6
경상남도,창원시성산구,31세,2019,3286,1898,1388,136.7,3073,1733,1340,129.3
경상남도,창원시성산구,32세,2019,3337,1959,1378,142.2,3101,1776,1325,134
경상남도,창원시성산구,33세,2019,3231,1881,1350,139.3,3007,1706,1301,131.1
경상남도,창원시성산구,34세,2019,3169,1852,1317,140.6,2946,1678,1268,132.3
경상남도,창원시성산구,35~39세,2019,16827,8880,7947,111.7,16058,8307,7751,107.2
경상남도,창원시성산구,35세,2019,3107,1740,1367,127.3,2924,1594,1330,119.8
경상남도,창원시성산구,36세,2019,3351,1824,1527,119.4,3180,1695,1485,114.1
경상남도,창원시성산구,37세,2019,3390,1753,1637,107.1,3218,1631,1587,102.8
경상남도,창원시성산구,38세,2019,3471,1788,1683,106.2,3337,1693,1644,103
경상남도,창원시성산구,39세,2019,3508,1775,1733,102.4,3399,1694,1705,99.4
경상남도,창원시성산구,40~44세,2019,16551,8117,8434,96.2,16080,7791,8289,94
경상남도,창원시성산구,40세,2019,3380,1712,1668,102.6,3268,1624,1644,98.8
경상남도,창원시성산구,41세,2019,3190,1601,1589,100.8,3077,1525,1552,98.3
경상남도,창원시성산구,42세,2019,3305,1635,1670,97.9,3208,1569,1639,95.7
경상남도,창원시성산구,43세,2019,3262,1586,1676,94.6,3200,1546,1654,93.5
경상남도,창원시성산구,44세,2019,3414,1583,1831,86.5,3327,1527,1800,84.8
경상남도,창원시성산구,45~49세,2019,21842,10347,11495,90,21437,10084,11353,88.8
경상남도,창원시성산구,45세,2019,3941,1841,2100,87.7,3857,1783,2074,86
경상남도,창원시성산구,46세,2019,4112,1908,2204,86.6,4042,1860,2182,85.2
경상남도,창원시성산구,47세,2019,4266,2061,2205,93.5,4185,2005,2180,92
경상남도,창원시성산구,48세,2019,4687,2223,2464,90.2,4608,2178,2430,89.6
경상남도,창원시성산구,49세,2019,4836,2314,2522,91.8,4745,2258,2487,90.8
경상남도,창원시성산구,50~54세,2019,23011,11025,11986,92,22702,10845,11857,91.5
경상남도,창원시성산구,50세,2019,4749,2228,2521,88.4,4674,2179,2495,87.3
경상남도,창원시성산구,51세,2019,4829,2240,2589,86.5,4767,2209,2558,86.4
경상남도,창원시성산구,52세,2019,4436,2096,2340,89.6,4375,2059,2316,88.9
경상남도,창원시성산구,53세,2019,4409,2210,2199,100.5,4352,2178,2174,100.2
경상남도,창원시성산구,54세,2019,4588,2251,2337,96.3,4534,2220,2314,95.9
경상남도,창원시성산구,55~59세,2019,21956,11317,10639,106.4,21732,11208,10524,106.5
경상남도,창원시성산구,55세,2019,4015,1961,2054,95.5,3962,1933,2029,95.3
경상남도,창원시성산구,56세,2019,4440,2311,2129,108.5,4380,2276,2104,108.2
경상남도,창원시성산구,57세,2019,4435,2292,2143,107,4391,2272,2119,107.2
경상남도,창원시성산구,58세,2019,4659,2396,2263,105.9,4628,2384,2244,106.2
경상남도,창원시성산구,59세,2019,4407,2357,2050,115,4371,2343,2028,115.5
경상남도,창원시성산구,60~64세,2019,13893,7507,6386,117.6,13768,7444,6324,117.7
경상남도,창원시성산구,60세,2019,3500,1961,1539,127.4,3467,1943,1524,127.5
경상남도,창원시성산구,61세,2019,3095,1733,1362,127.2,3066,1717,1349,127.3
경상남도,창원시성산구,62세,2019,2646,1437,1209,118.9,2621,1423,1198,118.8
경상남도,창원시성산구,63세,2019,2357,1200,1157,103.7,2340,1194,1146,104.2
경상남도,창원시성산구,64세,2019,2295,1176,1119,105.1,2274,1167,1107,105.4
경상남도,창원시성산구,65~69세,2019,6919,3739,3180,117.6,6873,3716,3157,117.7
경상남도,창원시성산구,65세,2019,1695,922,773,119.3,1684,917,767,119.6
경상남도,창원시성산구,66세,2019,1553,846,707,119.7,1537,837,700,119.6
경상남도,창원시성산구,67세,2019,1470,796,674,118.1,1465,794,671,118.3
경상남도,창원시성산구,68세,2019,1185,612,573,106.8,1177,607,570,106.5
경상남도,창원시성산구,69세,2019,1016,563,453,124.3,1010,561,449,124.9
경상남도,창원시성산구,70~74세,2019,3873,1930,1943,99.3,3857,1920,1937,99.1
경상남도,창원시성산구,70세,2019,979,477,502,95,975,474,501,94.6
경상남도,창원시성산구,71세,2019,924,455,469,97,923,455,468,97.2
경상남도,창원시성산구,72세,2019,878,457,421,108.6,873,453,420,107.9
경상남도,창원시성산구,73세,2019,575,289,286,101,571,287,284,101.1
경상남도,창원시성산구,74세,2019,517,252,265,95.1,515,251,264,95.1
경상남도,창원시성산구,75~79세,2019,2566,1014,1552,65.3,2559,1011,1548,65.3
경상남도,창원시성산구,75세,2019,537,224,313,71.6,536,224,312,71.8
경상남도,창원시성산구,76세,2019,526,223,303,73.6,526,223,303,73.6
경상남도,창원시성산구,77세,2019,581,234,347,67.4,578,233,345,67.5
경상남도,창원시성산구,78세,2019,474,188,286,65.7,473,187,286,65.4
경상남도,창원시성산구,79세,2019,448,145,303,47.9,446,144,302,47.7
경상남도,창원시성산구,80~84세,2019,1759,551,1208,45.6,1755,548,1207,45.4
경상남도,창원시성산구,80세,2019,436,142,294,48.3,436,142,294,48.3
경상남도,창원시성산구,81세,2019,376,129,247,52.2,374,128,246,52
경상남도,창원시성산구,82세,2019,324,102,222,45.9,323,101,222,45.5
경상남도,창원시성산구,83세,2019,319,91,228,39.9,319,91,228,39.9
경상남도,창원시성산구,84세,2019,304,87,217,40.1,303,86,217,39.6
경상남도,창원시성산구,85세이상,2019,1102,260,842,30.9,1096,258,838,30.8
경상남도,창원시성산구,85~89세,2019,821,195,626,31.2,817,194,623,31.1
경상남도,창원시성산구,85세,2019,244,62,182,34.1,243,61,182,33.5
경상남도,창원시성산구,86세,2019,206,62,144,43.1,205,62,143,43.4
경상남도,창원시성산구,87세,2019,154,29,125,23.2,154,29,125,23.2
경상남도,창원시성산구,88세,2019,120,24,96,25,120,24,96,25
경상남도,창원시성산구,89세,2019,97,18,79,22.8,95,18,77,23.4
경상남도,창원시성산구,90~94세,2019,237,57,180,31.7,235,56,179,31.3
경상남도,창원시성산구,90세,2019,89,23,66,34.8,88,22,66,33.3
경상남도,창원시성산구,91세,2019,44,7,37,18.9,43,7,36,19.4
경상남도,창원시성산구,92세,2019,55,16,39,41,55,16,39,41
경상남도,창원시성산구,93세,2019,25,X,21,19,25,X,21,19
경상남도,창원시성산구,94세,2019,24,7,17,41.2,24,7,17,41.2
경상남도,창원시성산구,95~99세,2019,38,8,30,26.7,38,8,30,26.7
경상남도,창원시성산구,95세,2019,19,X,16,18.8,19,X,16,18.8
경상남도,창원시성산구,96세,2019,8,X,6,33.3,8,X,6,33.3
경상남도,창원시성산구,97세,2019,8,X,6,33.3,8,X,6,33.3
경상남도,창원시성산구,98세,2019,X,X,X,50,X,X,X,50
경상남도,창원시성산구,99세,2019,X,X,X,,X,X,X,
경상남도,창원시성산구,100세이상,2019,6,X,6,0,6,X,6,0
경상남도,창원시성산구,15세미만,2019,28860,14944,13916,107.4,28719,14874,13845,107.4
경상남도,창원시성산구,15~64세,2019,174872,92050,82822,111.1,169901,88526,81375,108.8
경상남도,창원시성산구,65세이상,2019,16219,7494,8725,85.9,16140,7453,8687,85.8
경상남도,창원시성산구,평균연령,2019,39.5,38.6,40.5,,39.6,38.7,40.5,
경상남도,창원시성산구,중위연령,2019,41,39.2,43,,41.4,39.6,43.1,
경상남도,창원시마산합포구,합계,2019,177579,88712,88867,99.8,174434,86830,87604,99.1
경상남도,창원시마산합포구,0~4세,2019,5917,3085,2832,108.9,5890,3077,2813,109.4
경상남도,창원시마산합포구,0세,2019,971,518,453,114.3,965,516,449,114.9
경상남도,창원시마산합포구,1세,2019,1025,511,514,99.4,1022,510,512,99.6
경상남도,창원시마산합포구,2세,2019,1156,624,532,117.3,1149,622,527,118
경상남도,창원시마산합포구,3세,2019,1343,715,628,113.9,1338,712,626,113.7
경상남도,창원시마산합포구,4세,2019,1422,717,705,101.7,1416,717,699,102.6
경상남도,창원시마산합포구,5~9세,2019,7282,3738,3544,105.5,7270,3735,3535,105.7
경상남도,창원시마산합포구,5세,2019,1403,724,679,106.6,1399,723,676,107
경상남도,창원시마산합포구,6세,2019,1489,776,713,108.8,1488,776,712,109
경상남도,창원시마산합포구,7세,2019,1554,792,762,103.9,1551,791,760,104.1
경상남도,창원시마산합포구,8세,2019,1503,768,735,104.5,1500,767,733,104.6
경상남도,창원시마산합포구,9세,2019,1333,678,655,103.5,1332,678,654,103.7
경상남도,창원시마산합포구,10~14세,2019,6513,3365,3148,106.9,6499,3357,3142,106.8
경상남도,창원시마산합포구,10세,2019,1343,714,629,113.5,1339,711,628,113.2
경상남도,창원시마산합포구,11세,2019,1316,680,636,106.9,1315,680,635,107.1
경상남도,창원시마산합포구,12세,2019,1407,720,687,104.8,1403,718,685,104.8
경상남도,창원시마산합포구,13세,2019,1258,621,637,97.5,1254,618,636,97.2
경상남도,창원시마산합포구,14세,2019,1189,630,559,112.7,1188,630,558,112.9
경상남도,창원시마산합포구,15~19세,2019,8383,4433,3950,112.2,8265,4391,3874,113.3
경상남도,창원시마산합포구,15세,2019,1345,676,669,101,1342,675,667,101.2
경상남도,창원시마산합포구,16세,2019,1396,732,664,110.2,1394,731,663,110.3
경상남도,창원시마산합포구,17세,2019,1534,754,780,96.7,1524,747,777,96.1
경상남도,창원시마산합포구,18세,2019,1818,969,849,114.1,1780,955,825,115.8
경상남도,창원시마산합포구,19세,2019,2290,1302,988,131.8,2225,1283,942,136.2
경상남도,창원시마산합포구,20~24세,2019,11127,6276,4851,129.4,10637,6010,4627,129.9
경상남도,창원시마산합포구,20세,2019,2038,1110,928,119.6,1951,1055,896,117.7
경상남도,창원시마산합포구,21세,2019,2237,1230,1007,122.1,2148,1192,956,124.7
경상남도,창원시마산합포구,22세,2019,2350,1312,1038,126.4,2247,1256,991,126.7
경상남도,창원시마산합포구,23세,2019,2270,1307,963,135.7,2160,1251,909,137.6
경상남도,창원시마산합포구,24세,2019,2232,1317,915,143.9,2131,1256,875,143.5
경상남도,창원시마산합포구,25~29세,2019,9790,5476,4314,126.9,9262,5137,4125,124.5
경상남도,창원시마산합포구,25세,2019,2145,1228,917,133.9,2041,1158,883,131.1
경상남도,창원시마산합포구,26세,2019,1973,1110,863,128.6,1883,1049,834,125.8
경상남도,창원시마산합포구,27세,2019,1987,1079,908,118.8,1885,1017,868,117.2
경상남도,창원시마산합포구,28세,2019,1895,1062,833,127.5,1777,987,790,124.9
경상남도,창원시마산합포구,29세,2019,1790,997,793,125.7,1676,926,750,123.5
경상남도,창원시마산합포구,30~34세,2019,9458,5120,4338,118,8933,4769,4164,114.5
경상남도,창원시마산합포구,30세,2019,1833,1001,832,120.3,1715,920,795,115.7
경상남도,창원시마산합포구,31세,2019,1798,994,804,123.6,1691,925,766,120.8
경상남도,창원시마산합포구,32세,2019,1833,973,860,113.1,1737,909,828,109.8
경상남도,창원시마산합포구,33세,2019,1908,1048,860,121.9,1804,977,827,118.1
경상남도,창원시마산합포구,34세,2019,2086,1104,982,112.4,1986,1038,948,109.5
경상남도,창원시마산합포구,35~39세,2019,12942,6859,6083,112.8,12553,6602,5951,110.9
경상남도,창원시마산합포구,35세,2019,2116,1139,977,116.6,2034,1083,951,113.9
경상남도,창원시마산합포구,36세,2019,2450,1294,1156,111.9,2368,1235,1133,109
경상남도,창원시마산합포구,37세,2019,2713,1411,1302,108.4,2641,1367,1274,107.3
경상남도,창원시마산합포구,38세,2019,2829,1551,1278,121.4,2747,1502,1245,120.6
경상남도,창원시마산합포구,39세,2019,2834,1464,1370,106.9,2763,1415,1348,105
경상남도,창원시마산합포구,40~44세,2019,12006,6461,5545,116.5,11702,6258,5444,115
경상남도,창원시마산합포구,40세,2019,2697,1430,1267,112.9,2635,1392,1243,112
경상남도,창원시마산합포구,41세,2019,2362,1272,1090,116.7,2300,1230,1070,115
경상남도,창원시마산합포구,42세,2019,2313,1282,1031,124.3,2257,1245,1012,123
경상남도,창원시마산합포구,43세,2019,2216,1189,1027,115.8,2157,1145,1012,113.1
경상남도,창원시마산합포구,44세,2019,2418,1288,1130,114,2353,1246,1107,112.6
경상남도,창원시마산합포구,45~49세,2019,13367,6869,6498,105.7,13124,6719,6405,104.9
경상남도,창원시마산합포구,45세,2019,2552,1330,1222,108.8,2509,1305,1204,108.4
경상남도,창원시마산합포구,46세,2019,2671,1396,1275,109.5,2628,1368,1260,108.6
경상남도,창원시마산합포구,47세,2019,2458,1283,1175,109.2,2400,1246,1154,108
경상남도,창원시마산합포구,48세,2019,2859,1417,1442,98.3,2813,1384,1429,96.9
경상남도,창원시마산합포구,49세,2019,2827,1443,1384,104.3,2774,1416,1358,104.3
경상남도,창원시마산합포구,50~54세,2019,14187,7111,7076,100.5,13981,7002,6979,100.3
경상남도,창원시마산합포구,50세,2019,2911,1474,1437,102.6,2868,1454,1414,102.8
경상남도,창원시마산합포구,51세,2019,2963,1437,1526,94.2,2916,1407,1509,93.2
경상남도,창원시마산합포구,52세,2019,2750,1399,1351,103.6,2712,1377,1335,103.1
경상남도,창원시마산합포구,53세,2019,2705,1394,1311,106.3,2663,1375,1288,106.8
경상남도,창원시마산합포구,54세,2019,2858,1407,1451,97,2822,1389,1433,96.9
경상남도,창원시마산합포구,55~59세,2019,15616,7461,8155,91.5,15473,7390,8083,91.4
경상남도,창원시마산합포구,55세,2019,2497,1237,1260,98.2,2459,1221,1238,98.6
경상남도,창원시마산합포구,56세,2019,2866,1400,1466,95.5,2827,1381,1446,95.5
경상남도,창원시마산합포구,57세,2019,3140,1522,1618,94.1,3112,1507,1605,93.9
경상남도,창원시마산합포구,58세,2019,3549,1634,1915,85.3,3536,1628,1908,85.3
경상남도,창원시마산합포구,59세,2019,3564,1668,1896,88,3539,1653,1886,87.6
경상남도,창원시마산합포구,60~64세,2019,16203,7662,8541,89.7,16131,7624,8507,89.6
경상남도,창원시마산합포구,60세,2019,3409,1588,1821,87.2,3396,1582,1814,87.2
경상남도,창원시마산합포구,61세,2019,3139,1504,1635,92,3128,1495,1633,91.5
경상남도,창원시마산합포구,62세,2019,3229,1566,1663,94.2,3207,1555,1652,94.1
경상남도,창원시마산합포구,63세,2019,3109,1454,1655,87.9,3096,1449,1647,88
경상남도,창원시마산합포구,64세,2019,3317,1550,1767,87.7,3304,1543,1761,87.6
경상남도,창원시마산합포구,65~69세,2019,11685,5574,6111,91.2,11642,5551,6091,91.1
경상남도,창원시마산합포구,65세,2019,2698,1331,1367,97.4,2684,1324,1360,97.4
경상남도,창원시마산합포구,66세,2019,2351,1108,1243,89.1,2339,1103,1236,89.2
경상남도,창원시마산합포구,67세,2019,2598,1234,1364,90.5,2589,1229,1360,90.4
경상남도,창원시마산합포구,68세,2019,1942,910,1032,88.2,1938,907,1031,88
경상남도,창원시마산합포구,69세,2019,2096,991,1105,89.7,2092,988,1104,89.5
경상남도,창원시마산합포구,70~74세,2019,8779,4076,4703,86.7,8764,4071,4693,86.7
경상남도,창원시마산합포구,70세,2019,2141,1047,1094,95.7,2138,1045,1093,95.6
경상남도,창원시마산합포구,71세,2019,1979,939,1040,90.3,1977,939,1038,90.5
경상남도,창원시마산합포구,72세,2019,1895,842,1053,80,1889,841,1048,80.2
경상남도,창원시마산합포구,73세,2019,1373,625,748,83.6,1373,625,748,83.6
경상남도,창원시마산합포구,74세,2019,1391,623,768,81.1,1387,621,766,81.1
경상남도,창원시마산합포구,75~79세,2019,6885,2895,3990,72.6,6878,2889,3989,72.4
경상남도,창원시마산합포구,75세,2019,1455,642,813,79,1454,641,813,78.8
경상남도,창원시마산합포구,76세,2019,1400,579,821,70.5,1399,578,821,70.4
경상남도,창원시마산합포구,77세,2019,1515,672,843,79.7,1514,672,842,79.8
경상남도,창원시마산합포구,78세,2019,1366,551,815,67.6,1366,551,815,67.6
경상남도,창원시마산합포구,79세,2019,1149,451,698,64.6,1145,447,698,64
경상남도,창원시마산합포구,80~84세,2019,4376,1506,2870,52.5,4370,1505,2865,52.5
경상남도,창원시마산합포구,80세,2019,1077,394,683,57.7,1074,393,681,57.7
경상남도,창원시마산합포구,81세,2019,917,333,584,57,916,333,583,57.1
경상남도,창원시마산합포구,82세,2019,921,306,615,49.8,920,306,614,49.8
경상남도,창원시마산합포구,83세,2019,804,261,543,48.1,803,261,542,48.2
경상남도,창원시마산합포구,84세,2019,657,212,445,47.6,657,212,445,47.6
경상남도,창원시마산합포구,85세이상,2019,3063,745,2318,32.1,3060,743,2317,32.1
경상남도,창원시마산합포구,85~89세,2019,2222,582,1640,35.5,2222,582,1640,35.5
경상남도,창원시마산합포구,85세,2019,620,195,425,45.9,620,195,425,45.9
경상남도,창원시마산합포구,86세,2019,466,120,346,34.7,466,120,346,34.7
경상남도,창원시마산합포구,87세,2019,466,126,340,37.1,466,126,340,37.1
경상남도,창원시마산합포구,88세,2019,349,76,273,27.8,349,76,273,27.8
경상남도,창원시마산합포구,89세,2019,321,65,256,25.4,321,65,256,25.4
경상남도,창원시마산합포구,90~94세,2019,698,139,559,24.9,696,138,558,24.7
경상남도,창원시마산합포구,90세,2019,242,53,189,28,242,53,189,28
경상남도,창원시마산합포구,91세,2019,163,30,133,22.6,163,30,133,22.6
경상남도,창원시마산합포구,92세,2019,133,32,101,31.7,132,31,101,30.7
경상남도,창원시마산합포구,93세,2019,91,17,74,23,91,17,74,23
경상남도,창원시마산합포구,94세,2019,69,7,62,11.3,68,7,61,11.5
경상남도,창원시마산합포구,95~99세,2019,132,23,109,21.1,131,22,109,20.2
경상남도,창원시마산합포구,95세,2019,36,7,29,24.1,36,7,29,24.1
경상남도,창원시마산합포구,96세,2019,48,6,42,14.3,48,6,42,14.3
경상남도,창원시마산합포구,97세,2019,26,7,19,36.8,26,7,19,36.8
경상남도,창원시마산합포구,98세,2019,17,X,14,21.4,16,X,14,14.3
경상남도,창원시마산합포구,99세,2019,5,X,5,0,5,X,5,0
경상남도,창원시마산합포구,100세이상,2019,11,X,10,10,11,X,10,10
경상남도,창원시마산합포구,15세미만,2019,19712,10188,9524,107,19659,10169,9490,107.2
경상남도,창원시마산합포구,15~64세,2019,123079,63728,59351,107.4,120061,61902,58159,106.4
경상남도,창원시마산합포구,65세이상,2019,34788,14796,19992,74,34714,14759,19955,74
경상남도,창원시마산합포구,평균연령,2019,45.1,43.3,46.9,,45.2,43.4,47,
경상남도,창원시마산합포구,중위연령,2019,47.1,44.6,49.5,,47.4,45.1,49.8,
경상남도,창원시마산회원구,합계,2019,192446,96351,96095,100.3,189575,94740,94835,99.9
경상남도,창원시마산회원구,0~4세,2019,5808,3000,2808,106.8,5778,2980,2798,106.5
경상남도,창원시마산회원구,0세,2019,854,461,393,117.3,844,457,387,118.1
경상남도,창원시마산회원구,1세,2019,965,497,468,106.2,963,495,468,105.8
경상남도,창원시마산회원구,2세,2019,1159,592,567,104.4,1152,587,565,103.9
경상남도,창원시마산회원구,3세,2019,1324,666,658,101.2,1317,660,657,100.5
경상남도,창원시마산회원구,4세,2019,1506,784,722,108.6,1502,781,721,108.3
경상남도,창원시마산회원구,5~9세,2019,8369,4402,3967,111,8355,4395,3960,111
경상남도,창원시마산회원구,5세,2019,1519,820,699,117.3,1515,819,696,117.7
경상남도,창원시마산회원구,6세,2019,1563,796,767,103.8,1561,795,766,103.8
경상남도,창원시마산회원구,7세,2019,1812,965,847,113.9,1805,961,844,113.9
경상남도,창원시마산회원구,8세,2019,1765,937,828,113.2,1765,937,828,113.2
경상남도,창원시마산회원구,9세,2019,1710,884,826,107,1709,883,826,106.9
경상남도,창원시마산회원구,10~14세,2019,8821,4613,4208,109.6,8811,4609,4202,109.7
경상남도,창원시마산회원구,10세,2019,1662,902,760,118.7,1660,902,758,119
경상남도,창원시마산회원구,11세,2019,1811,910,901,101,1809,909,900,101
경상남도,창원시마산회원구,12세,2019,1860,1001,859,116.5,1856,998,858,116.3
경상남도,창원시마산회원구,13세,2019,1746,928,818,113.4,1745,928,817,113.6
경상남도,창원시마산회원구,14세,2019,1742,872,870,100.2,1741,872,869,100.3
경상남도,창원시마산회원구,15~19세,2019,9858,5132,4726,108.6,9788,5104,4684,109
경상남도,창원시마산회원구,15세,2019,1869,975,894,109.1,1869,975,894,109.1
경상남도,창원시마산회원구,16세,2019,1823,996,827,120.4,1821,994,827,120.2
경상남도,창원시마산회원구,17세,2019,1760,921,839,109.8,1756,919,837,109.8
경상남도,창원시마산회원구,18세,2019,2075,1077,998,107.9,2059,1072,987,108.6
경상남도,창원시마산회원구,19세,2019,2331,1163,1168,99.6,2283,1144,1139,100.4
경상남도,창원시마산회원구,20~24세,2019,11661,6297,5364,117.4,11352,6133,5219,117.5
경상남도,창원시마산회원구,20세,2019,2345,1249,1096,114,2305,1230,1075,114.4
경상남도,창원시마산회원구,21세,2019,2305,1236,1069,115.6,2251,1213,1038,116.9
경상남도,창원시마산회원구,22세,2019,2365,1305,1060,123.1,2311,1278,1033,123.7
경상남도,창원시마산회원구,23세,2019,2318,1266,1052,120.3,2247,1223,1024,119.4
경상남도,창원시마산회원구,24세,2019,2328,1241,1087,114.2,2238,1189,1049,113.3
경상남도,창원시마산회원구,25~29세,2019,11052,5989,5063,118.3,10592,5725,4867,117.6
경상남도,창원시마산회원구,25세,2019,2270,1202,1068,112.5,2193,1169,1024,114.2
경상남도,창원시마산회원구,26세,2019,2359,1268,1091,116.2,2285,1216,1069,113.8
경상남도,창원시마산회원구,27세,2019,2237,1215,1022,118.9,2149,1174,975,120.4
경상남도,창원시마산회원구,28세,2019,2040,1126,914,123.2,1939,1065,874,121.9
경상남도,창원시마산회원구,29세,2019,2146,1178,968,121.7,2026,1101,925,119
경상남도,창원시마산회원구,30~34세,2019,9850,5243,4607,113.8,9249,4858,4391,110.6
경상남도,창원시마산회원구,30세,2019,2008,1104,904,122.1,1876,1018,858,118.6
경상남도,창원시마산회원구,31세,2019,1945,1049,896,117.1,1819,973,846,115
경상남도,창원시마산회원구,32세,2019,1985,1046,939,111.4,1851,956,895,106.8
경상남도,창원시마산회원구,33세,2019,1941,1019,922,110.5,1813,934,879,106.3
경상남도,창원시마산회원구,34세,2019,1971,1025,946,108.4,1890,977,913,107
경상남도,창원시마산회원구,35~39세,2019,13549,7079,6470,109.4,13201,6883,6318,108.9
경상남도,창원시마산회원구,35세,2019,2271,1208,1063,113.6,2174,1150,1024,112.3
경상남도,창원시마산회원구,36세,2019,2495,1321,1174,112.5,2430,1286,1144,112.4
경상남도,창원시마산회원구,37세,2019,2873,1482,1391,106.5,2806,1448,1358,106.6
경상남도,창원시마산회원구,38세,2019,2854,1507,1347,111.9,2789,1467,1322,111
경상남도,창원시마산회원구,39세,2019,3056,1561,1495,104.4,3002,1532,1470,104.2
경상남도,창원시마산회원구,40~44세,2019,14187,7187,7000,102.7,13961,7067,6894,102.5
경상남도,창원시마산회원구,40세,2019,2886,1494,1392,107.3,2834,1471,1363,107.9
경상남도,창원시마산회원구,41세,2019,2786,1411,1375,102.6,2746,1394,1352,103.1
경상남도,창원시마산회원구,42세,2019,2842,1420,1422,99.9,2802,1396,1406,99.3
경상남도,창원시마산회원구,43세,2019,2712,1399,1313,106.5,2658,1365,1293,105.6
경상남도,창원시마산회원구,44세,2019,2961,1463,1498,97.7,2921,1441,1480,97.4
경상남도,창원시마산회원구,45~49세,2019,16678,8483,8195,103.5,16445,8348,8097,103.1
경상남도,창원시마산회원구,45세,2019,3256,1680,1576,106.6,3214,1658,1556,106.6
경상남도,창원시마산회원구,46세,2019,3284,1690,1594,106,3243,1664,1579,105.4
경상남도,창원시마산회원구,47세,2019,3129,1607,1522,105.6,3087,1584,1503,105.4
경상남도,창원시마산회원구,48세,2019,3526,1746,1780,98.1,3461,1708,1753,97.4
경상남도,창원시마산회원구,49세,2019,3483,1760,1723,102.1,3440,1734,1706,101.6
경상남도,창원시마산회원구,50~54세,2019,17383,8662,8721,99.3,17170,8544,8626,99
경상남도,창원시마산회원구,50세,2019,3636,1866,1770,105.4,3594,1842,1752,105.1
경상남도,창원시마산회원구,51세,2019,3646,1794,1852,96.9,3602,1766,1836,96.2
경상남도,창원시마산회원구,52세,2019,3376,1651,1725,95.7,3333,1624,1709,95
경상남도,창원시마산회원구,53세,2019,3407,1750,1657,105.6,3361,1735,1626,106.7
경상남도,창원시마산회원구,54세,2019,3318,1601,1717,93.2,3280,1577,1703,92.6
경상남도,창원시마산회원구,55~59세,2019,17739,8768,8971,97.7,17571,8683,8888,97.7
경상남도,창원시마산회원구,55세,2019,2937,1464,1473,99.4,2898,1443,1455,99.2
경상남도,창원시마산회원구,56세,2019,3311,1662,1649,100.8,3264,1640,1624,101
경상남도,창원시마산회원구,57세,2019,3709,1825,1884,96.9,3679,1808,1871,96.6
경상남도,창원시마산회원구,58세,2019,3896,1973,1923,102.6,3876,1961,1915,102.4
경상남도,창원시마산회원구,59세,2019,3886,1844,2042,90.3,3854,1831,2023,90.5
경상남도,창원시마산회원구,60~64세,2019,16334,7784,8550,91,16231,7729,8502,90.9
경상남도,창원시마산회원구,60세,2019,3420,1650,1770,93.2,3398,1638,1760,93.1
경상남도,창원시마산회원구,61세,2019,3270,1566,1704,91.9,3244,1553,1691,91.8
경상남도,창원시마산회원구,62세,2019,3301,1553,1748,88.8,3283,1543,1740,88.7
경상남도,창원시마산회원구,63세,2019,3046,1452,1594,91.1,3020,1436,1584,90.7
경상남도,창원시마산회원구,64세,2019,3297,1563,1734,90.1,3286,1559,1727,90.3
경상남도,창원시마산회원구,65~69세,2019,11606,5541,6065,91.4,11555,5521,6034,91.5
경상남도,창원시마산회원구,65세,2019,2647,1291,1356,95.2,2632,1286,1346,95.5
경상남도,창원시마산회원구,66세,2019,2383,1163,1220,95.3,2369,1158,1211,95.6
경상남도,창원시마산회원구,67세,2019,2586,1279,1307,97.9,2576,1274,1302,97.8
경상남도,창원시마산회원구,68세,2019,2021,932,1089,85.6,2014,930,1084,85.8
경상남도,창원시마산회원구,69세,2019,1969,876,1093,80.1,1964,873,1091,80
경상남도,창원시마산회원구,70~74세,2019,8132,3895,4237,91.9,8117,3891,4226,92.1
경상남도,창원시마산회원구,70세,2019,2003,942,1061,88.8,1997,941,1056,89.1
경상남도,창원시마산회원구,71세,2019,1937,945,992,95.3,1936,945,991,95.4
경상남도,창원시마산회원구,72세,2019,1727,830,897,92.5,1725,830,895,92.7
경상남도,창원시마산회원구,73세,2019,1236,610,626,97.4,1232,608,624,97.4
경상남도,창원시마산회원구,74세,2019,1229,568,661,85.9,1227,567,660,85.9
경상남도,창원시마산회원구,75~79세,2019,5855,2545,3310,76.9,5844,2541,3303,76.9
경상남도,창원시마산회원구,75세,2019,1325,609,716,85.1,1321,608,713,85.3
경상남도,창원시마산회원구,76세,2019,1235,547,688,79.5,1232,545,687,79.3
경상남도,창원시마산회원구,77세,2019,1223,533,690,77.2,1222,532,690,77.1
경상남도,창원시마산회원구,78세,2019,1110,465,645,72.1,1110,465,645,72.1
경상남도,창원시마산회원구,79세,2019,962,391,571,68.5,959,391,568,68.8
경상남도,창원시마산회원구,80~84세,2019,3490,1261,2229,56.6,3483,1260,2223,56.7
경상남도,창원시마산회원구,80세,2019,914,365,549,66.5,913,365,548,66.6
경상남도,창원시마산회원구,81세,2019,769,290,479,60.5,766,290,476,60.9
경상남도,창원시마산회원구,82세,2019,628,236,392,60.2,627,236,391,60.4
경상남도,창원시마산회원구,83세,2019,623,202,421,48,622,202,420,48.1
경상남도,창원시마산회원구,84세,2019,556,168,388,43.3,555,167,388,43
경상남도,창원시마산회원구,85세이상,2019,2074,470,1604,29.3,2072,469,1603,29.3
경상남도,창원시마산회원구,85~89세,2019,1502,372,1130,32.9,1500,371,1129,32.9
경상남도,창원시마산회원구,85세,2019,438,133,305,43.6,437,133,304,43.8
경상남도,창원시마산회원구,86세,2019,329,89,240,37.1,329,89,240,37.1
경상남도,창원시마산회원구,87세,2019,305,79,226,35,305,79,226,35
경상남도,창원시마산회원구,88세,2019,250,39,211,18.5,250,39,211,18.5
경상남도,창원시마산회원구,89세,2019,180,32,148,21.6,179,31,148,20.9
경상남도,창원시마산회원구,90~94세,2019,478,82,396,20.7,478,82,396,20.7
경상남도,창원시마산회원구,90세,2019,171,30,141,21.3,171,30,141,21.3
경상남도,창원시마산회원구,91세,2019,114,24,90,26.7,114,24,90,26.7
경상남도,창원시마산회원구,92세,2019,87,13,74,17.6,87,13,74,17.6
경상남도,창원시마산회원구,93세,2019,56,7,49,14.3,56,7,49,14.3
경상남도,창원시마산회원구,94세,2019,50,8,42,19,50,8,42,19
경상남도,창원시마산회원구,95~99세,2019,86,15,71,21.1,86,15,71,21.1
경상남도,창원시마산회원구,95세,2019,20,X,16,25,20,X,16,25
경상남도,창원시마산회원구,96세,2019,27,X,24,12.5,27,X,24,12.5
경상남도,창원시마산회원구,97세,2019,15,X,13,15.4,15,X,13,15.4
경상남도,창원시마산회원구,98세,2019,12,X,9,33.3,12,X,9,33.3
경상남도,창원시마산회원구,99세,2019,12,X,9,33.3,12,X,9,33.3
경상남도,창원시마산회원구,100세이상,2019,8,X,7,14.3,8,X,7,14.3
경상남도,창원시마산회원구,15세미만,2019,22998,12015,10983,109.4,22944,11984,10960,109.3
경상남도,창원시마산회원구,15~64세,2019,138291,70624,67667,104.4,135560,69074,66486,103.9
경상남도,창원시마산회원구,65세이상,2019,31157,13712,17445,78.6,31071,13682,17389,78.7
경상남도,창원시마산회원구,평균연령,2019,43.7,42.4,45,,43.8,42.5,45,
경상남도,창원시마산회원구,중위연령,2019,45.9,44.5,47.4,,46.1,44.7,47.6,
경상남도,창원시진해구,합계,2019,190885,98087,92798,105.7,185968,94938,91030,104.3
경상남도,창원시진해구,0~4세,2019,9138,4754,4384,108.4,9047,4707,4340,108.5
경상남도,창원시진해구,0세,2019,1466,754,712,105.9,1451,743,708,104.9
경상남도,창원시진해구,1세,2019,1599,848,751,112.9,1586,842,744,113.2
경상남도,창원시진해구,2세,2019,1802,914,888,102.9,1780,903,877,103
경상남도,창원시진해구,3세,2019,2101,1071,1030,104,2080,1061,1019,104.1
경상남도,창원시진해구,4세,2019,2170,1167,1003,116.4,2150,1158,992,116.7
경상남도,창원시진해구,5~9세,2019,11725,6116,5609,109,11677,6093,5584,109.1
경상남도,창원시진해구,5세,2019,2256,1156,1100,105.1,2234,1148,1086,105.7
경상남도,창원시진해구,6세,2019,2325,1225,1100,111.4,2317,1220,1097,111.2
경상남도,창원시진해구,7세,2019,2486,1323,1163,113.8,2479,1320,1159,113.9
경상남도,창원시진해구,8세,2019,2377,1199,1178,101.8,2370,1196,1174,101.9
경상남도,창원시진해구,9세,2019,2281,1213,1068,113.6,2277,1209,1068,113.2
경상남도,창원시진해구,10~14세,2019,10659,5397,5262,102.6,10633,5385,5248,102.6
경상남도,창원시진해구,10세,2019,2186,1090,1096,99.5,2180,1087,1093,99.5
경상남도,창원시진해구,11세,2019,2319,1102,1217,90.6,2313,1101,1212,90.8
경상남도,창원시진해구,12세,2019,2242,1161,1081,107.4,2235,1158,1077,107.5
경상남도,창원시진해구,13세,2019,2024,1085,939,115.5,2018,1081,937,115.4
경상남도,창원시진해구,14세,2019,1888,959,929,103.2,1887,958,929,103.1
경상남도,창원시진해구,15~19세,2019,8985,4865,4120,118.1,8938,4833,4105,117.7
경상남도,창원시진해구,15세,2019,2038,1095,943,116.1,2034,1093,941,116.2
경상남도,창원시진해구,16세,2019,1793,973,820,118.7,1786,967,819,118.1
경상남도,창원시진해구,17세,2019,1808,976,832,117.3,1803,972,831,117
경상남도,창원시진해구,18세,2019,1809,966,843,114.6,1793,956,837,114.2
경상남도,창원시진해구,19세,2019,1537,855,682,125.4,1522,845,677,124.8
경상남도,창원시진해구,20~24세,2019,8638,5105,3533,144.5,8281,4882,3399,143.6
경상남도,창원시진해구,20세,2019,1615,1007,608,165.6,1587,992,595,166.7
경상남도,창원시진해구,21세,2019,1644,999,645,154.9,1596,970,626,155
경상남도,창원시진해구,22세,2019,1710,1004,706,142.2,1637,954,683,139.7
경상남도,창원시진해구,23세,2019,1838,1032,806,128,1746,975,771,126.5
경상남도,창원시진해구,24세,2019,1831,1063,768,138.4,1715,991,724,136.9
경상남도,창원시진해구,25~29세,2019,10496,5934,4562,130.1,9746,5408,4338,124.7
경상남도,창원시진해구,25세,2019,1957,1114,843,132.1,1830,1022,808,126.5
경상남도,창원시진해구,26세,2019,2053,1211,842,143.8,1903,1091,812,134.4
경상남도,창원시진해구,27세,2019,2223,1242,981,126.6,2083,1156,927,124.7
경상남도,창원시진해구,28세,2019,2066,1143,923,123.8,1913,1038,875,118.6
경상남도,창원시진해구,29세,2019,2197,1224,973,125.8,2017,1101,916,120.2
경상남도,창원시진해구,30~34세,2019,12168,6449,5719,112.8,11190,5778,5412,106.8
경상남도,창원시진해구,30세,2019,2234,1203,1031,116.7,2041,1070,971,110.2
경상남도,창원시진해구,31세,2019,2268,1207,1061,113.8,2082,1077,1005,107.2
경상남도,창원시진해구,32세,2019,2397,1260,1137,110.8,2187,1117,1070,104.4
경상남도,창원시진해구,33세,2019,2520,1350,1170,115.4,2321,1214,1107,109.7
경상남도,창원시진해구,34세,2019,2749,1429,1320,108.3,2559,1300,1259,103.3
경상남도,창원시진해구,35~39세,2019,18157,9486,8671,109.4,17408,8974,8434,106.4
경상남도,창원시진해구,35세,2019,2933,1556,1377,113,2757,1435,1322,108.5
경상남도,창원시진해구,36세,2019,3465,1831,1634,112.1,3281,1711,1570,109
경상남도,창원시진해구,37세,2019,3814,1992,1822,109.3,3663,1888,1775,106.4
경상남도,창원시진해구,38세,2019,3949,2092,1857,112.7,3829,2009,1820,110.4
경상남도,창원시진해구,39세,2019,3996,2015,1981,101.7,3878,1931,1947,99.2
경상남도,창원시진해구,40~44세,2019,17158,9063,8095,112,16698,8752,7946,110.1
경상남도,창원시진해구,40세,2019,3759,1926,1833,105.1,3634,1845,1789,103.1
경상남도,창원시진해구,41세,2019,3353,1789,1564,114.4,3256,1721,1535,112.1
경상남도,창원시진해구,42세,2019,3409,1794,1615,111.1,3334,1740,1594,109.2
경상남도,창원시진해구,43세,2019,3232,1763,1469,120,3130,1692,1438,117.7
경상남도,창원시진해구,44세,2019,3405,1791,1614,111,3344,1754,1590,110.3
경상남도,창원시진해구,45~49세,2019,17213,9226,7987,115.5,16732,8935,7797,114.6
경상남도,창원시진해구,45세,2019,3718,1993,1725,115.5,3619,1928,1691,114
경상남도,창원시진해구,46세,2019,3527,1897,1630,116.4,3434,1842,1592,115.7
경상남도,창원시진해구,47세,2019,3337,1782,1555,114.6,3246,1727,1519,113.7
경상남도,창원시진해구,48세,2019,3407,1841,1566,117.6,3296,1768,1528,115.7
경상남도,창원시진해구,49세,2019,3224,1713,1511,113.4,3137,1670,1467,113.8
경상남도,창원시진해구,50~54세,2019,14121,7376,6745,109.4,13751,7161,6590,108.7
경상남도,창원시진해구,50세,2019,3115,1707,1408,121.2,3029,1652,1377,120
경상남도,창원시진해구,51세,2019,3089,1623,1466,110.7,3007,1584,1423,111.3
경상남도,창원시진해구,52세,2019,2680,1379,1301,106,2601,1332,1269,105
경상남도,창원시진해구,53세,2019,2669,1366,1303,104.8,2610,1331,1279,104.1
경상남도,창원시진해구,54세,2019,2568,1301,1267,102.7,2504,1262,1242,101.6
경상남도,창원시진해구,55~59세,2019,14130,6992,7138,98,13871,6853,7018,97.6
경상남도,창원시진해구,55세,2019,2525,1299,1226,106,2457,1259,1198,105.1
경상남도,창원시진해구,56세,2019,2794,1432,1362,105.1,2740,1405,1335,105.2
경상남도,창원시진해구,57세,2019,2643,1317,1326,99.3,2595,1292,1303,99.2
경상남도,창원시진해구,58세,2019,3059,1488,1571,94.7,3010,1461,1549,94.3
경상남도,창원시진해구,59세,2019,3109,1456,1653,88.1,3069,1436,1633,87.9
경상남도,창원시진해구,60~64세,2019,12892,6279,6613,94.9,12728,6195,6533,94.8
경상남도,창원시진해구,60세,2019,2755,1322,1433,92.3,2713,1302,1411,92.3
경상남도,창원시진해구,61세,2019,2616,1303,1313,99.2,2574,1282,1292,99.2
경상남도,창원시진해구,62세,2019,2566,1270,1296,98,2539,1257,1282,98
경상남도,창원시진해구,63세,2019,2423,1174,1249,94,2395,1156,1239,93.3
경상남도,창원시진해구,64세,2019,2532,1210,1322,91.5,2507,1198,1309,91.5
경상남도,창원시진해구,65~69세,2019,8705,4261,4444,95.9,8627,4220,4407,95.8
경상남도,창원시진해구,65세,2019,2094,1073,1021,105.1,2076,1066,1010,105.5
경상남도,창원시진해구,66세,2019,1782,906,876,103.4,1759,891,868,102.6
경상남도,창원시진해구,67세,2019,1943,948,995,95.3,1932,941,991,95
경상남도,창원시진해구,68세,2019,1472,680,792,85.9,1460,675,785,86
경상남도,창원시진해구,69세,2019,1414,654,760,86.1,1400,647,753,85.9
경상남도,창원시진해구,70~74세,2019,6314,2970,3344,88.8,6287,2958,3329,88.9
경상남도,창원시진해구,70세,2019,1530,750,780,96.2,1520,746,774,96.4
경상남도,창원시진해구,71세,2019,1388,678,710,95.5,1384,677,707,95.8
경상남도,창원시진해구,72세,2019,1356,611,745,82,1347,606,741,81.8
경상남도,창원시진해구,73세,2019,1048,515,533,96.6,1045,513,532,96.4
경상남도,창원시진해구,74세,2019,992,416,576,72.2,991,416,575,72.3
경상남도,창원시진해구,75~79세,2019,4943,2071,2872,72.1,4927,2066,2861,72.2
경상남도,창원시진해구,75세,2019,1033,465,568,81.9,1027,464,563,82.4
경상남도,창원시진해구,76세,2019,991,417,574,72.6,989,416,573,72.6
경상남도,창원시진해구,77세,2019,1144,469,675,69.5,1142,468,674,69.4
경상남도,창원시진해구,78세,2019,900,373,527,70.8,896,372,524,71
경상남도,창원시진해구,79세,2019,875,347,528,65.7,873,346,527,65.7
경상남도,창원시진해구,80~84세,2019,3297,1205,2092,57.6,3288,1201,2087,57.5
경상남도,창원시진해구,80세,2019,809,319,490,65.1,808,319,489,65.2
경상남도,창원시진해구,81세,2019,709,277,432,64.1,705,274,431,63.6
경상남도,창원시진해구,82세,2019,701,247,454,54.4,700,247,453,54.5
경상남도,창원시진해구,83세,2019,560,198,362,54.7,558,197,361,54.6
경상남도,창원시진해구,84세,2019,518,164,354,46.3,517,164,353,46.5
경상남도,창원시진해구,85세이상,2019,2146,538,1608,33.5,2139,537,1602,33.5
경상남도,창원시진해구,85~89세,2019,1568,415,1153,36,1563,414,1149,36
경상남도,창원시진해구,85세,2019,461,138,323,42.7,460,138,322,42.9
경상남도,창원시진해구,86세,2019,351,110,241,45.6,349,109,240,45.4
경상남도,창원시진해구,87세,2019,329,70,259,27,328,70,258,27.1
경상남도,창원시진해구,88세,2019,228,58,170,34.1,227,58,169,34.3
경상남도,창원시진해구,89세,2019,199,39,160,24.4,199,39,160,24.4
경상남도,창원시진해구,90~94세,2019,487,107,380,28.2,485,107,378,28.3
경상남도,창원시진해구,90세,2019,162,45,117,38.5,162,45,117,38.5
경상남도,창원시진해구,91세,2019,140,32,108,29.6,140,32,108,29.6
경상남도,창원시진해구,92세,2019,66,12,54,22.2,66,12,54,22.2
경상남도,창원시진해구,93세,2019,70,12,58,20.7,69,12,57,21.1
경상남도,창원시진해구,94세,2019,49,6,43,14,48,6,42,14.3
경상남도,창원시진해구,95~99세,2019,84,15,69,21.7,84,15,69,21.7
경상남도,창원시진해구,95세,2019,37,7,30,23.3,37,7,30,23.3
경상남도,창원시진해구,96세,2019,24,X,22,9.1,24,X,22,9.1
경상남도,창원시진해구,97세,2019,7,X,X,75,7,X,X,75
경상남도,창원시진해구,98세,2019,7,X,6,16.7,7,X,6,16.7
경상남도,창원시진해구,99세,2019,9,X,7,28.6,9,X,7,28.6
경상남도,창원시진해구,100세이상,2019,7,X,6,16.7,7,X,6,16.7
경상남도,창원시진해구,15세미만,2019,31522,16267,15255,106.6,31357,16185,15172,106.7
경상남도,창원시진해구,15~64세,2019,133958,70775,63183,112,129343,67771,61572,110.1
경상남도,창원시진해구,65세이상,2019,25405,11045,14360,76.9,25268,10982,14286,76.9
경상남도,창원시진해구,평균연령,2019,40.6,39.4,41.9,,40.7,39.5,42,
경상남도,창원시진해구,중위연령,2019,41.5,40.5,42.7,,41.7,40.8,42.8,
서울특별시,중구,합계,2017,127896,62195,65701,94.7,117631,57391,60240,95.3
서울특별시,중구,0~4세,2017,4206,2145,2061,104.1,4001,2024,1977,102.4
서울특별시,중구,0세,2017,807,400,407,98.3,763,376,387,97.2
서울특별시,중구,1세,2017,883,472,411,114.8,830,441,389,113.4
서울특별시,중구,2세,2017,874,444,430,103.3,830,421,409,102.9
서울특별시,중구,3세,2017,844,421,423,99.5,821,405,416,97.4
서울특별시,중구,4세,2017,798,408,390,104.6,757,381,376,101.3
서울특별시,중구,5~9세,2017,3682,1864,1818,102.5,3536,1787,1749,102.2
서울특별시,중구,5세,2017,826,437,389,112.3,795,420,375,112
서울특별시,중구,6세,2017,798,387,411,94.2,761,369,392,94.1
서울특별시,중구,7세,2017,712,372,340,109.4,688,359,329,109.1
서울특별시,중구,8세,2017,640,326,314,103.8,613,309,304,101.6
서울특별시,중구,9세,2017,706,342,364,94,679,330,349,94.6
서울특별시,중구,10~14세,2017,3147,1595,1552,102.8,3028,1523,1505,101.2
서울특별시,중구,10세,2017,724,371,353,105.1,693,349,344,101.5
서울특별시,중구,11세,2017,578,301,277,108.7,556,288,268,107.5
서울특별시,중구,12세,2017,579,291,288,101,555,280,275,101.8
서울특별시,중구,13세,2017,645,318,327,97.2,615,299,316,94.6
서울특별시,중구,14세,2017,621,314,307,102.3,609,307,302,101.7
서울특별시,중구,15~19세,2017,5739,2574,3165,81.3,5316,2415,2901,83.2
서울특별시,중구,15세,2017,711,359,352,102,694,347,347,100
서울특별시,중구,16세,2017,1065,422,643,65.6,1047,418,629,66.5
서울특별시,중구,17세,2017,1045,491,554,88.6,1011,474,537,88.3
서울특별시,중구,18세,2017,1132,547,585,93.5,1037,513,524,97.9
서울특별시,중구,19세,2017,1786,755,1031,73.2,1527,663,864,76.7
서울특별시,중구,20~24세,2017,10343,4813,5530,87,8861,4269,4592,93
서울특별시,중구,20세,2017,1987,814,1173,69.4,1698,718,980,73.3
서울특별시,중구,21세,2017,1914,819,1095,74.8,1626,721,905,79.7
서울특별시,중구,22세,2017,1928,929,999,93,1622,801,821,97.6
서울특별시,중구,23세,2017,2235,1111,1124,98.8,1934,1002,932,107.5
서울특별시,중구,24세,2017,2279,1140,1139,100.1,1981,1027,954,107.7
서울특별시,중구,25~29세,2017,11113,5609,5504,101.9,9743,4956,4787,103.5
서울특별시,중구,25세,2017,2418,1233,1185,104.1,2117,1105,1012,109.2
서울특별시,중구,26세,2017,2297,1161,1136,102.2,2043,1036,1007,102.9
서울특별시,중구,27세,2017,2165,1091,1074,101.6,1883,959,924,103.8
서울특별시,중구,28세,2017,2131,1102,1029,107.1,1867,964,903,106.8
서울특별시,중구,29세,2017,2102,1022,1080,94.6,1833,892,941,94.8
서울특별시,중구,30~34세,2017,10666,5373,5293,101.5,9548,4779,4769,100.2
서울특별시,중구,30세,2017,2127,1102,1025,107.5,1863,971,892,108.9
서울특별시,중구,31세,2017,2068,1025,1043,98.3,1834,898,936,95.9
서울특별시,중구,32세,2017,2038,1009,1029,98.1,1825,899,926,97.1
서울특별시,중구,33세,2017,2169,1072,1097,97.7,1952,952,1000,95.2
서울특별시,중구,34세,2017,2264,1165,1099,106,2074,1059,1015,104.3
서울특별시,중구,35~39세,2017,10498,5424,5074,106.9,9596,4911,4685,104.8
서울특별시,중구,35세,2017,2254,1129,1125,100.4,2061,1025,1036,98.9
서울특별시,중구,36세,2017,2231,1148,1083,106,2045,1045,1000,104.5
서울특별시,중구,37세,2017,2254,1184,1070,110.7,2068,1074,994,108
서울특별시,중구,38세,2017,2014,1044,970,107.6,1856,952,904,105.3
서울특별시,중구,39세,2017,1745,919,826,111.3,1566,815,751,108.5
서울특별시,중구,40~44세,2017,9144,4713,4431,106.4,8398,4310,4088,105.4
서울특별시,중구,40세,2017,1775,925,850,108.8,1639,853,786,108.5
서울특별시,중구,41세,2017,1744,899,845,106.4,1585,799,786,101.7
서울특별시,중구,42세,2017,1822,932,890,104.7,1686,860,826,104.1
서울특별시,중구,43세,2017,1892,988,904,109.3,1728,906,822,110.2
서울특별시,중구,44세,2017,1911,969,942,102.9,1760,892,868,102.8
서울특별시,중구,45~49세,2017,10406,5285,5121,103.2,9531,4850,4681,103.6
서울특별시,중구,45세,2017,1982,1025,957,107.1,1832,940,892,105.4
서울특별시,중구,46세,2017,2141,1103,1038,106.3,1976,1019,957,106.5
서울특별시,중구,47세,2017,2039,1006,1033,97.4,1858,919,939,97.9
서울특별시,중구,48세,2017,2095,1111,984,112.9,1908,1024,884,115.8
서울특별시,중구,49세,2017,2149,1040,1109,93.8,1957,948,1009,94
서울특별시,중구,50~54세,2017,9926,4863,5063,96,9026,4468,4558,98
서울특별시,중구,50세,2017,1926,950,976,97.3,1773,893,880,101.5
서울특별시,중구,51세,2017,1827,920,907,101.4,1665,847,818,103.5
서울특별시,중구,52세,2017,1999,935,1064,87.9,1829,856,973,88
서울특별시,중구,53세,2017,2036,992,1044,95,1837,897,940,95.4
서울특별시,중구,54세,2017,2138,1066,1072,99.4,1922,975,947,103
서울특별시,중구,55~59세,2017,10810,5264,5546,94.9,10029,4945,5084,97.3
서울특별시,중구,55세,2017,2137,1058,1079,98.1,1969,983,986,99.7
서울특별시,중구,56세,2017,2216,1080,1136,95.1,2111,1035,1076,96.2
서울특별시,중구,57세,2017,2320,1111,1209,91.9,2148,1039,1109,93.7
서울특별시,중구,58세,2017,2062,1014,1048,96.8,1904,957,947,101.1
서울특별시,중구,59세,2017,2075,1001,1074,93.2,1897,931,966,96.4
서울특별시,중구,60~64세,2017,9004,4414,4590,96.2,8326,4122,4204,98
서울특별시,중구,60세,2017,2066,1038,1028,101,1893,965,928,104
서울특별시,중구,61세,2017,1973,966,1007,95.9,1850,920,930,98.9
서울특별시,중구,62세,2017,1928,927,1001,92.6,1785,862,923,93.4
서울특별시,중구,63세,2017,1627,803,824,97.5,1490,741,749,98.9
서울특별시,중구,64세,2017,1410,680,730,93.2,1308,634,674,94.1
서울특별시,중구,65~69세,2017,6287,3000,3287,91.3,5979,2862,3117,91.8
서울특별시,중구,65세,2017,1494,699,795,87.9,1396,657,739,88.9
서울특별시,중구,66세,2017,1098,529,569,93,1026,495,531,93.2
서울특별시,중구,67세,2017,1264,620,644,96.3,1202,592,610,97
서울특별시,중구,68세,2017,1220,579,641,90.3,1165,551,614,89.7
서울특별시,중구,69세,2017,1211,573,638,89.8,1190,567,623,91
서울특별시,중구,70~74세,2017,4900,2204,2696,81.8,4802,2154,2648,81.3
서울특별시,중구,70세,2017,1213,547,666,82.1,1177,530,647,81.9
서울특별시,중구,71세,2017,889,378,511,74,870,368,502,73.3
서울특별시,중구,72세,2017,946,446,500,89.2,936,441,495,89.1
서울특별시,중구,73세,2017,927,422,505,83.6,905,408,497,82.1
서울특별시,중구,74세,2017,925,411,514,80,914,407,507,80.3
서울특별시,중구,75~79세,2017,4139,1732,2407,72,4078,1707,2371,72
서울특별시,중구,75세,2017,1110,478,632,75.6,1098,474,624,76
서울특별시,중구,76세,2017,888,366,522,70.1,874,362,512,70.7
서울특별시,중구,77세,2017,748,310,438,70.8,739,304,435,69.9
서울특별시,중구,78세,2017,758,331,427,77.5,743,326,417,78.2
서울특별시,중구,79세,2017,635,247,388,63.7,624,241,383,62.9
서울특별시,중구,80~84세,2017,2338,846,1492,56.7,2305,837,1468,57
서울특별시,중구,80세,2017,570,212,358,59.2,558,208,350,59.4
서울특별시,중구,81세,2017,546,212,334,63.5,541,212,329,64.4
서울특별시,중구,82세,2017,468,175,293,59.7,462,173,289,59.9
서울특별시,중구,83세,2017,391,131,260,50.4,384,129,255,50.6
서울특별시,중구,84세,2017,363,116,247,47,360,115,245,46.9
서울특별시,중구,85세이상,2017,1548,477,1071,44.5,1528,472,1056,44.7
서울특별시,중구,85~89세,2017,1098,346,752,46,1087,343,744,46.1
서울특별시,중구,85세,2017,282,81,201,40.3,280,81,199,40.7
서울특별시,중구,86세,2017,227,74,153,48.4,227,74,153,48.4
서울특별시,중구,87세,2017,225,78,147,53.1,219,76,143,53.1
서울특별시,중구,88세,2017,190,66,124,53.2,188,65,123,52.8
서울특별시,중구,89세,2017,174,47,127,37,173,47,126,37.3
서울특별시,중구,90~94세,2017,357,103,254,40.6,351,101,250,40.4
서울특별시,중구,90세,2017,129,38,91,41.8,126,37,89,41.6
서울특별시,중구,91세,2017,84,22,62,35.5,84,22,62,35.5
서울특별시,중구,92세,2017,53,12,41,29.3,53,12,41,29.3
서울특별시,중구,93세,2017,53,21,32,65.6,52,21,31,67.7
서울특별시,중구,94세,2017,38,10,28,35.7,36,9,27,33.3
서울특별시,중구,95~99세,2017,77,25,52,48.1,75,25,50,50
서울특별시,중구,95세,2017,38,13,25,52,37,13,24,54.2
서울특별시,중구,96세,2017,17,X,13,30.8,17,X,13,30.8
서울특별시,중구,97세,2017,8,X,6,33.3,8,X,6,33.3
서울특별시,중구,98세,2017,X,X,X,33.3,X,X,X,33.3
서울특별시,중구,99세,2017,10,5,5,100,9,5,X,125
서울특별시,중구,100세이상,2017,16,X,13,23.1,15,X,12,25
서울특별시,중구,15세미만,2017,11035,5604,5431,103.2,10565,5334,5231,102
서울특별시,중구,15~64세,2017,97649,48332,49317,98,88374,44025,44349,99.3
서울특별시,중구,65세이상,2017,19212,8259,10953,75.4,18692,8032,10660,75.3
서울특별시,중구,평균연령,2017,42.8,42.1,43.5,,43.2,42.4,43.9,
서울특별시,중구,중위연령,2017,42.6,41.9,43.3,,43.2,42.4,43.9,
